GAME_ID,PERIOD,DURATION_SECONDS,PLUS_MINUS,PLUS_MINUS_PER_MINUTE,STINT_START_SECONDS,STINT_END_SECONDS
22400001,1,298,0.0,0.0,720,422
22400001,1,47,2.0,2.5531914893617023,404,357
22400001,1,66,-2.0,-1.8181818181818183,357,291
22400001,1,24,-3.0,-7.5,291,267
22400001,1,236,3.0,0.7627118644067797,262,26
22400001,1,26,3.0,6.923076923076923,26,0
22400001,2,125,4.0,1.92,720,595
22400001,2,117,-3.0,-1.5384615384615383,578,461
22400001,2,38,0.0,0.0,444,406
22400001,2,68,0.0,0.0,400,332
22400001,2,39,3.0,4.615384615384616,329,290
22400001,2,39,5.0,7.692307692307692,283,244
22400001,2,93,-3.0,-1.935483870967742,244,151
22400001,2,37,3.0,4.864864864864865,151,114
22400001,2,113,1.0,0.5309734513274336,114,1
22400001,3,317,2.0,0.3785488958990536,720,403
22400001,3,73,0.0,0.0,393,320
22400001,3,59,-2.0,-2.0338983050847457,305,246
22400001,3,84,-3.0,-2.142857142857143,236,152
22400001,3,40,-2.0,-3.0,132,92
22400001,3,76,-1.0,-0.7894736842105263,92,16
22400001,3,3,0.0,0.0,3,0
22400001,4,101,1.0,0.594059405940594,720,619
22400001,4,19,0.0,0.0,609,590
22400001,4,115,-6.0,-3.1304347826086953,584,469
22400001,4,28,-1.0,-2.142857142857143,454,426
22400001,4,148,1.0,0.40540540540540543,426,278
22400001,4,269,-4.0,-0.8921933085501859,269,0
22400002,1,248,8.0,1.935483870967742,720,472
22400002,1,117,3.0,1.5384615384615383,458,341
22400002,1,12,0.0,0.0,334,322
22400002,1,65,0.0,0.0,306,241
22400002,1,21,-2.0,-5.7142857142857135,228,207
22400002,1,165,4.0,1.4545454545454546,165,0
22400002,2,239,2.0,0.502092050209205,720,481
22400002,2,16,-3.0,-11.25,474,458
22400002,2,158,-6.0,-2.278481012658228,457,299
22400002,2,73,1.0,0.821917808219178,283,210
22400002,2,112,3.0,1.607142857142857,210,98
22400002,3,194,-1.0,-0.30927835051546393,720,526
22400002,3,108,-3.0,-1.6666666666666665,526,418
22400002,3,17,-1.0,-3.5294117647058822,401,384
22400002,3,46,2.0,2.608695652173913,384,338
22400002,3,35,-3.0,-5.142857142857143,323,288
22400002,3,133,-1.0,-0.45112781954887216,268,135
22400002,3,116,4.0,2.0689655172413794,116,0
22400002,4,89,3.0,2.0224719101123596,720,631
22400002,4,29,2.0,4.137931034482759,626,597
22400002,4,101,-4.0,-2.376237623762376,589,488
22400002,4,168,1.0,0.3571428571428571,466,298
22400002,4,135,-2.0,-0.888888888888889,279,144
22400002,4,112,-4.0,-2.142857142857143,144,32
22400002,4,1,0.0,0.0,1,0
22400002,5,113,0.0,0.0,300,187
22400002,5,131,-3.0,-1.3740458015267176,187,56
22400002,5,16,-1.0,-3.75,56,40
22400002,5,2,0.0,0.0,17,15
22400003,1,264,-1.0,-0.2272727272727273,720,456
22400003,1,131,5.0,2.290076335877863,456,325
22400003,1,42,-2.0,-2.8571428571428568,304,262
22400003,1,20,0.0,0.0,252,232
22400003,1,18,-1.0,-3.333333333333333,228,210
22400003,1,115,-4.0,-2.0869565217391304,210,95
22400003,1,95,3.0,1.8947368421052633,95,0
22400003,2,131,-1.0,-0.4580152671755725,720,589
22400003,2,31,2.0,3.870967741935484,575,544
22400003,2,59,2.0,2.0338983050847457,537,478
22400003,2,66,0.0,0.0,478,412
22400003,2,32,0.0,0.0,401,369
22400003,2,29,2.0,4.137931034482759,366,337
22400003,2,87,6.0,4.137931034482759,322,235
22400003,2,172,-1.0,-0.3488372093023256,235,63
22400003,2,63,-3.0,-2.8571428571428568,63,0
22400003,3,238,1.0,0.25210084033613445,720,482
22400003,3,96,-2.0,-1.25,470,374
22400003,3,68,1.0,0.8823529411764706,374,306
22400003,3,72,1.0,0.8333333333333333,306,234
22400003,3,108,7.0,3.888888888888889,222,114
22400003,3,114,4.0,2.1052631578947367,114,0
22400003,4,78,2.0,1.5384615384615383,720,642
22400003,4,147,5.0,2.0408163265306123,642,495
22400003,4,28,0.0,0.0,478,450
22400003,4,59,-2.0,-2.0338983050847457,433,374
22400003,4,105,-2.0,-1.142857142857143,364,259
22400003,4,34,3.0,5.294117647058824,248,214
22400003,4,85,1.0,0.7058823529411764,203,118
22400003,4,112,-2.0,-1.0714285714285714,112,0
22400004,1,290,-8.0,-1.6551724137931034,720,430
22400004,1,89,3.0,2.0224719101123596,419,330
22400004,1,163,-2.0,-0.7361963190184049,299,136
22400004,1,105,5.0,2.8571428571428568,118,13
22400004,1,4,2.0,30.0,4,0
22400004,2,77,-1.0,-0.7792207792207793,720,643
22400004,2,132,-3.0,-1.3636363636363638,643,511
22400004,2,33,-2.0,-3.6363636363636367,511,478
22400004,2,19,1.0,3.1578947368421053,478,459
22400004,2,21,-1.0,-2.8571428571428568,459,438
22400004,2,41,2.0,2.926829268292683,438,397
22400004,2,15,2.0,8.0,385,370
22400004,2,241,-7.0,-1.7427385892116183,406,165
22400004,2,146,5.0,2.054794520547945,148,2
22400004,3,13,2.0,9.230769230769232,720,707
22400004,3,220,0.0,0.0,685,465
22400004,3,56,-5.0,-5.357142857142858,465,409
22400004,3,138,-3.0,-1.3043478260869565,392,254
22400004,3,19,2.0,6.315789473684211,252,233
22400004,3,14,0.0,0.0,149,135
22400004,3,86,4.0,2.7906976744186047,130,44
22400004,3,21,0.0,0.0,44,23
22400004,3,1,0.0,0.0,4,3
22400004,4,126,-2.0,-0.9523809523809523,720,594
22400004,4,68,-4.0,-3.5294117647058822,587,519
22400004,4,129,1.0,0.46511627906976744,510,381
22400004,4,330,0.0,0.0,366,36
22400004,4,36,0.0,0.0,36,0
22400005,1,126,0.0,0.0,720,594
22400005,1,247,7.0,1.7004048582995952,594,347
22400005,1,50,-2.0,-2.4,336,286
22400005,1,29,-1.0,-2.0689655172413794,282,253
22400005,1,87,-1.0,-0.6896551724137931,253,166
22400005,1,117,2.0,1.0256410256410258,149,32
22400005,2,71,0.0,0.0,720,649
22400005,2,138,2.0,0.8695652173913043,631,493
22400005,2,189,-3.0,-0.9523809523809523,611,422
22400005,2,73,2.0,1.643835616438356,422,349
22400005,2,25,2.0,4.8,349,324
22400005,2,276,5.0,1.0869565217391304,322,46
22400005,3,326,-2.0,-0.36809815950920244,720,394
22400005,3,86,2.0,1.3953488372093024,377,291
22400005,3,2,2.0,60.0,272,270
22400005,3,15,0.0,0.0,270,255
22400005,3,44,0.0,0.0,239,195
22400005,3,25,0.0,0.0,181,156
22400005,3,150,3.0,1.2,150,0
22400005,4,23,2.0,5.217391304347826,720,697
22400005,4,56,5.0,5.357142857142858,686,630
22400005,4,85,-2.0,-1.4117647058823528,613,528
22400005,4,17,0.0,0.0,522,505
22400005,4,22,-4.0,-10.90909090909091,493,471
22400005,4,69,-2.0,-1.7391304347826086,448,379
22400005,4,23,-3.0,-7.826086956521739,370,347
22400005,4,213,3.0,0.8450704225352113,329,116
22400005,4,76,-1.0,-0.7894736842105263,109,33
22400006,1,412,-3.0,-0.4368932038834952,720,308
22400006,1,160,-7.0,-2.625,304,144
22400006,1,139,0.0,0.0,139,0
22400006,2,310,-5.0,-0.967741935483871,720,410
22400006,2,66,2.0,1.8181818181818183,397,331
22400006,2,40,0.0,0.0,315,275
22400006,2,69,-2.0,-1.7391304347826086,275,206
22400006,2,60,-1.0,-1.0,191,131
22400006,2,10,0.0,0.0,121,111
22400006,2,106,2.0,1.1320754716981132,111,5
22400006,3,297,3.0,0.6060606060606061,720,423
22400006,3,63,0.0,0.0,416,353
22400006,3,42,2.0,2.8571428571428568,346,304
22400006,3,40,0.0,0.0,284,244
22400006,3,49,-2.0,-2.4489795918367343,234,185
22400006,3,182,0.0,0.0,185,3
22400006,3,3,2.0,40.0,3,0
22400006,4,178,-5.0,-1.6853932584269662,720,542
22400006,4,82,1.0,0.7317073170731707,521,439
22400006,4,16,0.0,0.0,430,414
22400006,4,51,0.0,0.0,411,360
22400006,4,139,-2.0,-0.8633093525179857,360,221
22400006,4,176,1.0,0.34090909090909094,212,36
22400006,4,12,3.0,15.0,33,21
22400006,4,5,3.0,36.0,21,16
22400006,4,15,-2.0,-8.0,15,0
22400007,1,276,6.0,1.3043478260869565,720,444
22400007,1,30,0.0,0.0,436,406
22400007,1,15,-1.0,-4.0,406,391
22400007,1,63,6.0,5.7142857142857135,391,328
22400007,1,52,0.0,0.0,328,276
22400007,1,144,-1.0,-0.41666666666666663,266,122
22400007,2,140,0.0,0.0,720,580
22400007,2,49,-4.0,-4.897959183673469,580,531
22400007,2,63,-4.0,-3.8095238095238093,516,453
22400007,2,68,-6.0,-5.294117647058824,453,385
22400007,2,49,1.0,1.2244897959183672,369,320
22400007,2,21,0.0,0.0,320,299
22400007,2,9,0.0,0.0,279,270
22400007,2,59,-3.0,-3.050847457627119,258,199
22400007,2,86,3.0,2.0930232558139537,199,113
22400007,2,105,3.0,1.7142857142857142,113,8
22400007,2,8,0.0,0.0,8,0
22400007,3,226,7.0,1.8584070796460177,720,494
22400007,3,60,4.0,4.0,484,424
22400007,3,85,-1.0,-0.7058823529411764,424,339
22400007,3,37,-3.0,-4.864864864864865,329,292
22400007,3,11,0.0,0.0,292,281
22400007,3,119,2.0,1.0084033613445378,281,162
22400007,4,176,-4.0,-1.3636363636363638,720,544
22400007,4,31,-1.0,-1.935483870967742,544,513
22400007,4,122,-3.0,-1.4754098360655736,513,391
22400007,4,63,-4.0,-3.8095238095238093,379,316
22400007,4,33,-2.0,-3.6363636363636367,306,273
22400007,4,16,0.0,0.0,273,257
22400007,4,116,6.0,3.103448275862069,238,122
22400007,4,110,2.0,1.0909090909090908,110,0
22400008,1,305,-4.0,-0.7868852459016393,720,415
22400008,1,34,-1.0,-1.7647058823529411,393,359
22400008,1,198,3.0,0.9090909090909092,457,259
22400008,1,29,2.0,4.137931034482759,234,205
22400008,1,17,3.0,10.588235294117649,194,177
22400008,1,101,-4.0,-2.376237623762376,157,56
22400008,1,44,0.0,0.0,49,5
22400008,2,209,0.0,0.0,720,511
22400008,2,43,0.0,0.0,505,462
22400008,2,42,-2.0,-2.8571428571428568,449,407
22400008,2,43,0.0,0.0,399,356
22400008,2,101,-1.0,-0.594059405940594,349,248
22400008,2,96,1.0,0.625,248,152
22400008,2,99,1.0,0.6060606060606061,152,53
22400008,2,43,0.0,0.0,43,0
22400008,3,177,3.0,1.0169491525423728,720,543
22400008,3,152,1.0,0.39473684210526316,543,391
22400008,3,128,1.0,0.46875,391,263
22400008,3,31,0.0,0.0,253,222
22400008,3,129,4.0,1.8604651162790697,208,79
22400008,3,79,2.0,1.5189873417721518,79,0
22400008,4,58,-6.0,-6.206896551724138,720,662
22400008,4,104,1.0,0.576923076923077,641,537
22400008,4,112,-1.0,-0.5357142857142857,537,425
22400008,4,69,-3.0,-2.608695652173913,425,356
22400008,4,130,5.0,2.307692307692308,356,226
22400008,4,4,1.0,15.0,226,222
22400008,4,133,-3.0,-1.3533834586466165,222,89
22400008,4,63,-2.0,-1.9047619047619047,63,0
22400009,1,335,-1.0,-0.1791044776119403,720,385
22400009,1,12,-2.0,-10.0,374,362
22400009,1,106,1.0,0.5660377358490566,362,256
22400009,1,83,1.0,0.7228915662650602,250,167
22400009,1,11,0.0,0.0,163,152
22400009,1,152,2.0,0.7894736842105263,152,0
22400009,2,214,-6.0,-1.6822429906542056,720,506
22400009,2,42,-3.0,-4.285714285714286,506,464
22400009,2,52,5.0,5.769230769230769,457,405
22400009,2,18,-1.0,-3.333333333333333,396,378
22400009,2,189,-1.0,-0.31746031746031744,378,189
22400009,2,12,-1.0,-5.0,178,166
22400009,2,78,0.0,0.0,166,88
22400009,3,298,-11.0,-2.214765100671141,720,422
22400009,3,95,-2.0,-1.263157894736842,413,318
22400009,3,43,0.0,0.0,307,264
22400009,3,57,5.0,5.263157894736842,255,198
22400009,3,20,2.0,6.0,188,168
22400009,3,146,-3.0,-1.2328767123287672,146,0
22400009,4,247,-1.0,-0.24291497975708504,720,473
22400009,4,115,-6.0,-3.1304347826086953,473,358
22400009,4,332,7.0,1.2650602409638554,341,9
22400009,4,9,0.0,0.0,9,0
22400010,1,286,3.0,0.6293706293706294,720,434
22400010,1,49,0.0,0.0,434,385
22400010,1,77,1.0,0.7792207792207793,370,293
22400010,1,87,5.0,3.4482758620689653,282,195
22400010,1,30,2.0,4.0,181,151
22400010,1,81,-2.0,-1.4814814814814814,139,58
22400010,2,144,-8.0,-3.333333333333333,720,576
22400010,2,94,4.0,2.5531914893617023,567,473
22400010,2,73,2.0,1.643835616438356,455,382
22400010,2,130,-4.0,-1.8461538461538463,374,244
22400010,2,42,-3.0,-4.285714285714286,238,196
22400010,2,169,-1.0,-0.35502958579881655,187,18
22400010,2,2,0.0,0.0,2,0
22400010,3,352,-7.0,-1.1931818181818181,720,368
22400010,3,50,-1.0,-1.2,353,303
22400010,3,44,-3.0,-4.090909090909091,298,254
22400010,3,36,1.0,1.6666666666666665,254,218
22400010,3,104,0.0,0.0,218,114
22400010,3,86,5.0,3.488372093023256,114,28
22400010,3,1,0.0,0.0,28,27
22400010,3,25,2.0,4.8,25,0
22400010,4,160,5.0,1.875,720,560
22400010,4,86,1.0,0.6976744186046512,560,474
22400010,4,29,1.0,2.0689655172413794,451,422
22400010,4,126,-5.0,-2.380952380952381,422,296
22400010,4,30,1.0,2.0,285,255
22400010,4,65,6.0,5.538461538461538,255,190
22400010,4,91,3.0,1.978021978021978,164,73
22400010,4,61,-1.0,-0.9836065573770493,61,0
22400011,1,308,-1.0,-0.19480519480519481,720,412
22400011,1,59,6.0,6.101694915254238,392,333
22400011,1,57,1.0,1.0526315789473684,333,276
22400011,1,93,1.0,0.6451612903225807,276,183
22400011,1,86,-2.0,-1.3953488372093024,169,83
22400011,1,83,-7.0,-5.0602409638554215,83,0
22400011,2,98,-2.0,-1.2244897959183672,720,622
22400011,2,70,2.0,1.7142857142857142,610,540
22400011,2,36,1.0,1.6666666666666665,540,504
22400011,2,102,-1.0,-0.5882352941176471,504,402
22400011,2,26,0.0,0.0,402,376
22400011,2,45,0.0,0.0,372,327
22400011,2,53,1.0,1.1320754716981132,327,274
22400011,2,145,-2.0,-0.8275862068965517,274,129
22400011,2,50,0.0,0.0,114,64
22400011,2,27,3.0,6.666666666666666,64,37
22400011,2,37,-2.0,-3.2432432432432434,37,0
22400011,3,74,2.0,1.6216216216216217,720,646
22400011,3,217,6.0,1.6589861751152075,646,429
22400011,3,72,-1.0,-0.8333333333333333,429,357
22400011,3,79,0.0,0.0,357,278
22400011,3,85,2.0,1.4117647058823528,270,185
22400011,3,12,0.0,0.0,178,166
22400011,3,6,-2.0,-20.0,6,0
22400011,4,69,-3.0,-2.608695652173913,720,651
22400011,4,128,-1.0,-0.46875,626,498
22400011,4,156,-7.0,-2.6923076923076925,481,325
22400011,4,225,4.0,1.0666666666666667,306,81
22400011,4,31,2.0,3.870967741935484,68,37
22400011,4,6,0.0,0.0,21,15
22400011,4,1,0.0,0.0,13,12
22400011,4,2,0.0,0.0,9,7
22400011,4,7,0.0,0.0,7,0
22400012,1,286,-6.0,-1.2587412587412588,720,434
22400012,1,75,-6.0,-4.8,423,348
22400012,1,77,-4.0,-3.116883116883117,343,266
22400012,1,36,-2.0,-3.333333333333333,251,215
22400012,1,191,2.0,0.6282722513089005,191,0
22400012,2,135,8.0,3.555555555555556,720,585
22400012,2,74,0.0,0.0,564,490
22400012,2,35,0.0,0.0,490,455
22400012,2,167,4.0,1.437125748502994,442,275
22400012,2,166,8.0,2.891566265060241,251,85
22400012,3,224,1.0,0.26785714285714285,720,496
22400012,3,91,1.0,0.6593406593406594,496,405
22400012,3,82,2.0,1.4634146341463414,399,317
22400012,3,18,1.0,3.333333333333333,317,299
22400012,3,125,6.0,2.88,299,174
22400012,3,34,1.0,1.7647058823529411,172,138
22400012,3,15,1.0,4.0,138,123
22400012,3,123,-1.0,-0.48780487804878053,123,0
22400012,4,125,2.0,0.96,720,595
22400012,4,62,3.0,2.903225806451613,595,533
22400012,4,63,4.0,3.8095238095238093,533,470
22400012,4,62,-2.0,-1.935483870967742,456,394
22400012,4,144,0.0,0.0,379,235
22400012,4,225,-7.0,-1.8666666666666667,231,6
22400012,4,6,-2.0,-20.0,6,0
22400013,1,208,5.0,1.4423076923076923,720,512
22400013,1,49,0.0,0.0,500,451
22400013,1,87,-1.0,-0.6896551724137931,451,364
22400013,1,201,5.0,1.492537313432836,347,146
22400013,1,24,0.0,0.0,127,103
22400013,1,67,1.0,0.8955223880597015,85,18
22400013,1,11,-1.0,-5.454545454545455,18,7
22400013,1,7,2.0,17.142857142857142,7,0
22400013,2,37,0.0,0.0,720,683
22400013,2,72,4.0,3.333333333333333,683,611
22400013,2,18,-2.0,-6.666666666666666,611,593
22400013,2,24,-1.0,-2.5,586,562
22400013,2,44,0.0,0.0,562,518
22400013,2,50,-1.0,-1.2,498,448
22400013,2,105,-2.0,-1.142857142857143,432,327
22400013,2,57,5.0,5.263157894736842,313,256
22400013,2,62,-2.0,-1.935483870967742,246,184
22400013,2,8,2.0,15.0,159,151
22400013,2,151,-3.0,-1.1920529801324504,151,0
22400013,3,116,0.0,0.0,720,604
22400013,3,19,1.0,3.1578947368421053,595,576
22400013,3,144,-5.0,-2.0833333333333335,576,432
22400013,3,21,0.0,0.0,418,397
22400013,3,17,0.0,0.0,381,364
22400013,3,58,-2.0,-2.0689655172413794,364,306
22400013,3,113,6.0,3.185840707964602,306,193
22400013,3,5,0.0,0.0,181,176
22400013,3,5,-1.0,-12.0,161,156
22400013,3,63,3.0,2.8571428571428568,156,93
22400013,3,74,-4.0,-3.2432432432432434,93,19
22400013,3,19,-2.0,-6.315789473684211,19,0
22400013,4,154,-2.0,-0.7792207792207793,720,566
22400013,4,90,-2.0,-1.3333333333333335,566,476
22400013,4,56,5.0,5.357142857142858,466,410
22400013,4,50,2.0,2.4,395,345
22400013,4,114,-4.0,-2.1052631578947367,334,220
22400013,4,174,8.0,2.7586206896551726,220,46
22400013,4,46,3.0,3.9130434782608696,46,0
22400014,1,394,-4.0,-0.6091370558375634,720,326
22400014,1,130,5.0,2.307692307692308,309,179
22400014,1,161,3.0,1.1180124223602486,161,0
22400014,2,85,2.0,1.4117647058823528,720,635
22400014,2,124,-2.0,-0.967741935483871,558,434
22400014,2,21,0.0,0.0,423,402
22400014,2,85,1.0,0.7058823529411764,382,297
22400014,2,88,2.0,1.3636363636363638,286,198
22400014,2,198,-2.0,-0.6060606060606061,198,0
22400014,3,275,4.0,0.8727272727272727,720,445
22400014,3,46,0.0,0.0,436,390
22400014,3,25,0.0,0.0,387,362
22400014,3,123,7.0,3.4146341463414633,362,239
22400014,3,45,0.0,0.0,227,182
22400014,3,7,-1.0,-8.571428571428571,182,175
22400014,3,126,8.0,3.8095238095238093,175,49
22400014,3,30,-3.0,-6.0,30,0
22400014,4,41,1.0,1.4634146341463414,720,679
22400014,4,50,-6.0,-7.199999999999999,679,629
22400014,4,56,-5.0,-5.357142857142858,615,559
22400014,4,49,-3.0,-3.673469387755102,545,496
22400014,4,79,4.0,3.0379746835443036,496,417
22400014,4,86,-1.0,-0.6976744186046512,405,319
22400014,4,64,1.0,0.9375,319,255
22400014,4,16,0.0,0.0,255,239
22400014,4,227,-4.0,-1.0572687224669604,227,0
22400015,1,337,8.0,1.42433234421365,720,383
22400015,1,84,-2.0,-1.4285714285714284,383,299
22400015,1,38,2.0,3.1578947368421053,299,261
22400015,1,36,2.0,3.333333333333333,256,220
22400015,1,103,-3.0,-1.7475728155339807,210,107
22400015,1,42,-3.0,-4.285714285714286,107,65
22400015,1,65,-4.0,-3.6923076923076925,65,0
22400015,2,205,-3.0,-0.8780487804878049,720,515
22400015,2,47,3.0,3.829787234042553,495,448
22400015,2,88,-3.0,-2.0454545454545454,423,335
22400015,2,5,0.0,0.0,323,318
22400015,2,54,2.0,2.2222222222222223,269,215
22400015,2,54,0.0,0.0,206,152
22400015,2,105,-2.0,-1.142857142857143,133,28
22400015,3,349,4.0,0.6876790830945558,720,371
22400015,3,24,0.0,0.0,368,344
22400015,3,69,1.0,0.8695652173913043,329,260
22400015,3,1,0.0,0.0,247,246
22400015,3,56,0.0,0.0,224,168
22400015,3,66,-3.0,-2.7272727272727275,168,102
22400015,4,217,6.0,1.6589861751152075,720,503
22400015,4,16,0.0,0.0,492,476
22400015,4,23,0.0,0.0,476,453
22400015,4,37,0.0,0.0,438,401
22400015,4,116,3.0,1.5517241379310345,401,285
22400015,4,10,0.0,0.0,268,258
22400015,4,34,-1.0,-1.7647058823529411,258,224
22400015,4,3,0.0,0.0,207,204
22400015,4,30,3.0,6.0,168,138
22400015,4,113,-5.0,-2.6548672566371683,138,25
22400015,4,11,-2.0,-10.90909090909091,11,0
22400016,1,306,5.0,0.9803921568627452,720,414
22400016,1,109,3.0,1.651376146788991,401,292
22400016,1,20,1.0,3.0,278,258
22400016,1,55,1.0,1.0909090909090908,258,203
22400016,1,32,-1.0,-1.875,180,148
22400016,2,214,-7.0,-1.9626168224299063,720,506
22400016,2,20,1.0,3.0,492,472
22400016,2,77,6.0,4.675324675324675,472,395
22400016,2,319,6.0,1.1285266457680252,380,61
22400016,2,14,3.0,12.857142857142856,57,43
22400016,2,43,0.0,0.0,43,0
22400016,3,378,0.0,0.0,720,342
22400016,3,45,-3.0,-4.0,342,297
22400016,3,39,0.0,0.0,283,244
22400016,3,69,0.0,0.0,244,175
22400016,3,156,0.0,0.0,156,0
22400016,4,97,1.0,0.6185567010309279,720,623
22400016,4,54,-4.0,-4.444444444444445,616,562
22400016,4,43,0.0,0.0,540,497
22400016,4,115,-2.0,-1.0434782608695652,485,370
22400016,4,116,6.0,3.103448275862069,370,254
22400016,4,68,5.0,4.411764705882353,254,186
22400016,4,12,-1.0,-5.0,186,174
22400016,4,23,0.0,0.0,174,151
22400016,4,109,-4.0,-2.2018348623853212,138,29
22400017,1,335,-1.0,-0.1791044776119403,720,385
22400017,1,30,-2.0,-4.0,373,343
22400017,1,54,0.0,0.0,343,289
22400017,1,39,0.0,0.0,246,207
22400017,1,10,4.0,24.0,193,183
22400017,1,121,4.0,1.9834710743801653,167,46
22400017,2,171,-1.0,-0.3508771929824561,720,549
22400017,2,26,-2.0,-4.615384615384616,542,516
22400017,2,10,-3.0,-18.0,508,498
22400017,2,73,-1.0,-0.821917808219178,480,407
22400017,2,84,4.0,2.8571428571428568,400,316
22400017,2,66,-2.0,-1.8181818181818183,301,235
22400017,2,17,0.0,0.0,235,218
22400017,2,204,-3.0,-0.8823529411764706,204,0
22400017,3,251,2.0,0.47808764940239046,720,469
22400017,3,19,-2.0,-6.315789473684211,466,447
22400017,3,24,-1.0,-2.5,422,398
22400017,3,114,-2.0,-1.0526315789473684,398,284
22400017,3,74,2.0,1.6216216216216217,269,195
22400017,3,25,0.0,0.0,178,153
22400017,3,52,2.0,2.307692307692308,144,92
22400017,4,102,3.0,1.7647058823529411,720,618
22400017,4,165,-5.0,-1.8181818181818183,597,432
22400017,4,137,2.0,0.875912408759124,418,281
22400017,4,267,1.0,0.2247191011235955,267,0
22400018,1,266,5.0,1.1278195488721803,720,454
22400018,1,101,2.0,1.188118811881188,454,353
22400018,1,75,6.0,4.8,336,261
22400018,1,129,6.0,2.7906976744186047,246,117
22400018,1,24,0.0,0.0,117,93
22400018,1,83,-2.0,-1.4457831325301205,83,0
22400018,2,101,-2.0,-1.188118811881188,720,619
22400018,2,44,2.0,2.7272727272727275,619,575
22400018,2,99,-2.0,-1.2121212121212122,575,476
22400018,2,39,1.0,1.5384615384615383,463,424
22400018,2,96,2.0,1.25,424,328
22400018,2,36,0.0,0.0,328,292
22400018,2,110,-2.0,-1.0909090909090908,273,163
22400018,2,131,-2.0,-0.916030534351145,156,25
22400018,2,3,0.0,0.0,3,0
22400018,3,274,7.0,1.532846715328467,720,446
22400018,3,48,0.0,0.0,446,398
22400018,3,119,-3.0,-1.5126050420168067,398,279
22400018,3,186,6.0,1.935483870967742,279,93
22400018,3,93,1.0,0.6451612903225807,93,0
22400018,4,60,0.0,0.0,720,660
22400018,4,40,0.0,0.0,654,614
22400018,4,95,2.0,1.263157894736842,614,519
22400018,4,58,-3.0,-3.103448275862069,519,461
22400018,4,35,1.0,1.7142857142857142,461,426
22400018,4,39,0.0,0.0,426,387
22400018,4,5,-1.0,-12.0,370,365
22400018,4,54,4.0,4.444444444444445,365,311
22400018,4,47,-2.0,-2.5531914893617023,300,253
22400018,4,199,-1.0,-0.30150753768844224,199,0
22400019,1,201,-1.0,-0.29850746268656714,720,519
22400019,1,84,9.0,6.428571428571428,500,416
22400019,1,74,0.0,0.0,395,321
22400019,1,150,-3.0,-1.2,305,155
22400019,1,118,4.0,2.0338983050847457,155,37
22400019,1,29,0.0,0.0,29,0
22400019,2,149,8.0,3.221476510067114,720,571
22400019,2,123,-1.0,-0.48780487804878053,556,433
22400019,2,64,0.0,0.0,416,352
22400019,2,89,5.0,3.3707865168539324,340,251
22400019,2,28,-2.0,-4.285714285714286,246,218
22400019,2,52,0.0,0.0,202,150
22400019,2,20,0.0,0.0,138,118
22400019,2,6,0.0,0.0,106,100
22400019,2,7,0.0,0.0,59,52
22400019,3,179,7.0,2.346368715083799,720,541
22400019,3,35,-1.0,-1.7142857142857142,522,487
22400019,3,61,-3.0,-2.9508196721311473,487,426
22400019,3,8,0.0,0.0,409,401
22400019,3,16,0.0,0.0,393,377
22400019,3,35,-2.0,-3.4285714285714284,373,338
22400019,3,89,0.0,0.0,333,244
22400019,3,50,3.0,3.5999999999999996,244,194
22400019,3,7,-1.0,-8.571428571428571,194,187
22400019,3,124,-1.0,-0.4838709677419355,154,30
22400019,3,10,0.0,0.0,26,16
22400019,3,16,3.0,11.25,16,0
22400019,4,63,2.0,1.9047619047619047,720,657
22400019,4,116,1.0,0.5172413793103449,641,525
22400019,4,29,3.0,6.206896551724138,517,488
22400019,4,20,1.0,3.0,488,468
22400019,4,37,0.0,0.0,468,431
22400019,4,43,-2.0,-2.7906976744186047,411,368
22400019,4,117,-2.0,-1.0256410256410258,368,251
22400019,4,106,-7.0,-3.9622641509433962,241,135
22400019,4,61,-3.0,-2.9508196721311473,135,74
22400019,4,51,-2.0,-2.3529411764705883,74,23
22400019,4,11,-2.0,-10.90909090909091,18,7
22400019,4,5,-2.0,-24.0,5,0
22400020,1,341,-4.0,-0.7038123167155426,720,379
22400020,1,41,-2.0,-2.926829268292683,363,322
22400020,1,113,1.0,0.5309734513274336,308,195
22400020,1,156,0.0,0.0,156,0
22400020,2,230,-2.0,-0.5217391304347826,720,490
22400020,2,66,-2.0,-1.8181818181818183,477,411
22400020,2,39,-2.0,-3.0769230769230766,411,372
22400020,2,138,3.0,1.3043478260869565,350,212
22400020,2,196,-1.0,-0.3061224489795918,197,1
22400020,2,1,0.0,0.0,1,0
22400020,3,172,-8.0,-2.7906976744186047,720,548
22400020,3,22,-2.0,-5.454545454545455,529,507
22400020,3,182,2.0,0.6593406593406594,499,317
22400020,3,31,1.0,1.935483870967742,305,274
22400020,3,31,2.0,3.870967741935484,263,232
22400020,3,38,-2.0,-3.1578947368421053,222,184
22400020,3,176,1.0,0.34090909090909094,176,0
22400020,4,33,3.0,5.454545454545455,720,687
22400020,4,126,9.0,4.285714285714286,687,561
22400020,4,109,3.0,1.651376146788991,553,444
22400020,4,105,0.0,0.0,433,328
22400020,4,26,2.0,4.615384615384616,328,302
22400020,4,36,-2.0,-3.333333333333333,288,252
22400020,4,87,3.0,2.0689655172413794,252,165
22400020,4,114,-4.0,-2.1052631578947367,152,38
22400020,4,4,0.0,0.0,20,16
22400020,5,89,-6.0,-4.044943820224719,300,211
22400020,5,102,0.0,0.0,188,86
22400020,5,84,-1.0,-0.7142857142857142,86,2
22400021,1,407,12.0,1.769041769041769,720,313
22400021,1,25,0.0,0.0,293,268
22400021,1,79,-6.0,-4.556962025316456,263,184
22400021,1,168,0.0,0.0,168,0
22400021,2,218,-1.0,-0.27522935779816515,720,502
22400021,2,164,3.0,1.097560975609756,502,338
22400021,2,35,-2.0,-3.4285714285714284,305,270
22400021,2,30,3.0,6.0,270,240
22400021,2,217,7.0,1.935483870967742,220,3
22400021,2,1,0.0,0.0,1,0
22400021,3,305,-1.0,-0.19672131147540983,720,415
22400021,3,67,-3.0,-2.6865671641791042,393,326
22400021,3,54,-4.0,-4.444444444444445,326,272
22400021,3,67,-4.0,-3.582089552238806,272,205
22400021,3,56,-3.0,-3.214285714285714,188,132
22400021,3,132,-1.0,-0.4545454545454546,132,0
22400021,4,178,0.0,0.0,720,542
22400021,4,62,1.0,0.967741935483871,542,480
22400021,4,21,-3.0,-8.571428571428571,480,459
22400021,4,2,0.0,0.0,413,411
22400021,4,68,3.0,2.647058823529412,397,329
22400021,4,26,-2.0,-4.615384615384616,313,287
22400021,4,276,-2.0,-0.43478260869565216,276,0
22400022,1,208,-9.0,-2.5961538461538463,720,512
22400022,1,120,-2.0,-1.0,500,380
22400022,1,36,3.0,5.0,380,344
22400022,1,35,0.0,0.0,327,292
22400022,1,12,-1.0,-5.0,290,278
22400022,1,80,-3.0,-2.25,278,198
22400022,1,192,-1.0,-0.3125,192,0
22400022,2,71,-1.0,-0.8450704225352113,720,649
22400022,2,109,-2.0,-1.1009174311926606,642,533
22400022,2,167,3.0,1.0778443113772456,515,348
22400022,2,1,0.0,0.0,333,332
22400022,2,35,0.0,0.0,317,282
22400022,2,45,2.0,2.666666666666667,269,224
22400022,2,47,1.0,1.2765957446808511,209,162
22400022,2,57,-3.0,-3.1578947368421053,102,45
22400022,3,259,11.0,2.548262548262548,720,461
22400022,3,8,0.0,0.0,446,438
22400022,3,52,2.0,2.307692307692308,438,386
22400022,3,120,-1.0,-0.5,379,259
22400022,3,34,1.0,1.7647058823529411,259,225
22400022,3,52,-1.0,-1.153846153846154,209,157
22400022,3,32,-3.0,-5.625,149,117
22400022,3,102,-4.0,-2.3529411764705883,117,15
22400022,3,15,2.0,8.0,15,0
22400022,4,125,-3.0,-1.44,720,595
22400022,4,142,-1.0,-0.4225352112676056,577,435
22400022,4,129,1.0,0.46511627906976744,416,287
22400022,4,43,0.0,0.0,271,228
22400022,4,22,0.0,0.0,205,183
22400022,4,87,-1.0,-0.6896551724137931,177,90
22400022,4,33,2.0,3.6363636363636367,90,57
22400022,4,19,2.0,6.315789473684211,57,38
22400022,4,22,-2.0,-5.454545454545455,35,13
22400022,4,1,0.0,0.0,6,5
22400022,4,1,-2.0,-120.0,1,0
22400023,1,251,-2.0,-0.47808764940239046,720,469
22400023,1,23,-1.0,-2.608695652173913,459,436
22400023,1,10,0.0,0.0,436,426
22400023,1,109,1.0,0.5504587155963303,424,315
22400023,1,74,-4.0,-3.2432432432432434,315,241
22400023,1,34,4.0,7.0588235294117645,241,207
22400023,1,90,2.0,1.3333333333333335,207,117
22400023,1,45,1.0,1.3333333333333335,117,72
22400023,1,35,-2.0,-3.4285714285714284,60,25
22400023,2,221,-2.0,-0.5429864253393666,720,499
22400023,2,75,0.0,0.0,488,413
22400023,2,17,2.0,7.0588235294117645,413,396
22400023,2,74,-1.0,-0.8108108108108109,396,322
22400023,2,28,4.0,8.571428571428571,319,291
22400023,2,52,-2.0,-2.307692307692308,279,227
22400023,2,16,-1.0,-3.75,210,194
22400023,2,107,1.0,0.5607476635514018,177,70
22400023,2,70,-3.0,-2.5714285714285716,70,0
22400023,3,144,-5.0,-2.0833333333333335,720,576
22400023,3,17,0.0,0.0,576,559
22400023,3,24,0.0,0.0,546,522
22400023,3,75,-5.0,-4.0,511,436
22400023,3,16,0.0,0.0,427,411
22400023,3,34,0.0,0.0,395,361
22400023,3,103,3.0,1.7475728155339807,361,258
22400023,3,71,2.0,1.6901408450704225,241,170
22400023,3,170,4.0,1.4117647058823528,170,0
22400023,4,53,3.0,3.3962264150943398,720,667
22400023,4,41,0.0,0.0,667,626
22400023,4,58,-1.0,-1.0344827586206897,616,558
22400023,4,5,-2.0,-24.0,544,539
22400023,4,78,1.0,0.7692307692307692,517,439
22400023,4,46,3.0,3.9130434782608696,429,383
22400023,4,18,3.0,10.0,370,352
22400023,4,112,-2.0,-1.0714285714285714,332,220
22400023,4,34,2.0,3.5294117647058822,220,186
22400023,4,20,-3.0,-9.0,172,152
22400023,4,7,0.0,0.0,152,145
22400023,4,140,2.0,0.8571428571428571,145,5
22400024,1,310,11.0,2.129032258064516,720,410
22400024,1,29,0.0,0.0,410,381
22400024,1,143,-1.0,-0.4195804195804196,377,234
22400024,1,18,0.0,0.0,171,153
22400024,1,33,-1.0,-1.8181818181818183,134,101
22400024,1,82,1.0,0.7317073170731707,101,19
22400024,1,19,3.0,9.473684210526315,19,0
22400024,2,143,1.0,0.4195804195804196,720,577
22400024,2,63,2.0,1.9047619047619047,562,499
22400024,2,21,3.0,8.571428571428571,489,468
22400024,2,171,-8.0,-2.807017543859649,451,280
22400024,2,86,1.0,0.6976744186046512,250,164
22400024,2,84,1.0,0.7142857142857142,164,80
22400024,2,41,-2.0,-2.926829268292683,80,39
22400024,2,26,-2.0,-4.615384615384616,30,4
22400024,3,394,7.0,1.0659898477157361,720,326
22400024,3,50,-2.0,-2.4,316,266
22400024,3,78,0.0,0.0,266,188
22400024,3,164,8.0,2.926829268292683,180,16
22400024,3,16,0.0,0.0,16,0
22400024,4,188,4.0,1.2765957446808511,720,532
22400024,4,56,3.0,3.214285714285714,532,476
22400024,4,35,0.0,0.0,459,424
22400024,4,30,2.0,4.0,411,381
22400024,4,11,0.0,0.0,381,370
22400024,4,118,-1.0,-0.5084745762711864,360,242
22400024,4,33,3.0,5.454545454545455,191,158
22400025,1,402,-6.0,-0.8955223880597015,720,318
22400025,1,121,7.0,3.4710743801652892,300,179
22400025,1,95,-1.0,-0.631578947368421,179,84
22400025,1,45,-4.0,-5.333333333333334,78,33
22400025,2,298,-2.0,-0.40268456375838924,720,422
22400025,2,13,0.0,0.0,410,397
22400025,2,72,-1.0,-0.8333333333333333,397,325
22400025,2,172,5.0,1.744186046511628,305,133
22400025,2,126,4.0,1.9047619047619047,133,7
22400025,2,7,0.0,0.0,7,0
22400025,3,190,11.0,3.473684210526316,720,530
22400025,3,52,-1.0,-1.153846153846154,524,472
22400025,3,189,-1.0,-0.31746031746031744,472,283
22400025,3,45,0.0,0.0,281,236
22400025,3,123,2.0,0.9756097560975611,236,113
22400025,4,116,5.0,2.586206896551724,720,604
22400025,4,89,-7.0,-4.719101123595506,591,502
22400025,4,108,-2.0,-1.1111111111111112,484,376
22400025,4,36,-3.0,-5.0,360,324
22400025,4,11,0.0,0.0,311,300
22400025,4,30,0.0,0.0,288,258
22400025,4,13,1.0,4.615384615384616,245,232
22400025,4,22,-3.0,-8.181818181818182,232,210
22400025,4,167,-2.0,-0.718562874251497,187,20
22400026,1,347,10.0,1.7291066282420748,720,373
22400026,1,66,5.0,4.545454545454546,364,298
22400026,1,34,2.0,3.5294117647058822,289,255
22400026,1,61,-2.0,-1.9672131147540985,245,184
22400026,1,61,-1.0,-0.9836065573770493,166,105
22400026,1,105,-1.0,-0.5714285714285715,105,0
22400026,2,92,-2.0,-1.3043478260869565,720,628
22400026,2,63,-4.0,-3.8095238095238093,628,565
22400026,2,128,2.0,0.9375,565,437
22400026,2,22,0.0,0.0,417,395
22400026,2,99,2.0,1.2121212121212122,377,278
22400026,2,69,-2.0,-1.7391304347826086,278,209
22400026,2,14,0.0,0.0,209,195
22400026,2,36,2.0,3.333333333333333,185,149
22400026,2,136,2.0,0.8823529411764706,136,0
22400026,3,177,4.0,1.3559322033898304,720,543
22400026,3,156,1.0,0.3846153846153846,543,387
22400026,3,37,1.0,1.6216216216216217,375,338
22400026,3,39,-2.0,-3.0769230769230766,324,285
22400026,3,25,-2.0,-4.8,285,260
22400026,3,17,1.0,3.5294117647058822,260,243
22400026,3,8,0.0,0.0,243,235
22400026,3,222,11.0,2.972972972972973,222,0
22400026,4,200,-2.0,-0.6,720,520
22400026,4,55,2.0,2.1818181818181817,520,465
22400026,4,45,-6.0,-8.0,465,420
22400026,4,23,-1.0,-2.608695652173913,394,371
22400026,4,79,-4.0,-3.0379746835443036,371,292
22400026,4,55,3.0,3.2727272727272725,292,237
22400026,4,189,-1.0,-0.31746031746031744,206,17
22400026,4,12,-3.0,-15.0,12,0
22400027,1,289,4.0,0.8304498269896194,720,431
22400027,1,61,0.0,0.0,415,354
22400027,1,17,0.0,0.0,345,328
22400027,1,34,-3.0,-5.294117647058824,310,276
22400027,1,94,6.0,3.829787234042553,263,169
22400027,1,107,-4.0,-2.2429906542056073,156,49
22400027,1,49,0.0,0.0,49,0
22400027,2,141,-1.0,-0.425531914893617,720,579
22400027,2,17,1.0,3.5294117647058822,572,555
22400027,2,59,6.0,6.101694915254238,555,496
22400027,2,59,2.0,2.0338983050847457,470,411
22400027,2,47,2.0,2.5531914893617023,392,345
22400027,2,40,0.0,0.0,337,297
22400027,2,27,0.0,0.0,292,265
22400027,2,76,3.0,2.3684210526315788,260,184
22400027,2,165,-10.0,-3.6363636363636367,165,0
22400027,3,319,-11.0,-2.0689655172413794,720,401
22400027,3,19,0.0,0.0,392,373
22400027,3,68,4.0,3.5294117647058822,365,297
22400027,3,62,2.0,1.935483870967742,285,223
22400027,3,35,0.0,0.0,223,188
22400027,4,164,-5.0,-1.8292682926829267,720,556
22400027,4,64,-2.0,-1.875,546,482
22400027,4,84,-3.0,-2.142857142857143,471,387
22400027,4,53,5.0,5.660377358490567,377,324
22400027,4,96,5.0,3.125,310,214
22400027,4,206,8.0,2.3300970873786406,206,0
22400028,1,433,7.0,0.9699769053117784,720,287
22400028,1,37,-2.0,-3.2432432432432434,278,241
22400028,1,63,-1.0,-0.9523809523809523,239,176
22400028,1,158,-3.0,-1.139240506329114,158,0
22400028,2,199,6.0,1.809045226130653,720,521
22400028,2,62,2.0,1.935483870967742,521,459
22400028,2,40,2.0,3.0,459,419
22400028,2,12,-1.0,-5.0,413,401
22400028,2,93,-6.0,-3.870967741935484,401,308
22400028,2,62,-2.0,-1.935483870967742,294,232
22400028,2,12,0.0,0.0,219,207
22400028,2,131,-4.0,-1.83206106870229,207,76
22400028,2,76,3.0,2.3684210526315788,76,0
22400028,3,261,-1.0,-0.22988505747126436,720,459
22400028,3,47,0.0,0.0,451,404
22400028,3,59,0.0,0.0,404,345
22400028,3,131,1.0,0.4580152671755725,345,214
22400028,3,25,0.0,0.0,214,189
22400028,3,55,-3.0,-3.2727272727272725,178,123
22400028,3,59,-2.0,-2.0338983050847457,123,64
22400028,4,230,0.0,0.0,720,490
22400028,4,52,-2.0,-2.307692307692308,487,435
22400028,4,54,2.0,2.2222222222222223,413,359
22400028,4,103,1.0,0.5825242718446602,356,253
22400028,4,169,0.0,0.0,237,68
22400028,4,22,-2.0,-5.454545454545455,68,46
22400028,4,6,0.0,0.0,40,34
22400028,4,23,-4.0,-10.434782608695652,34,11
22400028,4,2,0.0,0.0,7,5
22400028,4,5,0.0,0.0,5,0
22400029,1,366,5.0,0.819672131147541,720,354
22400029,1,52,4.0,4.615384615384616,354,302
22400029,1,92,3.0,1.9565217391304348,287,195
22400029,1,115,0.0,0.0,151,36
22400029,1,36,3.0,5.0,36,0
22400029,2,264,-3.0,-0.6818181818181819,720,456
22400029,2,125,-2.0,-0.96,437,312
22400029,2,117,-5.0,-2.5641025641025643,285,168
22400029,2,123,7.0,3.4146341463414633,168,45
22400029,2,72,1.0,0.8333333333333333,99,27
22400029,2,27,3.0,6.666666666666666,27,0
22400029,3,341,4.0,0.7038123167155426,720,379
22400029,3,47,5.0,6.382978723404255,366,319
22400029,3,97,1.0,0.6185567010309279,310,213
22400029,3,25,0.0,0.0,199,174
22400029,3,164,-5.0,-1.8292682926829267,164,0
22400029,3,3,1.0,20.0,263,260
22400029,4,258,0.0,0.0,720,462
22400029,4,51,-2.0,-2.3529411764705883,462,411
22400029,4,34,-2.0,-3.5294117647058822,386,352
22400029,4,240,4.0,1.0,333,93
22400029,4,2,0.0,0.0,32,30
22400030,1,270,7.0,1.5555555555555556,720,450
22400030,1,44,1.0,1.3636363636363638,450,406
22400030,1,46,-2.0,-2.608695652173913,388,342
22400030,1,90,-1.0,-0.6666666666666667,325,235
22400030,1,34,0.0,0.0,207,173
22400030,1,167,5.0,1.7964071856287425,167,0
22400030,2,204,2.0,0.5882352941176471,720,516
22400030,2,50,-3.0,-3.5999999999999996,500,450
22400030,2,71,0.0,0.0,446,375
22400030,2,149,1.0,0.40268456375838924,355,206
22400030,2,135,6.0,2.666666666666667,198,63
22400030,3,295,2.0,0.4067796610169491,720,425
22400030,3,76,4.0,3.1578947368421053,322,246
22400030,3,52,0.0,0.0,246,194
22400030,3,191,-2.0,-0.6282722513089005,191,0
22400030,4,171,3.0,1.0526315789473684,720,549
22400030,4,23,2.0,5.217391304347826,533,510
22400030,4,24,2.0,5.0,510,486
22400030,4,13,-1.0,-4.615384615384616,477,464
22400030,4,23,2.0,5.217391304347826,349,326
22400030,4,37,-3.0,-4.864864864864865,318,281
22400030,4,268,-2.0,-0.44776119402985076,269,1
22400031,1,279,1.0,0.21505376344086022,720,441
22400031,1,153,1.0,0.39215686274509803,441,288
22400031,1,81,2.0,1.4814814814814814,276,195
22400031,1,61,0.0,0.0,195,134
22400031,1,99,5.0,3.0303030303030303,134,35
22400031,1,35,3.0,5.142857142857143,35,0
22400031,2,42,3.0,4.285714285714286,720,678
22400031,2,161,0.0,0.0,678,517
22400031,2,18,0.0,0.0,517,499
22400031,2,55,-1.0,-1.0909090909090908,487,432
22400031,2,88,-1.0,-0.6818181818181819,427,339
22400031,2,38,0.0,0.0,332,294
22400031,2,25,0.0,0.0,280,255
22400031,2,82,3.0,2.195121951219512,250,168
22400031,2,30,-1.0,-2.0,159,129
22400031,2,101,5.0,2.9702970297029703,129,28
22400031,2,28,0.0,0.0,28,0
22400031,3,197,5.0,1.5228426395939085,720,523
22400031,3,185,-9.0,-2.9189189189189193,510,325
22400031,3,47,5.0,6.382978723404255,325,278
22400031,3,48,2.0,2.5,259,211
22400031,3,41,1.0,1.4634146341463414,211,170
22400031,3,147,-1.0,-0.40816326530612246,170,23
22400031,4,191,4.0,1.256544502617801,720,529
22400031,4,70,-1.0,-0.8571428571428571,518,448
22400031,4,58,0.0,0.0,448,390
22400031,4,139,0.0,0.0,378,239
22400031,4,224,2.0,0.5357142857142857,224,0
22400032,1,296,2.0,0.40540540540540543,720,424
22400032,1,63,-3.0,-2.8571428571428568,407,344
22400032,1,82,-3.0,-2.195121951219512,337,255
22400032,1,71,-2.0,-1.6901408450704225,240,169
22400032,1,88,1.0,0.6818181818181819,151,63
22400032,1,43,0.0,0.0,54,11
22400032,2,56,-4.0,-4.285714285714286,720,664
22400032,2,147,7.0,2.8571428571428568,664,517
22400032,2,39,3.0,4.615384615384616,517,478
22400032,2,46,2.0,2.608695652173913,475,429
22400032,2,68,-2.0,-1.7647058823529411,423,355
22400032,2,220,0.0,0.0,355,135
22400032,3,314,1.0,0.1910828025477707,720,406
22400032,3,46,-5.0,-6.521739130434782,387,341
22400032,3,38,0.0,0.0,341,303
22400032,3,8,0.0,0.0,292,284
22400032,3,84,-1.0,-0.7142857142857142,273,189
22400032,3,24,-1.0,-2.5,189,165
22400032,3,165,2.0,0.7272727272727273,165,0
22400032,4,95,-2.0,-1.263157894736842,720,625
22400032,4,76,-1.0,-0.7894736842105263,625,549
22400032,4,109,-3.0,-1.651376146788991,526,417
22400032,4,43,0.0,0.0,411,368
22400032,4,55,1.0,1.0909090909090908,368,313
22400032,4,82,2.0,1.4634146341463414,313,231
22400032,4,99,0.0,0.0,218,119
22400032,4,84,2.0,1.4285714285714284,119,35
22400032,4,4,0.0,0.0,35,31
22400032,4,11,2.0,10.90909090909091,31,20
22400032,4,3,0.0,0.0,14,11
22400032,4,8,0.0,0.0,10,2
22400032,4,2,-1.0,-30.0,2,0
22400033,1,255,-6.0,-1.4117647058823528,720,465
22400033,1,83,-6.0,-4.337349397590361,451,368
22400033,1,46,2.0,2.608695652173913,368,322
22400033,1,32,-2.0,-3.75,317,285
22400033,1,136,-1.0,-0.4411764705882353,276,140
22400033,1,17,0.0,0.0,117,100
22400033,1,13,2.0,9.230769230769232,70,57
22400033,1,55,0.0,0.0,57,2
22400033,1,2,2.0,60.0,2,0
22400033,2,131,-3.0,-1.3740458015267176,720,589
22400033,2,75,-4.0,-3.2,574,499
22400033,2,18,0.0,0.0,488,470
22400033,2,24,-1.0,-2.5,456,432
22400033,2,128,-4.0,-1.875,432,304
22400033,2,17,0.0,0.0,297,280
22400033,2,49,-3.0,-3.673469387755102,256,207
22400033,2,187,-5.0,-1.6042780748663101,207,20
22400033,2,20,-2.0,-6.0,20,0
22400033,3,276,3.0,0.6521739130434783,720,444
22400033,3,55,5.0,5.454545454545455,432,377
22400033,3,135,7.0,3.111111111111111,356,221
22400033,3,44,-1.0,-1.3636363636363638,209,165
22400033,3,110,-1.0,-0.5454545454545454,154,44
22400033,3,9,-1.0,-6.666666666666666,36,27
22400033,4,155,2.0,0.7741935483870968,720,565
22400033,4,46,2.0,2.608695652173913,553,507
22400033,4,25,0.0,0.0,507,482
22400033,4,48,-1.0,-1.25,481,433
22400033,4,4,0.0,0.0,433,429
22400033,4,176,8.0,2.7272727272727275,429,253
22400033,4,53,0.0,0.0,253,200
22400033,4,136,-9.0,-3.9705882352941178,185,49
22400033,4,6,2.0,20.0,13,7
22400033,4,3,1.0,20.0,7,4
22400033,4,1,-2.0,-120.0,4,3
22400034,1,503,12.0,1.4314115308151094,720,217
22400034,1,38,0.0,0.0,217,179
22400034,1,124,2.0,0.967741935483871,179,55
22400034,2,158,3.0,1.139240506329114,720,562
22400034,2,41,-1.0,-1.4634146341463414,551,510
22400034,2,122,0.0,0.0,510,388
22400034,2,54,2.0,2.2222222222222223,372,318
22400034,2,144,2.0,0.8333333333333333,297,153
22400034,2,63,1.0,0.9523809523809523,153,90
22400034,2,90,-3.0,-2.0,90,0
22400034,3,374,-13.0,-2.085561497326203,720,346
22400034,3,59,3.0,3.050847457627119,346,287
22400034,3,116,3.0,1.5517241379310345,287,171
22400034,3,23,0.0,0.0,171,148
22400034,3,65,0.0,0.0,148,83
22400034,3,68,2.0,1.7647058823529411,70,2
22400034,4,68,4.0,3.5294117647058822,720,652
22400034,4,87,3.0,2.0689655172413794,631,544
22400034,4,52,-5.0,-5.769230769230769,537,485
22400034,4,58,1.0,1.0344827586206897,461,403
22400034,4,53,2.0,2.2641509433962264,391,338
22400034,4,94,-1.0,-0.6382978723404256,328,234
22400034,4,225,4.0,1.0666666666666667,225,0
22400035,1,252,-3.0,-0.7142857142857142,720,468
22400035,1,110,7.0,3.818181818181818,465,355
22400035,1,214,1.0,0.2803738317757009,342,128
22400035,1,66,-2.0,-1.8181818181818183,117,51
22400035,1,45,3.0,4.0,50,5
22400035,2,190,-6.0,-1.8947368421052633,720,530
22400035,2,49,1.0,1.2244897959183672,516,467
22400035,2,62,0.0,0.0,467,405
22400035,2,59,-3.0,-3.050847457627119,396,337
22400035,2,59,-4.0,-4.067796610169491,315,256
22400035,2,102,-2.0,-1.1764705882352942,256,154
22400035,2,150,-6.0,-2.4,150,0
22400035,3,250,-6.0,-1.44,720,470
22400035,3,64,3.0,2.8125,454,390
22400035,3,84,0.0,0.0,377,293
22400035,3,44,0.0,0.0,293,249
22400035,3,49,-2.0,-2.4489795918367343,234,185
22400035,3,59,4.0,4.067796610169491,185,126
22400035,3,85,1.0,0.7058823529411764,123,38
22400035,3,38,-3.0,-4.7368421052631575,38,0
22400035,4,201,-1.0,-0.29850746268656714,720,519
22400035,4,41,0.0,0.0,514,473
22400035,4,144,-1.0,-0.41666666666666663,458,314
22400035,4,82,-5.0,-3.6585365853658534,314,232
22400035,4,56,0.0,0.0,221,165
22400035,4,50,-1.0,-1.2,165,115
22400035,4,110,5.0,2.7272727272727275,115,5
22400036,1,365,-7.0,-1.1506849315068495,720,355
22400036,1,79,1.0,0.7594936708860759,355,276
22400036,1,31,2.0,3.870967741935484,276,245
22400036,1,27,0.0,0.0,227,200
22400036,1,71,0.0,0.0,193,122
22400036,1,49,-1.0,-1.2244897959183672,107,58
22400036,1,11,0.0,0.0,58,47
22400036,1,47,0.0,0.0,47,0
22400036,2,246,0.0,0.0,720,474
22400036,2,85,-1.0,-0.7058823529411764,474,389
22400036,2,105,-1.0,-0.5714285714285715,368,263
22400036,2,58,-1.0,-1.0344827586206897,263,205
22400036,2,69,0.0,0.0,184,115
22400036,2,103,-1.0,-0.5825242718446602,115,12
22400036,2,12,0.0,0.0,12,0
22400036,3,185,-8.0,-2.5945945945945947,720,535
22400036,3,93,1.0,0.6451612903225807,519,426
22400036,3,119,5.0,2.521008403361345,426,307
22400036,3,38,1.0,1.5789473684210527,307,269
22400036,3,74,5.0,4.054054054054054,248,174
22400036,3,162,3.0,1.1111111111111112,162,0
22400036,4,139,-4.0,-1.7266187050359714,720,581
22400036,4,77,4.0,3.116883116883117,564,487
22400036,4,15,0.0,0.0,462,447
22400036,4,95,3.0,1.8947368421052633,440,345
22400036,4,15,0.0,0.0,322,307
22400036,4,87,-1.0,-0.6896551724137931,307,220
22400036,4,175,1.0,0.34285714285714286,204,29
22400036,4,2,-1.0,-30.0,3,1
22400037,1,277,-5.0,-1.0830324909747293,720,443
22400037,1,60,0.0,0.0,443,383
22400037,1,62,-2.0,-1.935483870967742,369,307
22400037,1,64,5.0,4.6875,291,227
22400037,1,110,6.0,3.2727272727272725,223,113
22400037,1,85,-4.0,-2.8235294117647056,107,22
22400037,1,22,0.0,0.0,22,0
22400037,2,195,9.0,2.769230769230769,720,525
22400037,2,45,0.0,0.0,525,480
22400037,2,24,0.0,0.0,461,437
22400037,2,118,-1.0,-0.5084745762711864,427,309
22400037,2,148,0.0,0.0,293,145
22400037,2,125,-3.0,-1.44,132,7
22400037,2,7,0.0,0.0,7,0
22400037,3,280,-2.0,-0.42857142857142855,720,440
22400037,3,11,0.0,0.0,420,409
22400037,3,42,2.0,2.8571428571428568,397,355
22400037,3,67,-5.0,-4.477611940298507,344,277
22400037,3,83,0.0,0.0,261,178
22400037,3,16,0.0,0.0,178,162
22400037,3,150,9.0,3.5999999999999996,154,4
22400037,4,45,5.0,6.666666666666666,720,675
22400037,4,116,0.0,0.0,662,546
22400037,4,43,-4.0,-5.5813953488372094,546,503
22400037,4,197,2.0,0.6091370558375634,483,286
22400037,4,130,6.0,2.769230769230769,286,156
22400037,4,118,-3.0,-1.5254237288135595,146,28
22400037,4,15,0.0,0.0,15,0
22400037,5,246,-9.0,-2.195121951219512,300,54
22400037,5,16,1.0,3.75,49,33
22400037,5,33,-2.0,-3.6363636363636367,33,0
22400038,1,338,4.0,0.7100591715976331,720,382
22400038,1,116,1.0,0.5172413793103449,368,252
22400038,1,99,-3.0,-1.8181818181818183,252,153
22400038,1,123,-1.0,-0.48780487804878053,140,17
22400038,1,1,0.0,0.0,1,0
22400038,2,277,-7.0,-1.5162454873646207,720,443
22400038,2,31,2.0,3.870967741935484,422,391
22400038,2,101,6.0,3.564356435643564,384,283
22400038,2,16,0.0,0.0,272,256
22400038,2,30,-2.0,-4.0,245,215
22400038,2,14,0.0,0.0,215,201
22400038,2,62,0.0,0.0,195,133
22400038,2,55,-3.0,-3.2727272727272725,133,78
22400038,2,76,-2.0,-1.5789473684210527,76,0
22400038,3,396,7.0,1.0606060606060606,720,324
22400038,3,63,2.0,1.9047619047619047,324,261
22400038,3,46,-3.0,-3.9130434782608696,253,207
22400038,3,15,-1.0,-4.0,196,181
22400038,3,82,-3.0,-2.195121951219512,181,99
22400038,4,301,-7.0,-1.3953488372093024,720,419
22400038,4,82,-1.0,-0.7317073170731707,403,321
22400038,4,77,4.0,3.116883116883117,299,222
22400038,4,48,-2.0,-2.5,200,152
22400038,4,144,-4.0,-1.6666666666666665,144,0
22400039,1,308,-6.0,-1.1688311688311688,720,412
22400039,1,125,1.0,0.48,393,268
22400039,1,76,4.0,3.1578947368421053,255,179
22400039,1,124,-1.0,-0.4838709677419355,174,50
22400039,1,30,2.0,4.0,45,15
22400039,1,1,0.0,0.0,1,0
22400039,2,137,-1.0,-0.437956204379562,720,583
22400039,2,98,-2.0,-1.2244897959183672,583,485
22400039,2,61,-3.0,-2.9508196721311473,476,415
22400039,2,69,5.0,4.3478260869565215,415,346
22400039,2,31,1.0,1.935483870967742,346,315
22400039,2,26,0.0,0.0,314,288
22400039,2,96,-7.0,-4.375,275,179
22400039,2,99,1.0,0.6060606060606061,179,80
22400039,2,66,0.0,0.0,66,0
22400039,3,301,3.0,0.5980066445182723,720,419
22400039,3,14,1.0,4.285714285714286,419,405
22400039,3,65,7.0,6.461538461538462,400,335
22400039,3,182,6.0,1.978021978021978,328,146
22400039,3,37,4.0,6.486486486486487,130,93
22400039,3,29,0.0,0.0,45,16
22400039,4,177,3.0,1.0169491525423728,720,543
22400039,4,81,0.0,0.0,543,462
22400039,4,64,0.0,0.0,447,383
22400039,4,108,2.0,1.1111111111111112,373,265
22400039,4,64,0.0,0.0,254,190
22400039,4,116,0.0,0.0,179,63
22400039,4,57,-3.0,-3.1578947368421053,57,0
22400040,1,349,7.0,1.2034383954154728,720,371
22400040,1,166,2.0,0.7228915662650602,371,205
22400040,1,44,-3.0,-4.090909090909091,190,146
22400040,1,56,2.0,2.142857142857143,132,76
22400040,1,66,2.0,1.8181818181818183,66,0
22400040,2,131,-2.0,-0.916030534351145,720,589
22400040,2,34,0.0,0.0,573,539
22400040,2,15,-2.0,-8.0,527,512
22400040,2,136,-2.0,-0.8823529411764706,490,354
22400040,2,272,1.0,0.22058823529411764,354,82
22400040,2,64,-3.0,-2.8125,70,6
22400040,2,1,2.0,120.0,1,0
22400040,3,335,-1.0,-0.1791044776119403,720,385
22400040,3,74,-1.0,-0.8108108108108109,372,298
22400040,3,102,1.0,0.5882352941176471,286,184
22400040,3,72,0.0,0.0,184,112
22400040,3,112,0.0,0.0,112,0
22400040,4,183,5.0,1.639344262295082,720,537
22400040,4,22,-2.0,-5.454545454545455,527,505
22400040,4,29,0.0,0.0,477,448
22400040,4,20,0.0,0.0,435,415
22400040,4,277,-7.0,-1.5162454873646207,400,123
22400040,4,60,2.0,2.0,108,48
22400040,4,34,0.0,0.0,48,14
22400040,4,1,0.0,0.0,14,13
22400040,4,6,3.0,30.0,6,0
22400041,1,327,-4.0,-0.7339449541284404,720,393
22400041,1,39,0.0,0.0,387,348
22400041,1,98,-2.0,-1.2244897959183672,337,239
22400041,1,71,1.0,0.8450704225352113,223,152
22400041,1,139,4.0,1.7266187050359714,139,0
22400041,2,137,0.0,0.0,720,583
22400041,2,39,2.0,3.0769230769230766,575,536
22400041,2,32,-2.0,-3.75,512,480
22400041,2,82,1.0,0.7317073170731707,480,398
22400041,2,77,4.0,3.116883116883117,398,321
22400041,2,17,0.0,0.0,304,287
22400041,2,89,5.0,3.3707865168539324,272,183
22400041,2,139,-6.0,-2.589928057553957,165,26
22400041,2,2,0.0,0.0,2,0
22400041,3,354,10.0,1.694915254237288,720,366
22400041,3,44,4.0,5.454545454545455,357,313
22400041,3,20,2.0,6.0,308,288
22400041,3,125,-1.0,-0.48,276,151
22400041,3,19,-1.0,-3.1578947368421053,145,126
22400041,3,126,7.0,3.333333333333333,126,0
22400041,4,79,-4.0,-3.0379746835443036,720,641
22400041,4,182,1.0,0.3296703296703297,641,459
22400041,4,66,0.0,0.0,455,389
22400041,4,27,1.0,2.2222222222222223,381,354
22400041,4,31,-1.0,-1.935483870967742,354,323
22400041,4,30,-2.0,-4.0,323,293
22400041,4,135,-2.0,-0.888888888888889,269,134
22400041,4,83,5.0,3.6144578313253013,134,51
22400041,4,51,-2.0,-2.3529411764705883,51,0
22400042,1,285,8.0,1.6842105263157896,720,435
22400042,1,27,2.0,4.444444444444445,426,399
22400042,1,73,1.0,0.821917808219178,392,319
22400042,1,97,-3.0,-1.8556701030927836,319,222
22400042,1,147,1.0,0.40816326530612246,210,63
22400042,1,44,-2.0,-2.7272727272727275,44,0
22400042,2,175,-1.0,-0.34285714285714286,720,545
22400042,2,19,-1.0,-3.1578947368421053,545,526
22400042,2,50,-2.0,-2.4,526,476
22400042,2,98,4.0,2.4489795918367343,463,365
22400042,2,83,-2.0,-1.4457831325301205,365,282
22400042,2,50,1.0,1.2,271,221
22400042,2,47,3.0,3.829787234042553,218,171
22400042,2,56,3.0,3.214285714285714,147,91
22400042,2,79,0.0,0.0,79,0
22400042,3,295,2.0,0.4067796610169491,720,425
22400042,3,76,3.0,2.3684210526315788,425,349
22400042,3,23,1.0,2.608695652173913,332,309
22400042,3,37,-2.0,-3.2432432432432434,309,272
22400042,3,58,-2.0,-2.0689655172413794,257,199
22400042,3,100,6.0,3.5999999999999996,181,81
22400042,3,6,-1.0,-10.0,81,75
22400042,3,75,-5.0,-4.0,75,0
22400042,4,173,3.0,1.0404624277456647,720,547
22400042,4,64,2.0,1.875,535,471
22400042,4,27,0.0,0.0,446,419
22400042,4,41,-2.0,-2.926829268292683,419,378
22400042,4,39,0.0,0.0,378,339
22400042,4,62,4.0,3.870967741935484,336,274
22400042,4,59,0.0,0.0,271,212
22400042,4,148,0.0,0.0,212,64
22400042,4,64,-3.0,-2.8125,64,0
22400043,1,301,3.0,0.5980066445182723,720,419
22400043,1,123,-7.0,-3.4146341463414633,419,296
22400043,1,59,-1.0,-1.0169491525423728,296,237
22400043,1,64,0.0,0.0,237,173
22400043,1,90,-2.0,-1.3333333333333335,161,71
22400043,1,24,2.0,5.0,58,34
22400043,2,219,3.0,0.821917808219178,720,501
22400043,2,75,0.0,0.0,500,425
22400043,2,73,-3.0,-2.4657534246575343,414,341
22400043,2,219,-10.0,-2.73972602739726,286,67
22400043,2,65,1.0,0.9230769230769231,65,0
22400043,3,262,-8.0,-1.83206106870229,720,458
22400043,3,43,-2.0,-2.7906976744186047,445,402
22400043,3,49,1.0,1.2244897959183672,389,340
22400043,3,76,-1.0,-0.7894736842105263,340,264
22400043,3,55,0.0,0.0,264,209
22400043,3,64,1.0,0.9375,144,80
22400043,3,80,1.0,0.75,80,0
22400043,4,153,5.0,1.9607843137254903,720,567
22400043,4,107,0.0,0.0,554,447
22400043,4,14,2.0,8.571428571428571,441,427
22400043,4,86,3.0,2.0930232558139537,412,326
22400043,4,30,0.0,0.0,315,285
22400043,4,32,-2.0,-3.75,271,239
22400043,4,40,0.0,0.0,237,197
22400043,4,37,-2.0,-3.2432432432432434,197,160
22400043,4,160,0.0,0.0,160,0
22400044,1,430,4.0,0.5581395348837209,720,290
22400044,1,63,0.0,0.0,290,227
22400044,1,34,3.0,5.294117647058824,215,181
22400044,1,63,1.0,0.9523809523809523,169,106
22400044,1,106,-5.0,-2.8301886792452833,106,0
22400044,2,234,9.0,2.307692307692308,720,486
22400044,2,91,-2.0,-1.3186813186813189,486,395
22400044,2,54,2.0,2.2222222222222223,381,327
22400044,2,77,-3.0,-2.3376623376623376,301,224
22400044,2,175,-2.0,-0.6857142857142857,224,49
22400044,2,33,0.0,0.0,33,0
22400044,3,299,-1.0,-0.20066889632107024,720,421
22400044,3,118,3.0,1.5254237288135595,412,294
22400044,3,70,2.0,1.7142857142857142,286,216
22400044,3,63,0.0,0.0,197,134
22400044,3,121,-5.0,-2.479338842975207,121,0
22400044,4,201,-2.0,-0.5970149253731343,720,519
22400044,4,193,0.0,0.0,519,326
22400044,4,58,-5.0,-5.172413793103448,308,250
22400044,4,20,0.0,0.0,205,185
22400044,4,60,3.0,3.0,165,105
22400044,4,16,0.0,0.0,105,89
22400045,1,291,3.0,0.6185567010309279,720,429
22400045,1,45,-3.0,-4.0,423,378
22400045,1,47,0.0,0.0,378,331
22400045,1,61,-2.0,-1.9672131147540985,323,262
22400045,1,50,-4.0,-4.8,238,188
22400045,1,73,-5.0,-4.10958904109589,179,106
22400045,2,183,6.0,1.9672131147540985,720,537
22400045,2,17,-2.0,-7.0588235294117645,525,508
22400045,2,8,-1.0,-7.5,495,487
22400045,2,108,0.0,0.0,487,379
22400045,2,33,1.0,1.8181818181818183,375,342
22400045,2,152,1.0,0.39473684210526316,342,190
22400045,2,82,1.0,0.7317073170731707,178,96
22400045,3,319,-2.0,-0.37617554858934166,720,401
22400045,3,27,-2.0,-4.444444444444445,401,374
22400045,3,30,-2.0,-4.0,374,344
22400045,3,24,0.0,0.0,328,304
22400045,3,39,-3.0,-4.615384615384616,295,256
22400045,3,102,1.0,0.5882352941176471,243,141
22400045,3,16,-2.0,-7.5,126,110
22400045,3,85,2.0,1.4117647058823528,93,8
22400045,4,163,6.0,2.208588957055215,720,557
22400045,4,133,0.0,0.0,557,424
22400045,4,75,1.0,0.8,411,336
22400045,4,51,1.0,1.1764705882352942,336,285
22400045,4,65,-2.0,-1.8461538461538463,285,220
22400045,4,18,-2.0,-6.666666666666666,212,194
22400045,4,116,-3.0,-1.5517241379310345,187,71
22400045,4,23,-2.0,-5.217391304347826,63,40
22400045,4,32,-3.0,-5.625,36,4
22400045,4,4,0.0,0.0,4,0
22400046,1,381,-2.0,-0.31496062992125984,720,339
22400046,1,47,0.0,0.0,319,272
22400046,1,16,1.0,3.75,268,252
22400046,1,79,3.0,2.278481012658228,252,173
22400046,1,46,0.0,0.0,158,112
22400046,1,100,-3.0,-1.7999999999999998,100,0
22400046,2,95,-1.0,-0.631578947368421,720,625
22400046,2,90,-2.0,-1.3333333333333335,614,524
22400046,2,83,3.0,2.1686746987951806,521,438
22400046,2,24,2.0,5.0,438,414
22400046,2,23,0.0,0.0,414,391
22400046,2,20,0.0,0.0,387,367
22400046,2,21,0.0,0.0,354,333
22400046,2,59,-5.0,-5.084745762711864,333,274
22400046,2,7,-1.0,-8.571428571428571,251,244
22400046,2,120,4.0,2.0,244,124
22400046,2,118,-1.0,-0.5084745762711864,119,1
22400046,2,1,0.0,0.0,1,0
22400046,3,185,4.0,1.2972972972972974,720,535
22400046,3,59,6.0,6.101694915254238,530,471
22400046,3,101,-1.0,-0.594059405940594,455,354
22400046,3,31,-2.0,-3.870967741935484,354,323
22400046,3,78,0.0,0.0,295,217
22400046,3,76,6.0,4.7368421052631575,217,141
22400046,3,108,5.0,2.7777777777777777,108,0
22400046,4,17,0.0,0.0,720,703
22400046,4,88,1.0,0.6818181818181819,687,599
22400046,4,33,1.0,1.8181818181818183,592,559
22400046,4,72,0.0,0.0,543,471
22400046,4,31,-5.0,-9.67741935483871,461,430
22400046,4,106,-5.0,-2.8301886792452833,410,304
22400046,4,282,0.0,0.0,303,21
22400046,4,21,1.0,2.8571428571428568,21,0
22400047,1,249,-1.0,-0.24096385542168672,720,471
22400047,1,101,-6.0,-3.564356435643564,471,370
22400047,1,25,-2.0,-4.8,353,328
22400047,1,145,1.0,0.41379310344827586,319,174
22400047,1,84,4.0,2.8571428571428568,159,75
22400047,2,167,7.0,2.5149700598802394,720,553
22400047,2,67,0.0,0.0,534,467
22400047,2,26,1.0,2.307692307692308,460,434
22400047,2,56,3.0,3.214285714285714,434,378
22400047,2,14,-1.0,-4.285714285714286,277,263
22400047,2,45,-4.0,-5.333333333333334,263,218
22400047,2,201,2.0,0.5970149253731343,201,0
22400047,3,232,11.0,2.8448275862068964,720,488
22400047,3,72,-6.0,-5.0,474,402
22400047,3,60,3.0,3.0,402,342
22400047,3,202,-7.0,-2.0792079207920793,340,138
22400047,3,138,5.0,2.1739130434782608,138,0
22400047,4,197,-1.0,-0.3045685279187817,720,523
22400047,4,67,0.0,0.0,517,450
22400047,4,125,-4.0,-1.92,450,325
22400047,4,64,-6.0,-5.625,315,251
22400047,4,232,3.0,0.7758620689655172,251,19
22400047,4,15,1.0,4.0,16,1
22400048,1,322,-13.0,-2.422360248447205,720,398
22400048,1,54,3.0,3.333333333333333,386,332
22400048,1,126,0.0,0.0,317,191
22400048,1,84,3.0,2.142857142857143,183,99
22400048,1,90,-1.0,-0.6666666666666667,90,0
22400048,2,109,7.0,3.853211009174312,720,611
22400048,2,128,-3.0,-1.40625,593,465
22400048,2,170,3.0,1.0588235294117647,445,275
22400048,2,49,0.0,0.0,264,215
22400048,2,61,-1.0,-0.9836065573770493,211,150
22400048,2,68,4.0,3.5294117647058822,140,72
22400048,2,72,-5.0,-4.166666666666667,72,0
22400048,3,306,1.0,0.19607843137254902,720,414
22400048,3,37,1.0,1.6216216216216217,414,377
22400048,3,13,0.0,0.0,365,352
22400048,3,120,-4.0,-2.0,336,216
22400048,3,102,5.0,2.941176470588235,216,114
22400048,3,32,0.0,0.0,114,82
22400048,3,49,0.0,0.0,69,20
22400048,4,262,-3.0,-0.6870229007633588,720,458
22400048,4,23,0.0,0.0,441,418
22400048,4,50,-1.0,-1.2,408,358
22400048,4,108,-1.0,-0.5555555555555556,343,235
22400048,4,213,1.0,0.28169014084507044,235,22
22400048,4,2,-2.0,-60.0,20,18
22400048,4,17,-2.0,-7.0588235294117645,17,0
22400049,1,211,2.0,0.5687203791469195,720,509
22400049,1,139,0.0,0.0,509,370
22400049,1,120,2.0,1.0,354,234
22400049,1,124,-2.0,-0.967741935483871,224,100
22400049,1,52,-2.0,-2.307692307692308,100,48
22400049,1,48,2.0,2.5,48,0
22400049,2,37,2.0,3.2432432432432434,720,683
22400049,2,115,-1.0,-0.5217391304347826,669,554
22400049,2,24,2.0,5.0,552,528
22400049,2,51,5.0,5.88235294117647,510,459
22400049,2,64,-2.0,-1.875,459,395
22400049,2,8,0.0,0.0,377,369
22400049,2,87,5.0,3.4482758620689653,369,282
22400049,2,274,-2.0,-0.437956204379562,274,0
22400049,3,179,4.0,1.340782122905028,720,541
22400049,3,40,4.0,6.0,530,490
22400049,3,89,2.0,1.348314606741573,490,401
22400049,3,85,-4.0,-2.8235294117647056,394,309
22400049,3,35,2.0,3.4285714285714284,296,261
22400049,3,50,0.0,0.0,251,201
22400049,3,7,1.0,8.571428571428571,201,194
22400049,3,132,-4.0,-1.8181818181818183,194,62
22400049,3,47,3.0,3.829787234042553,47,0
22400049,4,157,1.0,0.3821656050955414,720,563
22400049,4,115,3.0,1.5652173913043477,555,440
22400049,4,102,5.0,2.941176470588235,429,327
22400049,4,315,-10.0,-1.9047619047619047,315,0
22400050,1,356,-1.0,-0.16853932584269662,720,364
22400050,1,62,-2.0,-1.935483870967742,342,280
22400050,1,62,-1.0,-0.967741935483871,262,200
22400050,1,134,-2.0,-0.8955223880597015,194,60
22400050,1,42,-2.0,-2.8571428571428568,42,0
22400050,2,187,3.0,0.9625668449197862,720,533
22400050,2,31,1.0,1.935483870967742,533,502
22400050,2,51,-6.0,-7.0588235294117645,502,451
22400050,2,22,-3.0,-8.181818181818182,429,407
22400050,2,70,0.0,0.0,391,321
22400050,2,107,-3.0,-1.6822429906542056,321,214
22400050,2,72,4.0,3.333333333333333,214,142
22400050,2,75,4.0,3.2,130,55
22400050,2,55,0.0,0.0,55,0
22400050,3,364,1.0,0.16483516483516486,720,356
22400050,3,140,-7.0,-3.0,356,216
22400050,3,104,5.0,2.8846153846153846,216,112
22400050,3,95,3.0,1.8947368421052633,95,0
22400050,4,193,2.0,0.6217616580310881,720,527
22400050,4,140,1.0,0.42857142857142855,500,360
22400050,4,108,1.0,0.5555555555555556,360,252
22400050,4,95,3.0,1.8947368421052633,244,149
22400050,4,112,0.0,0.0,156,44
22400050,4,1,-1.0,-60.0,25,24
22400050,4,15,0.0,0.0,24,9
22400050,4,6,-2.0,-20.0,6,0
22400051,1,289,10.0,2.0761245674740487,720,431
22400051,1,56,-4.0,-4.285714285714286,431,375
22400051,1,108,3.0,1.6666666666666665,366,258
22400051,1,36,5.0,8.333333333333334,248,212
22400051,1,34,0.0,0.0,212,178
22400051,1,178,2.0,0.6741573033707865,178,0
22400051,2,250,1.0,0.24,720,470
22400051,2,57,-2.0,-2.1052631578947367,459,402
22400051,2,5,-2.0,-24.0,395,390
22400051,2,88,7.0,4.7727272727272725,375,287
22400051,2,27,1.0,2.2222222222222223,284,257
22400051,2,94,-1.0,-0.6382978723404256,257,163
22400051,2,72,4.0,3.333333333333333,163,91
22400051,2,82,-3.0,-2.195121951219512,82,0
22400051,3,78,3.0,2.307692307692308,720,642
22400051,3,120,0.0,0.0,634,514
22400051,3,17,0.0,0.0,505,488
22400051,3,104,-1.0,-0.576923076923077,488,384
22400051,3,47,0.0,0.0,370,323
22400051,3,71,2.0,1.6901408450704225,323,252
22400051,3,61,1.0,0.9836065573770493,252,191
22400051,3,142,-2.0,-0.8450704225352113,191,49
22400051,4,161,3.0,1.1180124223602486,720,559
22400051,4,130,2.0,0.9230769230769231,495,365
22400051,4,24,5.0,12.5,365,341
22400051,4,328,6.0,1.097560975609756,328,0
22400052,1,314,5.0,0.9554140127388535,720,406
22400052,1,77,-2.0,-1.5584415584415585,397,320
22400052,1,163,-5.0,-1.8404907975460123,320,157
22400052,1,85,0.0,0.0,137,52
22400052,1,26,-1.0,-2.307692307692308,45,19
22400052,2,67,-1.0,-0.8955223880597015,720,653
22400052,2,120,-1.0,-0.5,644,524
22400052,2,36,-2.0,-3.333333333333333,514,478
22400052,2,40,-1.0,-1.5,452,412
22400052,2,27,0.0,0.0,403,376
22400052,2,15,0.0,0.0,376,361
22400052,2,46,3.0,3.9130434782608696,352,306
22400052,2,63,1.0,0.9523809523809523,306,243
22400052,2,15,0.0,0.0,237,222
22400052,2,49,-5.0,-6.122448979591837,213,164
22400052,2,64,-5.0,-4.6875,164,100
22400052,2,37,3.0,4.864864864864865,100,63
22400052,2,43,-3.0,-4.186046511627907,63,20
22400052,2,20,0.0,0.0,20,0
22400052,3,143,-3.0,-1.2587412587412588,720,577
22400052,3,233,-4.0,-1.0300429184549356,577,344
22400052,3,120,3.0,1.5,325,205
22400052,3,10,0.0,0.0,195,185
22400052,3,26,1.0,2.307692307692308,181,155
22400052,3,20,0.0,0.0,155,135
22400052,3,101,-3.0,-1.782178217821782,135,34
22400052,3,16,0.0,0.0,16,0
22400052,4,346,-2.0,-0.3468208092485549,720,374
22400052,4,47,4.0,5.1063829787234045,363,316
22400052,4,103,2.0,1.1650485436893203,316,213
22400052,4,47,2.0,2.5531914893617023,192,145
22400052,4,15,-5.0,-20.0,135,120
22400053,1,351,2.0,0.3418803418803419,720,369
22400053,1,22,2.0,5.454545454545455,356,334
22400053,1,47,0.0,0.0,318,271
22400053,1,56,-2.0,-2.142857142857143,246,190
22400053,1,54,-2.0,-2.2222222222222223,172,118
22400053,1,118,4.0,2.0338983050847457,118,0
22400053,2,90,5.0,3.333333333333333,720,630
22400053,2,45,0.0,0.0,616,571
22400053,2,30,2.0,4.0,571,541
22400053,2,29,0.0,0.0,541,512
22400053,2,70,-2.0,-1.7142857142857142,504,434
22400053,2,187,0.0,0.0,422,235
22400053,2,54,4.0,4.444444444444445,235,181
22400053,2,111,3.0,1.6216216216216217,161,50
22400053,3,242,9.0,2.231404958677686,720,478
22400053,3,27,3.0,6.666666666666666,478,451
22400053,3,112,3.0,1.607142857142857,439,327
22400053,3,144,2.0,0.8333333333333333,309,165
22400053,3,135,-4.0,-1.777777777777778,165,30
22400053,4,109,3.0,1.651376146788991,720,611
22400053,4,142,-5.0,-2.1126760563380285,602,460
22400053,4,27,-1.0,-2.2222222222222223,460,433
22400053,4,38,0.0,0.0,433,395
22400053,4,44,-1.0,-1.3636363636363638,386,342
22400053,4,155,-4.0,-1.5483870967741935,328,173
22400053,4,155,-6.0,-2.3225806451612905,155,0
22400054,1,280,6.0,1.2857142857142858,720,440
22400054,1,145,0.0,0.0,424,279
22400054,1,142,-6.0,-2.535211267605634,268,126
22400054,1,40,2.0,3.0,110,70
22400054,2,16,0.0,0.0,720,704
22400054,2,131,2.0,0.916030534351145,701,570
22400054,2,27,3.0,6.666666666666666,545,518
22400054,2,70,0.0,0.0,498,428
22400054,2,61,2.0,1.9672131147540985,417,356
22400054,2,69,4.0,3.4782608695652173,341,272
22400054,2,56,0.0,0.0,257,201
22400054,2,34,3.0,5.294117647058824,201,167
22400054,2,148,-4.0,-1.6216216216216217,154,6
22400054,3,349,6.0,1.0315186246418337,720,371
22400054,3,80,-5.0,-3.75,371,291
22400054,3,85,1.0,0.7058823529411764,280,195
22400054,3,48,-4.0,-5.0,195,147
22400054,3,46,-2.0,-2.608695652173913,147,101
22400054,3,92,-4.0,-2.608695652173913,92,0
22400054,4,49,1.0,1.2244897959183672,720,671
22400054,4,64,0.0,0.0,671,607
22400054,4,79,-5.0,-3.79746835443038,607,528
22400054,4,19,0.0,0.0,513,494
22400054,4,27,-2.0,-4.444444444444445,494,467
22400054,4,52,-2.0,-2.307692307692308,448,396
22400054,4,53,3.0,3.3962264150943398,396,343
22400054,4,29,-1.0,-2.0689655172413794,320,291
22400054,4,89,5.0,3.3707865168539324,291,202
22400054,4,150,2.0,0.8,193,43
22400054,4,43,0.0,0.0,43,0
22400055,1,365,-10.0,-1.643835616438356,720,355
22400055,1,28,2.0,4.285714285714286,355,327
22400055,1,66,3.0,2.7272727272727275,322,256
22400055,1,48,2.0,2.5,256,208
22400055,1,187,8.0,2.5668449197860963,187,0
22400055,2,142,1.0,0.4225352112676056,720,578
22400055,2,14,0.0,0.0,569,555
22400055,2,107,7.0,3.9252336448598126,541,434
22400055,2,67,0.0,0.0,434,367
22400055,2,33,0.0,0.0,357,324
22400055,2,34,-3.0,-5.294117647058824,314,280
22400055,2,49,1.0,1.2244897959183672,268,219
22400055,2,69,-1.0,-0.8695652173913043,196,127
22400055,2,127,3.0,1.4173228346456692,127,0
22400055,3,383,7.0,1.0966057441253265,720,337
22400055,3,64,4.0,3.75,324,260
22400055,3,85,4.0,2.8235294117647056,255,170
22400055,3,170,-1.0,-0.3529411764705882,170,0
22400055,4,132,2.0,0.9090909090909092,720,588
22400055,4,37,0.0,0.0,582,545
22400055,4,40,-2.0,-3.0,530,490
22400055,4,27,1.0,2.2222222222222223,477,450
22400055,4,105,2.0,1.142857142857143,443,338
22400055,4,50,1.0,1.2,318,268
22400055,4,142,-1.0,-0.4225352112676056,251,109
22400055,4,109,3.0,1.651376146788991,109,0
22400056,1,375,4.0,0.64,720,345
22400056,1,31,3.0,5.806451612903226,332,301
22400056,1,14,0.0,0.0,294,280
22400056,1,137,-1.0,-0.437956204379562,204,67
22400056,1,38,-4.0,-6.315789473684211,38,0
22400056,2,193,7.0,2.176165803108808,720,527
22400056,2,14,-1.0,-4.285714285714286,523,509
22400056,2,58,2.0,2.0689655172413794,509,451
22400056,2,5,0.0,0.0,451,446
22400056,2,97,-2.0,-1.2371134020618557,444,347
22400056,2,46,-3.0,-3.9130434782608696,341,295
22400056,2,1,0.0,0.0,277,276
22400056,2,68,-2.0,-1.7647058823529411,263,195
22400056,2,75,5.0,4.0,188,113
22400056,2,22,-1.0,-2.7272727272727275,113,91
22400056,2,81,1.0,0.7407407407407407,91,10
22400056,3,280,-7.0,-1.5,720,440
22400056,3,20,-3.0,-9.0,423,403
22400056,3,123,1.0,0.48780487804878053,484,361
22400056,3,22,0.0,0.0,346,324
22400056,3,18,2.0,6.666666666666666,309,291
22400056,3,30,-5.0,-10.0,291,261
22400056,3,44,0.0,0.0,238,194
22400056,3,31,0.0,0.0,187,156
22400056,3,12,0.0,0.0,143,131
22400056,3,53,1.0,1.1320754716981132,123,70
22400056,3,24,2.0,5.0,70,46
22400056,3,34,-1.0,-1.7647058823529411,35,1
22400056,4,180,3.0,1.0,720,540
22400056,4,15,-1.0,-4.0,540,525
22400056,4,56,1.0,1.0714285714285714,516,460
22400056,4,121,1.0,0.49586776859504134,460,339
22400056,4,13,2.0,9.230769230769232,336,323
22400056,4,18,-1.0,-3.333333333333333,323,305
22400056,4,77,0.0,0.0,305,228
22400056,4,202,11.0,3.267326732673267,228,26
22400056,4,21,-1.0,-2.8571428571428568,22,1
22400056,4,1,0.0,0.0,1,0
22400057,1,322,6.0,1.1180124223602486,720,398
22400057,1,170,-5.0,-1.7647058823529411,390,220
22400057,1,93,0.0,0.0,220,127
22400057,1,61,8.0,7.868852459016394,113,52
22400057,2,137,-4.0,-1.751824817518248,720,583
22400057,2,68,3.0,2.647058823529412,583,515
22400057,2,67,4.0,3.582089552238806,496,429
22400057,2,50,-1.0,-1.2,418,368
22400057,2,9,-2.0,-13.333333333333332,368,359
22400057,2,89,-2.0,-1.348314606741573,359,270
22400057,2,39,0.0,0.0,270,231
22400057,2,150,5.0,2.0,225,75
22400057,3,246,-8.0,-1.9512195121951221,720,474
22400057,3,131,1.0,0.4580152671755725,474,343
22400057,3,60,0.0,0.0,331,271
22400057,3,63,-5.0,-4.761904761904762,256,193
22400057,3,22,0.0,0.0,193,171
22400057,3,19,0.0,0.0,158,139
22400057,3,31,1.0,1.935483870967742,139,108
22400057,3,78,0.0,0.0,108,30
22400057,3,24,0.0,0.0,30,6
22400057,4,133,7.0,3.1578947368421053,720,587
22400057,4,84,0.0,0.0,575,491
22400057,4,61,3.0,2.9508196721311473,477,416
22400057,4,57,-5.0,-5.263157894736842,416,359
22400057,4,129,2.0,0.9302325581395349,347,218
22400057,4,190,-4.0,-1.263157894736842,214,24
22400057,4,13,0.0,0.0,19,6
22400058,1,276,-3.0,-0.6521739130434783,720,444
22400058,1,51,-3.0,-3.5294117647058822,430,379
22400058,1,34,-1.0,-1.7647058823529411,379,345
22400058,1,26,0.0,0.0,253,227
22400058,1,35,4.0,6.857142857142857,227,192
22400058,1,87,5.0,3.4482758620689653,179,92
22400058,1,42,-1.0,-1.4285714285714284,89,47
22400058,1,36,0.0,0.0,36,0
22400058,2,203,-5.0,-1.477832512315271,720,517
22400058,2,21,-2.0,-5.7142857142857135,511,490
22400058,2,102,-3.0,-1.7647058823529411,482,380
22400058,2,170,1.0,0.3529411764705882,370,200
22400058,2,71,4.0,3.380281690140845,188,117
22400058,2,104,0.0,0.0,104,0
22400058,3,291,-1.0,-0.20618556701030927,720,429
22400058,3,63,0.0,0.0,429,366
22400058,3,64,0.0,0.0,366,302
22400058,3,85,2.0,1.4117647058823528,288,203
22400058,3,16,1.0,3.75,203,187
22400058,3,83,-3.0,-2.1686746987951806,187,104
22400058,3,8,-1.0,-7.5,104,96
22400058,3,53,2.0,2.2641509433962264,96,43
22400058,3,43,0.0,0.0,43,0
22400058,4,156,-8.0,-3.0769230769230766,720,564
22400058,4,81,-4.0,-2.962962962962963,551,470
22400058,4,83,-1.0,-0.7228915662650602,463,380
22400058,4,29,-1.0,-2.0689655172413794,373,344
22400058,4,31,3.0,5.806451612903226,337,306
22400058,4,44,2.0,2.7272727272727275,306,262
22400058,4,17,4.0,14.117647058823529,48,31
22400058,4,6,0.0,0.0,20,14
22400059,1,384,0.0,0.0,720,336
22400059,1,26,-2.0,-4.615384615384616,321,295
22400059,1,95,-2.0,-1.263157894736842,285,190
22400059,1,138,-3.0,-1.3043478260869565,170,32
22400059,1,32,0.0,0.0,32,0
22400059,2,218,2.0,0.5504587155963303,720,502
22400059,2,62,-4.0,-3.870967741935484,486,424
22400059,2,16,-1.0,-3.75,402,386
22400059,2,6,0.0,0.0,386,380
22400059,2,30,2.0,4.0,371,341
22400059,2,40,0.0,0.0,331,291
22400059,2,195,-2.0,-0.6153846153846154,281,86
22400059,2,86,8.0,5.5813953488372094,86,0
22400059,3,299,13.0,2.608695652173913,720,421
22400059,3,134,-2.0,-0.8955223880597015,411,277
22400059,3,11,0.0,0.0,277,266
22400059,3,34,0.0,0.0,266,232
22400059,3,83,1.0,0.7228915662650602,222,139
22400059,3,117,-2.0,-1.0256410256410258,133,16
22400059,3,16,1.0,3.75,16,0
22400059,4,105,-1.0,-0.5714285714285715,720,615
22400059,4,42,-3.0,-4.285714285714286,615,573
22400059,4,139,0.0,0.0,561,422
22400059,4,35,2.0,3.4285714285714284,422,387
22400059,4,109,0.0,0.0,387,278
22400059,4,108,3.0,1.6666666666666665,263,155
22400059,4,43,3.0,4.186046511627907,155,112
22400060,1,350,8.0,1.3714285714285714,720,370
22400060,1,41,-1.0,-1.4634146341463414,354,313
22400060,1,28,-3.0,-6.428571428571428,313,285
22400060,1,103,0.0,0.0,285,182
22400060,1,16,0.0,0.0,182,166
22400060,1,100,-2.0,-1.2,149,49
22400060,1,35,-2.0,-3.4285714285714284,45,10
22400060,1,3,-1.0,-20.0,3,0
22400060,2,157,-7.0,-2.6751592356687897,720,563
22400060,2,91,0.0,0.0,558,467
22400060,2,1,0.0,0.0,450,449
22400060,2,55,4.0,4.363636363636363,435,380
22400060,2,14,0.0,0.0,373,359
22400060,2,131,1.0,0.4580152671755725,348,217
22400060,2,101,1.0,0.594059405940594,193,92
22400060,2,82,1.0,0.7317073170731707,82,0
22400060,3,334,1.0,0.17964071856287425,720,386
22400060,3,15,-1.0,-4.0,386,371
22400060,3,49,4.0,4.897959183673469,365,316
22400060,3,16,0.0,0.0,316,300
22400060,3,48,0.0,0.0,279,231
22400060,3,92,-2.0,-1.3043478260869565,213,121
22400060,3,65,3.0,2.769230769230769,114,49
22400060,3,42,3.0,4.285714285714286,49,7
22400060,4,117,8.0,4.102564102564103,720,603
22400060,4,199,3.0,0.9045226130653266,597,398
22400060,4,11,0.0,0.0,398,387
22400060,4,165,5.0,1.8181818181818183,379,214
22400060,4,216,-4.0,-1.1111111111111112,216,0
22400061,1,325,3.0,0.5538461538461539,720,395
22400061,1,91,0.0,0.0,395,304
22400061,1,2,0.0,0.0,293,291
22400061,1,117,5.0,2.5641025641025643,278,161
22400061,1,147,6.0,2.4489795918367343,147,0
22400061,2,87,-4.0,-2.7586206896551726,720,633
22400061,2,242,4.0,0.9917355371900827,620,378
22400061,2,16,-1.0,-3.75,361,345
22400061,2,150,6.0,2.4,345,195
22400061,2,195,-5.0,-1.5384615384615383,195,0
22400061,3,394,10.0,1.5228426395939085,720,326
22400061,3,124,0.0,0.0,311,187
22400061,3,121,0.0,0.0,180,59
22400061,3,39,2.0,3.0769230769230766,39,0
22400061,4,126,4.0,1.9047619047619047,720,594
22400061,4,75,5.0,4.0,590,515
22400061,4,140,-3.0,-1.2857142857142858,505,365
22400061,4,32,-2.0,-3.75,356,324
22400061,4,150,-5.0,-2.0,317,167
22400062,1,316,1.0,0.18987341772151897,720,404
22400062,1,19,0.0,0.0,385,366
22400062,1,45,3.0,4.0,354,309
22400062,1,121,-1.0,-0.49586776859504134,304,183
22400062,1,51,-2.0,-2.3529411764705883,183,132
22400062,1,64,-2.0,-1.875,132,68
22400062,1,68,-3.0,-2.647058823529412,68,0
22400062,2,207,8.0,2.318840579710145,720,513
22400062,2,44,1.0,1.3636363636363638,498,454
22400062,2,36,4.0,6.666666666666666,444,408
22400062,2,129,3.0,1.3953488372093024,408,279
22400062,2,23,-3.0,-7.826086956521739,263,240
22400062,2,157,-5.0,-1.910828025477707,236,79
22400062,2,65,2.0,1.8461538461538463,65,0
22400062,3,214,3.0,0.8411214953271028,720,506
22400062,3,87,-3.0,-2.0689655172413794,506,419
22400062,3,42,0.0,0.0,419,377
22400062,3,48,1.0,1.25,377,329
22400062,3,63,-6.0,-5.7142857142857135,320,257
22400062,3,40,1.0,1.5,257,217
22400062,3,37,2.0,3.2432432432432434,217,180
22400062,3,150,-3.0,-1.2,150,0
22400062,4,89,-4.0,-2.696629213483146,720,631
22400062,4,36,0.0,0.0,616,580
22400062,4,56,4.0,4.285714285714286,572,516
22400062,4,71,0.0,0.0,500,429
22400062,4,127,3.0,1.4173228346456692,429,302
22400062,4,154,3.0,1.1688311688311688,284,130
22400062,4,103,-3.0,-1.7475728155339807,130,27
22400062,4,25,-2.0,-4.8,25,0
22400063,1,309,2.0,0.3883495145631068,720,411
22400063,1,67,-3.0,-2.6865671641791042,411,344
22400063,1,29,-4.0,-8.275862068965518,328,299
22400063,1,84,0.0,0.0,299,215
22400063,1,60,4.0,4.0,126,66
22400063,1,38,2.0,3.1578947368421053,66,28
22400063,1,1,0.0,0.0,5,4
22400063,1,1,0.0,0.0,1,0
22400063,2,52,-3.0,-3.4615384615384617,720,668
22400063,2,31,2.0,3.870967741935484,660,629
22400063,2,113,-1.0,-0.5309734513274336,618,505
22400063,2,22,2.0,5.454545454545455,505,483
22400063,2,23,2.0,5.217391304347826,446,423
22400063,2,19,0.0,0.0,410,391
22400063,2,35,0.0,0.0,379,344
22400063,2,54,0.0,0.0,330,276
22400063,2,89,2.0,1.348314606741573,276,187
22400063,2,21,-1.0,-2.8571428571428568,182,161
22400063,2,132,2.0,0.9090909090909092,161,29
22400063,3,297,-2.0,-0.40404040404040403,720,423
22400063,3,34,0.0,0.0,423,389
22400063,3,99,-4.0,-2.4242424242424243,386,287
22400063,3,6,-2.0,-20.0,261,255
22400063,3,26,0.0,0.0,255,229
22400063,3,28,-1.0,-2.142857142857143,219,191
22400063,3,41,5.0,7.317073170731707,191,150
22400063,3,71,-1.0,-0.8450704225352113,135,64
22400063,3,27,2.0,4.444444444444445,64,37
22400063,3,16,0.0,0.0,37,21
22400063,4,221,-5.0,-1.3574660633484164,720,499
22400063,4,93,0.0,0.0,484,391
22400063,4,95,0.0,0.0,370,275
22400063,4,129,-4.0,-1.8604651162790697,266,137
22400063,4,117,-2.0,-1.0256410256410258,137,20
22400063,4,8,2.0,15.0,16,8
22400063,4,2,0.0,0.0,2,0
22400064,1,297,2.0,0.40404040404040403,720,423
22400064,1,68,-3.0,-2.647058823529412,416,348
22400064,1,41,-1.0,-1.4634146341463414,332,291
22400064,1,34,1.0,1.7647058823529411,291,257
22400064,1,21,0.0,0.0,244,223
22400064,1,68,4.0,3.5294117647058822,218,150
22400064,2,167,-4.0,-1.437125748502994,720,553
22400064,2,41,-3.0,-4.390243902439024,539,498
22400064,2,18,0.0,0.0,498,480
22400064,2,115,2.0,1.0434782608695652,455,340
22400064,2,52,3.0,3.4615384615384617,330,278
22400064,2,99,-3.0,-1.8181818181818183,265,166
22400064,2,125,-3.0,-1.44,151,26
22400064,2,8,0.0,0.0,8,0
22400064,3,301,3.0,0.5980066445182723,720,419
22400064,3,47,-2.0,-2.5531914893617023,412,365
22400064,3,122,4.0,1.9672131147540985,365,243
22400064,3,13,0.0,0.0,243,230
22400064,3,163,1.0,0.36809815950920244,230,67
22400064,3,9,0.0,0.0,67,58
22400064,3,58,0.0,0.0,58,0
22400064,4,109,0.0,0.0,720,611
22400064,4,24,2.0,5.0,611,587
22400064,4,63,0.0,0.0,564,501
22400064,4,18,-1.0,-3.333333333333333,501,483
22400064,4,24,3.0,7.5,483,459
22400064,4,64,3.0,2.8125,459,395
22400064,4,96,-2.0,-1.25,376,280
22400064,4,278,-6.0,-1.2949640287769786,280,2
22400064,4,1,0.0,0.0,1,0
22400065,1,315,-3.0,-0.5714285714285715,720,405
22400065,1,63,9.0,8.571428571428571,405,342
22400065,1,71,-3.0,-2.535211267605634,324,253
22400065,1,52,3.0,3.4615384615384617,239,187
22400065,1,71,-3.0,-2.535211267605634,187,116
22400065,1,97,-3.0,-1.8556701030927836,110,13
22400065,1,3,0.0,0.0,3,0
22400065,2,117,-3.0,-1.5384615384615383,720,603
22400065,2,43,3.0,4.186046511627907,600,557
22400065,2,46,2.0,2.608695652173913,552,506
22400065,2,5,0.0,0.0,493,488
22400065,2,36,-1.0,-1.6666666666666665,476,440
22400065,2,91,2.0,1.3186813186813189,440,349
22400065,2,133,-2.0,-0.9022556390977443,349,216
22400065,2,204,-3.0,-0.8823529411764706,216,12
22400065,2,4,-3.0,-45.0,4,0
22400065,3,262,-10.0,-2.290076335877863,720,458
22400065,3,111,-2.0,-1.0810810810810811,458,347
22400065,3,64,-5.0,-4.6875,347,283
22400065,3,122,-7.0,-3.4426229508196724,266,144
22400065,3,27,0.0,0.0,135,108
22400065,3,93,0.0,0.0,93,0
22400065,4,106,5.0,2.8301886792452833,720,614
22400065,4,89,-4.0,-2.696629213483146,614,525
22400065,4,150,-9.0,-3.5999999999999996,525,375
22400065,4,31,0.0,0.0,352,321
22400065,4,314,13.0,2.484076433121019,314,0
22400066,1,261,5.0,1.1494252873563218,720,459
22400066,1,79,-2.0,-1.5189873417721518,451,372
22400066,1,125,1.0,0.48,351,226
22400066,1,36,-2.0,-3.333333333333333,205,169
22400066,1,79,-5.0,-3.79746835443038,163,84
22400066,1,37,0.0,0.0,84,47
22400066,1,38,1.0,1.5789473684210527,43,5
22400066,2,197,-5.0,-1.5228426395939085,720,523
22400066,2,40,0.0,0.0,505,465
22400066,2,115,1.0,0.5217391304347826,461,346
22400066,2,98,-7.0,-4.285714285714286,331,233
22400066,2,87,-4.0,-2.7586206896551726,214,127
22400066,2,55,0.0,0.0,121,66
22400066,2,57,1.0,1.0526315789473684,57,0
22400066,3,264,0.0,0.0,720,456
22400066,3,125,-5.0,-2.4,440,315
22400066,3,21,3.0,8.571428571428571,308,287
22400066,3,5,1.0,12.0,278,273
22400066,3,167,-5.0,-1.7964071856287425,273,106
22400066,3,83,-3.0,-2.1686746987951806,83,0
22400066,4,83,1.0,0.7228915662650602,720,637
22400066,4,63,2.0,1.9047619047619047,624,561
22400066,4,16,0.0,0.0,559,543
22400066,4,81,4.0,2.962962962962963,543,462
22400066,4,99,1.0,0.6060606060606061,452,353
22400066,4,10,0.0,0.0,353,343
22400066,4,75,0.0,0.0,333,258
22400066,4,26,-2.0,-4.615384615384616,258,232
22400066,4,73,2.0,1.643835616438356,232,159
22400066,4,26,1.0,2.307692307692308,159,133
22400066,4,55,1.0,1.0909090909090908,121,66
22400066,4,7,-1.0,-8.571428571428571,44,37
22400066,4,37,0.0,0.0,37,0
22400067,1,334,7.0,1.2574850299401197,720,386
22400067,1,61,-2.0,-1.9672131147540985,363,302
22400067,1,90,0.0,0.0,295,205
22400067,1,40,1.0,1.5,205,165
22400067,1,162,-3.0,-1.1111111111111112,162,0
22400067,2,78,-6.0,-4.615384615384616,720,642
22400067,2,50,-1.0,-1.2,630,580
22400067,2,36,1.0,1.6666666666666665,580,544
22400067,2,32,-1.0,-1.875,529,497
22400067,2,42,0.0,0.0,497,455
22400067,2,69,2.0,1.7391304347826086,455,386
22400067,2,88,2.0,1.3636363636363638,386,298
22400067,2,18,0.0,0.0,277,259
22400067,2,74,-7.0,-5.675675675675676,259,185
22400067,2,21,0.0,0.0,165,144
22400067,2,126,-4.0,-1.9047619047619047,126,0
22400067,3,205,-1.0,-0.2926829268292683,720,515
22400067,3,69,-5.0,-4.3478260869565215,496,427
22400067,3,25,0.0,0.0,427,402
22400067,3,37,-2.0,-3.2432432432432434,402,365
22400067,3,144,2.0,0.8333333333333333,354,210
22400067,3,31,1.0,1.935483870967742,196,165
22400067,3,165,-3.0,-1.0909090909090908,165,0
22400067,4,127,0.0,0.0,720,593
22400067,4,57,-2.0,-2.1052631578947367,585,528
22400067,4,18,-2.0,-6.666666666666666,528,510
22400067,4,92,1.0,0.6521739130434783,492,400
22400067,4,46,1.0,1.3043478260869565,375,329
22400067,4,46,5.0,6.521739130434782,316,270
22400068,1,241,1.0,0.24896265560165975,720,479
22400068,1,93,-2.0,-1.2903225806451615,479,386
22400068,1,108,6.0,3.333333333333333,386,278
22400068,1,47,1.0,1.2765957446808511,263,216
22400068,1,48,-1.0,-1.25,216,168
22400068,1,167,1.0,0.3592814371257485,168,1
22400068,1,1,0.0,0.0,1,0
22400068,2,169,1.0,0.35502958579881655,720,551
22400068,2,35,-1.0,-1.7142857142857142,536,501
22400068,2,35,0.0,0.0,501,466
22400068,2,14,2.0,8.571428571428571,458,444
22400068,2,67,2.0,1.791044776119403,419,352
22400068,2,27,1.0,2.2222222222222223,350,323
22400068,2,184,3.0,0.9782608695652174,323,139
22400068,2,13,0.0,0.0,137,124
22400068,2,119,-5.0,-2.521008403361345,119,0
22400068,3,300,3.0,0.6,720,420
22400068,3,69,-3.0,-2.608695652173913,406,337
22400068,3,20,0.0,0.0,323,303
22400068,3,42,1.0,1.4285714285714284,292,250
22400068,3,77,-4.0,-3.116883116883117,250,173
22400068,3,122,-1.0,-0.49180327868852464,156,34
22400068,3,27,0.0,0.0,34,7
22400068,4,84,-6.0,-4.285714285714286,720,636
22400068,4,24,0.0,0.0,613,589
22400068,4,42,3.0,4.285714285714286,581,539
22400068,4,68,0.0,0.0,532,464
22400068,4,84,-4.0,-2.8571428571428568,458,374
22400068,4,67,0.0,0.0,359,292
22400068,4,74,1.0,0.8108108108108109,292,218
22400068,4,105,-8.0,-4.571428571428572,205,100
22400068,4,56,0.0,0.0,89,33
22400068,4,5,-1.0,-12.0,11,6
22400068,4,2,1.0,30.0,6,4
22400068,4,3,0.0,0.0,3,0
22400069,1,346,-3.0,-0.5202312138728323,720,374
22400069,1,145,2.0,0.8275862068965517,365,220
22400069,1,29,3.0,6.206896551724138,207,178
22400069,1,14,0.0,0.0,168,154
22400069,2,167,1.0,0.3592814371257485,720,553
22400069,2,103,-2.0,-1.1650485436893203,542,439
22400069,2,62,0.0,0.0,439,377
22400069,2,203,-9.0,-2.6600985221674875,353,150
22400069,2,139,7.0,3.0215827338129495,150,11
22400069,2,1,0.0,0.0,1,0
22400069,3,10,-2.0,-12.0,720,710
22400069,3,213,10.0,2.816901408450704,710,497
22400069,3,16,0.0,0.0,480,464
22400069,3,148,0.0,0.0,453,305
22400069,3,138,2.0,0.8695652173913043,288,150
22400069,3,68,-1.0,-0.8823529411764706,150,82
22400069,3,43,2.0,2.7906976744186047,43,0
22400069,4,126,-4.0,-1.9047619047619047,720,594
22400069,4,93,2.0,1.2903225806451615,594,501
22400069,4,48,1.0,1.25,501,453
22400069,4,35,2.0,3.4285714285714284,453,418
22400069,4,50,0.0,0.0,405,355
22400069,4,95,0.0,0.0,355,260
22400069,4,23,0.0,0.0,260,237
22400069,4,112,3.0,1.607142857142857,218,106
22400069,4,31,0.0,0.0,91,60
22400070,1,232,-1.0,-0.25862068965517243,720,488
22400070,1,62,2.0,1.935483870967742,488,426
22400070,1,84,-5.0,-3.571428571428571,414,330
22400070,1,9,0.0,0.0,317,308
22400070,1,34,0.0,0.0,308,274
22400070,1,66,-6.0,-5.454545454545455,269,203
22400070,1,33,2.0,3.6363636363636367,190,157
22400070,1,18,0.0,0.0,145,127
22400070,1,22,2.0,5.454545454545455,127,105
22400070,1,85,0.0,0.0,100,15
22400070,1,15,0.0,0.0,15,0
22400070,2,136,-2.0,-0.8823529411764706,720,584
22400070,2,42,2.0,2.8571428571428568,584,542
22400070,2,76,2.0,1.5789473684210527,533,457
22400070,2,32,0.0,0.0,442,410
22400070,2,49,1.0,1.2244897959183672,410,361
22400070,2,158,-6.0,-2.278481012658228,347,189
22400070,2,99,3.0,1.8181818181818183,181,82
22400070,2,32,-2.0,-3.75,82,50
22400070,2,46,1.0,1.3043478260869565,50,4
22400070,3,251,6.0,1.4342629482071714,720,469
22400070,3,70,-1.0,-0.8571428571428571,455,385
22400070,3,37,0.0,0.0,385,348
22400070,3,188,-1.0,-0.3191489361702128,324,136
22400070,3,99,2.0,1.2121212121212122,120,21
22400070,4,42,-1.0,-1.4285714285714284,720,678
22400070,4,84,-3.0,-2.142857142857143,671,587
22400070,4,32,0.0,0.0,587,555
22400070,4,27,2.0,4.444444444444445,548,521
22400070,4,67,5.0,4.477611940298507,507,440
22400070,4,67,-6.0,-5.3731343283582085,405,338
22400070,4,60,1.0,1.0,330,270
22400070,4,30,2.0,4.0,270,240
22400070,4,104,1.0,0.576923076923077,240,136
22400070,4,52,-1.0,-1.153846153846154,136,84
22400070,4,62,-1.0,-0.967741935483871,68,6
22400070,4,4,0.0,0.0,4,0
22400071,1,155,0.0,0.0,720,565
22400071,1,38,0.0,0.0,565,527
22400071,1,72,-1.0,-0.8333333333333333,527,455
22400071,1,127,0.0,0.0,447,320
22400071,1,89,1.0,0.6741573033707865,320,231
22400071,1,25,0.0,0.0,225,200
22400071,1,8,0.0,0.0,191,183
22400071,1,22,1.0,2.7272727272727275,175,153
22400071,1,153,-5.0,-1.9607843137254903,153,0
22400071,2,127,-1.0,-0.47244094488188976,720,593
22400071,2,14,0.0,0.0,574,560
22400071,2,22,0.0,0.0,543,521
22400071,2,66,-3.0,-2.7272727272727275,510,444
22400071,2,12,0.0,0.0,435,423
22400071,2,89,-6.0,-4.044943820224719,401,312
22400071,2,49,0.0,0.0,295,246
22400071,2,67,-1.0,-0.8955223880597015,219,152
22400071,2,8,1.0,7.5,144,136
22400071,2,36,2.0,3.333333333333333,136,100
22400071,2,74,2.0,1.6216216216216217,152,78
22400071,2,26,0.0,0.0,78,52
22400071,2,49,2.0,2.4489795918367343,49,0
22400071,3,189,5.0,1.5873015873015872,720,531
22400071,3,20,1.0,3.0,519,499
22400071,3,69,1.0,0.8695652173913043,499,430
22400071,3,117,6.0,3.0769230769230766,430,313
22400071,3,88,-2.0,-1.3636363636363638,307,219
22400071,3,2,-1.0,-30.0,215,213
22400071,3,213,-2.0,-0.5633802816901409,213,0
22400071,4,28,-1.0,-2.142857142857143,720,692
22400071,4,142,6.0,2.535211267605634,692,550
22400071,4,91,-2.0,-1.3186813186813189,435,344
22400071,4,105,2.0,1.142857142857143,337,232
22400071,4,37,-5.0,-8.108108108108109,232,195
22400071,4,29,0.0,0.0,195,166
22400071,4,53,-3.0,-3.3962264150943398,166,113
22400071,4,12,0.0,0.0,99,87
22400071,4,33,3.0,5.454545454545455,74,41
22400071,4,41,0.0,0.0,41,0
22400071,5,136,-2.0,-0.8823529411764706,300,164
22400071,5,29,2.0,4.137931034482759,164,135
22400071,5,55,0.0,0.0,135,80
22400071,5,76,3.0,2.3684210526315788,80,4
22400071,5,1,-1.0,-60.0,4,3
22400071,5,1,0.0,0.0,1,0
22400072,1,314,6.0,1.1464968152866242,720,406
22400072,1,67,0.0,0.0,406,339
22400072,1,40,2.0,3.0,334,294
22400072,1,81,-2.0,-1.4814814814814814,289,208
22400072,1,9,-1.0,-6.666666666666666,208,199
22400072,1,53,0.0,0.0,189,136
22400072,1,15,-2.0,-8.0,114,99
22400072,1,94,-3.0,-1.9148936170212765,99,5
22400072,1,1,0.0,0.0,1,0
22400072,2,130,0.0,0.0,720,590
22400072,2,73,1.0,0.821917808219178,580,507
22400072,2,72,-1.0,-0.8333333333333333,501,429
22400072,2,52,0.0,0.0,429,377
22400072,2,96,-3.0,-1.875,368,272
22400072,2,100,-3.0,-1.7999999999999998,264,164
22400072,2,12,-2.0,-10.0,152,140
22400072,2,130,-4.0,-1.8461538461538463,140,10
22400072,2,4,0.0,0.0,10,6
22400072,2,6,0.0,0.0,6,0
22400072,3,354,-5.0,-0.847457627118644,720,366
22400072,3,50,-3.0,-3.5999999999999996,347,297
22400072,3,46,-5.0,-6.521739130434782,286,240
22400072,3,28,0.0,0.0,240,212
22400072,3,27,2.0,4.444444444444445,193,166
22400072,3,32,-3.0,-5.625,152,120
22400072,3,21,-4.0,-11.428571428571427,120,99
22400072,3,81,1.0,0.7407407407407407,81,0
22400072,4,120,3.0,1.5,720,600
22400072,4,52,-1.0,-1.153846153846154,600,548
22400072,4,104,0.0,0.0,548,444
22400072,4,88,1.0,0.6818181818181819,444,356
22400072,4,18,-1.0,-3.333333333333333,356,338
22400072,4,31,0.0,0.0,338,307
22400072,4,12,1.0,5.0,296,284
22400072,4,16,0.0,0.0,284,268
22400072,4,70,-5.0,-4.285714285714286,266,196
22400072,4,175,-5.0,-1.7142857142857142,188,13
22400073,1,319,6.0,1.1285266457680252,720,401
22400073,1,77,1.0,0.7792207792207793,401,324
22400073,1,79,-1.0,-0.7594936708860759,312,233
22400073,1,121,-3.0,-1.487603305785124,210,89
22400073,1,23,0.0,0.0,89,66
22400073,1,23,1.0,2.608695652173913,66,43
22400073,1,26,0.0,0.0,43,17
22400073,1,17,0.0,0.0,17,0
22400073,2,163,0.0,0.0,720,557
22400073,2,31,-3.0,-5.806451612903226,557,526
22400073,2,70,-1.0,-0.8571428571428571,509,439
22400073,2,54,6.0,6.666666666666666,439,385
22400073,2,121,0.0,0.0,363,242
22400073,2,10,1.0,6.0,240,230
22400073,2,92,-6.0,-3.9130434782608696,230,138
22400073,2,32,1.0,1.875,135,103
22400073,2,90,-4.0,-2.666666666666667,103,13
22400073,3,229,-7.0,-1.8340611353711789,720,491
22400073,3,92,-5.0,-3.260869565217391,491,399
22400073,3,152,0.0,0.0,383,231
22400073,3,71,-1.0,-0.8450704225352113,231,160
22400073,3,141,-5.0,-2.127659574468085,141,0
22400073,4,112,-5.0,-2.678571428571429,720,608
22400073,4,104,0.0,0.0,588,484
22400073,4,15,0.0,0.0,463,448
22400073,4,103,1.0,0.5825242718446602,436,333
22400073,4,99,1.0,0.6060606060606061,333,234
22400073,4,30,1.0,2.0,221,191
22400073,4,186,4.0,1.2903225806451615,186,0
22400074,1,284,2.0,0.4225352112676056,720,436
22400074,1,43,0.0,0.0,432,389
22400074,1,12,-1.0,-5.0,389,377
22400074,1,91,-6.0,-3.956043956043956,363,272
22400074,1,12,1.0,5.0,263,251
22400074,1,34,0.0,0.0,234,200
22400074,1,13,0.0,0.0,187,174
22400074,1,49,0.0,0.0,162,113
22400074,1,93,0.0,0.0,93,0
22400074,2,75,0.0,0.0,720,645
22400074,2,30,1.0,2.0,620,590
22400074,2,109,1.0,0.5504587155963303,590,481
22400074,2,33,0.0,0.0,472,439
22400074,2,22,-3.0,-8.181818181818182,439,417
22400074,2,48,-1.0,-1.25,407,359
22400074,2,69,1.0,0.8695652173913043,344,275
22400074,2,96,1.0,0.625,264,168
22400074,2,154,0.0,0.0,154,0
22400074,3,395,9.0,1.3670886075949367,720,325
22400074,3,14,1.0,4.285714285714286,325,311
22400074,3,17,0.0,0.0,311,294
22400074,3,14,0.0,0.0,292,278
22400074,3,9,1.0,6.666666666666666,257,248
22400074,3,10,-1.0,-6.0,248,238
22400074,3,36,0.0,0.0,238,202
22400074,3,24,1.0,2.5,202,178
22400074,3,168,5.0,1.7857142857142856,178,10
22400074,3,10,0.0,0.0,10,0
22400074,4,60,2.0,2.0,720,660
22400074,4,58,6.0,6.206896551724138,660,602
22400074,4,111,7.0,3.7837837837837833,591,480
22400074,4,25,0.0,0.0,471,446
22400074,4,81,2.0,1.4814814814814814,440,359
22400074,4,163,-8.0,-2.9447852760736195,340,177
22400074,4,63,0.0,0.0,165,102
22400074,4,84,-2.0,-1.4285714285714284,84,0
22400075,1,334,5.0,0.8982035928143712,720,386
22400075,1,12,0.0,0.0,372,360
22400075,1,105,-6.0,-3.4285714285714284,348,243
22400075,1,36,0.0,0.0,243,207
22400075,1,51,0.0,0.0,205,154
22400075,1,21,0.0,0.0,154,133
22400075,1,73,-2.0,-1.643835616438356,121,48
22400075,1,36,-3.0,-5.0,48,12
22400075,2,95,0.0,0.0,720,625
22400075,2,123,-1.0,-0.48780487804878053,625,502
22400075,2,22,-2.0,-5.454545454545455,486,464
22400075,2,16,1.0,3.75,422,406
22400075,2,121,2.0,0.9917355371900827,406,285
22400075,2,226,-3.0,-0.7964601769911505,266,40
22400075,2,28,2.0,4.285714285714286,35,7
22400075,3,260,3.0,0.6923076923076923,720,460
22400075,3,127,-2.0,-0.9448818897637795,460,333
22400075,3,89,0.0,0.0,311,222
22400075,3,96,-6.0,-3.75,222,126
22400075,3,120,-2.0,-1.0,120,0
22400075,4,77,5.0,3.8961038961038956,720,643
22400075,4,85,-4.0,-2.8235294117647056,641,556
22400075,4,2,0.0,0.0,474,472
22400075,4,116,-1.0,-0.5172413793103449,464,348
22400075,4,76,0.0,0.0,340,264
22400075,4,158,3.0,1.139240506329114,256,98
22400075,4,8,0.0,0.0,79,71
22400075,4,64,0.0,0.0,64,0
22400076,1,378,5.0,0.7936507936507936,720,342
22400076,1,18,-1.0,-3.333333333333333,329,311
22400076,1,102,1.0,0.5882352941176471,311,209
22400076,1,68,-4.0,-3.5294117647058822,209,141
22400076,1,58,1.0,1.0344827586206897,119,61
22400076,1,46,1.0,1.3043478260869565,55,9
22400076,2,162,0.0,0.0,720,558
22400076,2,23,-1.0,-2.608695652173913,550,527
22400076,2,56,-1.0,-1.0714285714285714,527,471
22400076,2,1,0.0,0.0,447,446
22400076,2,120,-2.0,-1.0,436,316
22400076,2,81,-1.0,-0.7407407407407407,295,214
22400076,2,78,-3.0,-2.307692307692308,214,136
22400076,2,23,3.0,7.826086956521739,123,100
22400076,2,72,1.0,0.8333333333333333,100,28
22400076,2,28,0.0,0.0,28,0
22400076,3,241,2.0,0.4979253112033195,720,479
22400076,3,126,5.0,2.380952380952381,479,353
22400076,3,9,-3.0,-20.0,335,326
22400076,3,121,2.0,0.9917355371900827,308,187
22400076,3,71,-5.0,-4.225352112676057,187,116
22400076,3,72,-3.0,-2.5,100,28
22400076,3,14,0.0,0.0,14,0
22400076,4,122,2.0,0.9836065573770493,720,598
22400076,4,63,3.0,2.8571428571428568,590,527
22400076,4,58,-4.0,-4.137931034482759,527,469
22400076,4,53,-3.0,-3.3962264150943398,453,400
22400076,4,62,2.0,1.935483870967742,368,306
22400076,4,79,0.0,0.0,295,216
22400076,4,56,3.0,3.214285714285714,196,140
22400076,4,102,2.0,1.1764705882352942,140,38
22400077,1,302,2.0,0.3973509933774834,720,418
22400077,1,153,-1.0,-0.39215686274509803,418,265
22400077,1,26,3.0,6.923076923076923,257,231
22400077,1,22,0.0,0.0,212,190
22400077,1,30,0.0,0.0,174,144
22400077,1,132,-9.0,-4.090909090909091,134,2
22400077,2,141,0.0,0.0,720,579
22400077,2,49,4.0,4.897959183673469,579,530
22400077,2,1,0.0,0.0,518,517
22400077,2,81,1.0,0.7407407407407407,504,423
22400077,2,87,2.0,1.3793103448275863,423,336
22400077,2,40,2.0,3.0,336,296
22400077,2,13,1.0,4.615384615384616,287,274
22400077,2,165,-11.0,-4.0,274,109
22400077,2,109,2.0,1.1009174311926606,109,0
22400077,3,340,-1.0,-0.1764705882352941,720,380
22400077,3,66,-2.0,-1.8181818181818183,380,314
22400077,3,52,4.0,4.615384615384616,314,262
22400077,3,32,2.0,3.75,248,216
22400077,3,26,2.0,4.615384615384616,203,177
22400077,3,91,2.0,1.3186813186813189,177,86
22400077,3,84,0.0,0.0,84,0
22400077,4,227,4.0,1.0572687224669604,720,493
22400077,4,119,-1.0,-0.5042016806722689,491,372
22400077,4,49,2.0,2.4489795918367343,372,323
22400077,4,68,-1.0,-0.8823529411764706,323,255
22400077,4,69,-2.0,-1.7391304347826086,255,186
22400077,4,44,1.0,1.3636363636363638,168,124
22400077,4,19,0.0,0.0,112,93
22400077,4,93,1.0,0.6451612903225807,93,0
22400078,1,189,2.0,0.6349206349206349,720,531
22400078,1,157,-2.0,-0.7643312101910829,531,374
22400078,1,55,0.0,0.0,374,319
22400078,1,46,0.0,0.0,308,262
22400078,1,84,-3.0,-2.142857142857143,262,178
22400078,1,86,-3.0,-2.0930232558139537,169,83
22400078,1,41,2.0,2.926829268292683,83,42
22400078,1,10,0.0,0.0,42,32
22400078,1,28,2.0,4.285714285714286,28,0
22400078,2,142,0.0,0.0,720,578
22400078,2,24,2.0,5.0,578,554
22400078,2,39,0.0,0.0,554,515
22400078,2,46,-1.0,-1.3043478260869565,503,457
22400078,2,54,2.0,2.2222222222222223,457,403
22400078,2,45,2.0,2.666666666666667,400,355
22400078,2,33,-1.0,-1.8181818181818183,355,322
22400078,2,84,2.0,1.4285714285714284,322,238
22400078,2,20,-1.0,-3.0,238,218
22400078,2,21,-1.0,-2.8571428571428568,218,197
22400078,2,184,-1.0,-0.32608695652173914,197,13
22400078,3,107,1.0,0.5607476635514018,720,613
22400078,3,60,1.0,1.0,613,553
22400078,3,109,0.0,0.0,539,430
22400078,3,27,0.0,0.0,406,379
22400078,3,15,1.0,4.0,379,364
22400078,3,41,0.0,0.0,364,323
22400078,3,101,-2.0,-1.188118811881188,323,222
22400078,3,53,0.0,0.0,222,169
22400078,3,142,3.0,1.267605633802817,169,27
22400078,3,27,0.0,0.0,27,0
22400078,4,143,4.0,1.6783216783216783,720,577
22400078,4,105,6.0,3.4285714285714284,577,472
22400078,4,15,3.0,12.0,451,436
22400078,4,25,-3.0,-7.199999999999999,436,411
22400078,4,18,0.0,0.0,411,393
22400078,4,6,-1.0,-10.0,393,387
22400078,4,169,-2.0,-0.7100591715976331,387,218
22400078,4,22,0.0,0.0,218,196
22400078,4,124,0.0,0.0,196,72
22400078,4,72,-1.0,-0.8333333333333333,72,0
22400079,1,355,3.0,0.5070422535211268,720,365
22400079,1,1,0.0,0.0,351,350
22400079,1,33,3.0,5.454545454545455,340,307
22400079,1,64,2.0,1.875,289,225
22400079,1,51,2.0,2.3529411764705883,213,162
22400079,1,156,1.0,0.3846153846153846,162,6
22400079,1,6,0.0,0.0,6,0
22400079,2,104,-1.0,-0.576923076923077,720,616
22400079,2,30,2.0,4.0,616,586
22400079,2,65,4.0,3.6923076923076925,580,515
22400079,2,31,-1.0,-1.935483870967742,515,484
22400079,2,62,-3.0,-2.903225806451613,484,422
22400079,2,29,-2.0,-4.137931034482759,403,374
22400079,2,35,-2.0,-3.4285714285714284,368,333
22400079,2,27,-1.0,-2.2222222222222223,333,306
22400079,2,43,2.0,2.7906976744186047,306,263
22400079,2,249,-7.0,-1.686746987951807,258,9
22400079,3,215,-1.0,-0.27906976744186046,720,505
22400079,3,21,0.0,0.0,493,472
22400079,3,120,3.0,1.5,457,337
22400079,3,35,0.0,0.0,325,290
22400079,3,36,5.0,8.333333333333334,267,231
22400079,3,19,0.0,0.0,218,199
22400079,3,50,-2.0,-2.4,184,134
22400079,3,10,-1.0,-6.0,122,112
22400079,3,48,-4.0,-5.0,112,64
22400079,3,32,2.0,3.75,64,32
22400079,3,30,2.0,4.0,32,2
22400079,3,2,0.0,0.0,2,0
22400079,4,101,0.0,0.0,720,619
22400079,4,123,3.0,1.4634146341463414,612,489
22400079,4,74,-1.0,-0.8108108108108109,484,410
22400079,4,48,-3.0,-3.75,410,362
22400079,4,95,3.0,1.8947368421052633,324,229
22400079,4,16,0.0,0.0,229,213
22400079,4,168,-2.0,-0.7142857142857142,189,21
22400079,4,5,0.0,0.0,21,16
22400079,4,9,-2.0,-13.333333333333332,16,7
22400079,4,2,0.0,0.0,2,0
22400080,1,358,-2.0,-0.335195530726257,720,362
22400080,1,34,5.0,8.823529411764707,362,328
22400080,1,19,1.0,3.1578947368421053,308,289
22400080,1,14,0.0,0.0,289,275
22400080,1,111,-8.0,-4.324324324324325,258,147
22400080,1,135,2.0,0.888888888888889,147,12
22400080,2,101,-1.0,-0.594059405940594,720,619
22400080,2,31,0.0,0.0,608,577
22400080,2,53,1.0,1.1320754716981132,568,515
22400080,2,27,1.0,2.2222222222222223,493,466
22400080,2,91,3.0,1.978021978021978,466,375
22400080,2,48,1.0,1.25,364,316
22400080,2,65,0.0,0.0,300,235
22400080,2,96,0.0,0.0,235,139
22400080,2,93,3.0,1.935483870967742,127,34
22400080,3,205,0.0,0.0,720,515
22400080,3,13,0.0,0.0,505,492
22400080,3,47,1.0,1.2765957446808511,492,445
22400080,3,52,2.0,2.307692307692308,436,384
22400080,3,139,-3.0,-1.2949640287769786,384,245
22400080,3,84,-2.0,-1.4285714285714284,225,141
22400080,3,7,0.0,0.0,127,120
22400080,3,64,5.0,4.6875,105,41
22400080,3,33,1.0,1.8181818181818183,41,8
22400080,3,8,2.0,15.0,8,0
22400080,4,48,0.0,0.0,720,672
22400080,4,79,-2.0,-1.5189873417721518,665,586
22400080,4,55,2.0,2.1818181818181817,575,520
22400080,4,83,-2.0,-1.4457831325301205,506,423
22400080,4,110,8.0,4.363636363636363,423,313
22400080,4,23,-2.0,-5.217391304347826,302,279
22400080,4,168,-4.0,-1.4285714285714284,255,87
22400080,4,69,2.0,1.7391304347826086,69,0
22400081,1,329,2.0,0.364741641337386,720,391
22400081,1,188,2.0,0.6382978723404256,391,203
22400081,1,53,-2.0,-2.2641509433962264,180,127
22400081,1,107,-1.0,-0.5607476635514018,115,8
22400081,1,1,0.0,0.0,1,0
22400081,2,211,-2.0,-0.5687203791469195,720,509
22400081,2,60,2.0,2.0,509,449
22400081,2,47,0.0,0.0,435,388
22400081,2,301,9.0,1.7940199335548175,388,87
22400081,2,87,3.0,2.0689655172413794,87,0
22400081,3,372,2.0,0.32258064516129037,720,348
22400081,3,55,1.0,1.0909090909090908,348,293
22400081,3,25,-1.0,-2.4,293,268
22400081,3,29,2.0,4.137931034482759,240,211
22400081,3,99,7.0,4.242424242424242,211,112
22400081,3,65,2.0,1.8461538461538463,93,28
22400081,3,28,0.0,0.0,28,0
22400081,4,150,-3.0,-1.2,720,570
22400081,4,85,-3.0,-2.1176470588235294,565,480
22400081,4,129,4.0,1.8604651162790697,472,343
22400081,4,35,2.0,3.4285714285714284,334,299
22400081,4,31,-1.0,-1.935483870967742,295,264
22400081,4,39,1.0,1.5384615384615383,264,225
22400081,4,97,-4.0,-2.4742268041237114,225,128
22400081,4,118,0.0,0.0,118,0
22400082,1,121,0.0,0.0,720,599
22400082,1,126,-1.0,-0.47619047619047616,585,459
22400082,1,73,1.0,0.821917808219178,459,386
22400082,1,80,-2.0,-1.5,374,294
22400082,1,67,-1.0,-0.8955223880597015,287,220
22400082,1,31,-5.0,-9.67741935483871,220,189
22400082,1,6,-1.0,-10.0,170,164
22400082,1,96,0.0,0.0,164,68
22400082,1,29,3.0,6.206896551724138,61,32
22400082,1,19,0.0,0.0,19,0
22400082,2,163,-5.0,-1.8404907975460123,720,557
22400082,2,17,-2.0,-7.0588235294117645,538,521
22400082,2,86,-1.0,-0.6976744186046512,497,411
22400082,2,30,-3.0,-6.0,411,381
22400082,2,58,3.0,3.103448275862069,381,323
22400082,2,196,3.0,0.9183673469387755,320,124
22400082,2,59,0.0,0.0,124,65
22400082,2,33,-1.0,-1.8181818181818183,53,20
22400082,3,122,4.0,1.9672131147540985,720,598
22400082,3,64,0.0,0.0,598,534
22400082,3,140,-1.0,-0.42857142857142855,534,394
22400082,3,44,3.0,4.090909090909091,394,350
22400082,3,75,6.0,4.8,335,260
22400082,3,165,6.0,2.1818181818181817,241,76
22400082,3,4,0.0,0.0,76,72
22400082,3,54,3.0,3.333333333333333,72,18
22400082,3,15,0.0,0.0,18,3
22400082,4,98,4.0,2.4489795918367343,720,622
22400082,4,82,0.0,0.0,622,540
22400082,4,5,0.0,0.0,521,516
22400082,4,5,2.0,24.0,511,506
22400082,4,69,-3.0,-2.608695652173913,496,427
22400082,4,72,2.0,1.6666666666666665,424,352
22400082,4,26,-3.0,-6.923076923076923,352,326
22400082,4,112,3.0,1.607142857142857,326,214
22400082,4,59,-1.0,-1.0169491525423728,192,133
22400082,4,115,-1.0,-0.5217391304347826,115,0
22400083,1,431,5.0,0.6960556844547563,720,289
22400083,1,46,2.0,2.608695652173913,272,226
22400083,1,84,0.0,0.0,226,142
22400083,1,56,3.0,3.214285714285714,142,86
22400083,2,46,-1.0,-1.3043478260869565,720,674
22400083,2,173,-2.0,-0.6936416184971098,674,501
22400083,2,40,4.0,6.0,501,461
22400083,2,193,-1.0,-0.31088082901554404,398,205
22400083,2,128,-4.0,-1.875,205,77
22400083,2,30,0.0,0.0,41,11
22400083,2,9,3.0,20.0,9,0
22400083,3,223,-3.0,-0.8071748878923767,720,497
22400083,3,133,-1.0,-0.45112781954887216,492,359
22400083,3,23,0.0,0.0,359,336
22400083,3,43,0.0,0.0,336,293
22400083,3,75,-5.0,-4.0,285,210
22400083,3,7,0.0,0.0,184,177
22400083,3,169,0.0,0.0,171,2
22400083,3,2,0.0,0.0,2,0
22400083,4,172,-2.0,-0.6976744186046512,720,548
22400083,4,63,-3.0,-2.8571428571428568,548,485
22400083,4,101,2.0,1.188118811881188,485,384
22400083,4,63,-1.0,-0.9523809523809523,384,321
22400083,4,88,0.0,0.0,312,224
22400083,4,106,-1.0,-0.5660377358490566,215,109
22400083,4,35,0.0,0.0,105,70
22400083,4,59,2.0,2.0338983050847457,59,0
22400084,1,298,4.0,0.8053691275167785,720,422
22400084,1,33,2.0,3.6363636363636367,420,387
22400084,1,69,-1.0,-0.8695652173913043,375,306
22400084,1,127,-9.0,-4.251968503937007,301,174
22400084,1,62,-2.0,-1.935483870967742,174,112
22400084,1,69,-2.0,-1.7391304347826086,112,43
22400084,2,103,1.0,0.5825242718446602,720,617
22400084,2,188,-2.0,-0.6382978723404256,617,429
22400084,2,58,2.0,2.0689655172413794,414,356
22400084,2,88,-3.0,-2.0454545454545454,346,258
22400084,2,83,-3.0,-2.1686746987951806,249,166
22400084,2,98,-5.0,-3.0612244897959187,143,45
22400084,2,45,0.0,0.0,45,0
22400084,3,167,-10.0,-3.592814371257485,720,553
22400084,3,153,-2.0,-0.7843137254901961,539,386
22400084,3,15,2.0,8.0,364,349
22400084,3,95,-3.0,-1.8947368421052633,349,254
22400084,3,137,0.0,0.0,249,112
22400084,3,112,2.0,1.0714285714285714,112,0
22400084,4,199,1.0,0.30150753768844224,720,521
22400084,4,19,0.0,0.0,521,502
22400084,4,25,-2.0,-4.8,502,477
22400084,4,55,-3.0,-3.2727272727272725,464,409
22400084,4,11,0.0,0.0,367,356
22400084,4,34,-2.0,-3.5294117647058822,348,314
22400084,4,75,2.0,1.6,299,224
22400084,4,204,-9.0,-2.647058823529412,204,0
22400085,1,234,4.0,1.0256410256410258,720,486
22400085,1,72,-3.0,-2.5,486,414
22400085,1,83,-2.0,-1.4457831325301205,406,323
22400085,1,95,0.0,0.0,304,209
22400085,1,41,-5.0,-7.317073170731707,199,158
22400085,1,90,-6.0,-4.0,139,49
22400085,1,49,-1.0,-1.2244897959183672,49,0
22400085,2,142,-7.0,-2.957746478873239,720,578
22400085,2,149,4.0,1.610738255033557,563,414
22400085,2,188,4.0,1.2765957446808511,391,203
22400085,2,7,0.0,0.0,189,182
22400085,2,30,3.0,6.0,175,145
22400085,2,46,-3.0,-3.9130434782608696,145,99
22400085,2,92,4.0,2.608695652173913,92,0
22400085,3,276,6.0,1.3043478260869565,720,444
22400085,3,157,-3.0,-1.1464968152866242,335,178
22400085,3,81,7.0,5.185185185185185,168,87
22400085,3,57,0.0,0.0,81,24
22400085,3,24,1.0,2.5,24,0
22400085,4,133,5.0,2.2556390977443606,720,587
22400085,4,15,2.0,8.0,587,572
22400085,4,44,-2.0,-2.7272727272727275,555,511
22400085,4,55,3.0,3.2727272727272725,500,445
22400085,4,84,3.0,2.142857142857143,445,361
22400085,4,59,-1.0,-1.0169491525423728,345,286
22400085,4,63,-2.0,-1.9047619047619047,286,223
22400085,4,223,0.0,0.0,223,0
22400086,1,293,8.0,1.6382252559726962,720,427
22400086,1,14,0.0,0.0,413,399
22400086,1,160,6.0,2.25,399,239
22400086,1,54,2.0,2.2222222222222223,232,178
22400086,1,151,0.0,0.0,178,27
22400086,2,264,1.0,0.2272727272727273,720,456
22400086,2,36,-2.0,-3.333333333333333,448,412
22400086,2,10,0.0,0.0,405,395
22400086,2,86,2.0,1.3953488372093024,382,296
22400086,2,119,0.0,0.0,277,158
22400086,2,36,0.0,0.0,158,122
22400086,2,101,-2.0,-1.188118811881188,112,11
22400086,2,11,0.0,0.0,11,0
22400086,3,348,-1.0,-0.1724137931034483,720,372
22400086,3,4,-1.0,-15.0,361,357
22400086,3,50,0.0,0.0,357,307
22400086,3,90,-3.0,-2.0,295,205
22400086,3,57,1.0,1.0526315789473684,262,205
22400086,3,63,3.0,2.8571428571428568,205,142
22400086,3,31,1.0,1.935483870967742,142,111
22400086,3,90,4.0,2.666666666666667,105,15
22400086,3,14,-1.0,-4.285714285714286,15,1
22400086,4,144,-2.0,-0.8333333333333333,720,576
22400086,4,83,-6.0,-4.337349397590361,561,478
22400086,4,73,3.0,2.4657534246575343,335,262
22400086,4,8,0.0,0.0,262,254
22400086,4,48,0.0,0.0,234,186
22400086,4,238,0.0,0.0,242,4
22400087,1,372,0.0,0.0,720,348
22400087,1,159,-2.0,-0.7547169811320755,341,182
22400087,1,18,0.0,0.0,173,155
22400087,1,148,-5.0,-2.027027027027027,148,0
22400087,2,201,1.0,0.29850746268656714,720,519
22400087,2,10,0.0,0.0,506,496
22400087,2,25,-2.0,-4.8,487,462
22400087,2,49,-4.0,-4.897959183673469,448,399
22400087,2,6,-3.0,-30.0,387,381
22400087,2,47,0.0,0.0,363,316
22400087,2,299,10.0,2.0066889632107023,307,8
22400087,2,7,1.0,8.571428571428571,8,1
22400087,2,1,0.0,0.0,1,0
22400087,3,372,4.0,0.6451612903225807,720,348
22400087,3,15,0.0,0.0,330,315
22400087,3,112,0.0,0.0,308,196
22400087,3,42,5.0,7.142857142857142,176,134
22400087,3,134,-1.0,-0.44776119402985076,134,0
22400087,4,127,-2.0,-0.9448818897637795,720,593
22400087,4,50,3.0,3.5999999999999996,581,531
22400087,4,100,2.0,1.2,526,426
22400087,4,136,-5.0,-2.2058823529411766,415,279
22400087,4,51,1.0,1.1764705882352942,279,228
22400087,4,193,-4.0,-1.2435233160621761,212,19
22400087,4,3,0.0,0.0,19,16
22400087,4,14,-2.0,-8.571428571428571,14,0
22400088,1,309,-1.0,-0.1941747572815534,720,411
22400088,1,82,4.0,2.926829268292683,403,321
22400088,1,58,-3.0,-3.103448275862069,315,257
22400088,1,47,-4.0,-5.1063829787234045,236,189
22400088,1,43,0.0,0.0,176,133
22400088,1,39,3.0,4.615384615384616,57,18
22400088,1,11,0.0,0.0,18,7
22400088,2,77,-2.0,-1.5584415584415585,720,643
22400088,2,104,-1.0,-0.576923076923077,643,539
22400088,2,68,-1.0,-0.8823529411764706,528,460
22400088,2,56,2.0,2.142857142857143,460,404
22400088,2,92,1.0,0.6521739130434783,377,285
22400088,2,85,-1.0,-0.7058823529411764,285,200
22400088,2,29,-2.0,-4.137931034482759,200,171
22400088,2,90,2.0,1.3333333333333335,159,69
22400088,2,69,0.0,0.0,69,0
22400088,3,171,0.0,0.0,720,549
22400088,3,159,-2.0,-0.7547169811320755,549,390
22400088,3,74,0.0,0.0,377,303
22400088,3,8,0.0,0.0,290,282
22400088,3,58,0.0,0.0,282,224
22400088,3,23,3.0,7.826086956521739,224,201
22400088,3,96,-6.0,-3.75,187,91
22400088,3,9,0.0,0.0,89,80
22400088,3,45,3.0,4.0,80,35
22400088,3,35,-1.0,-1.7142857142857142,35,0
22400088,4,48,6.0,7.5,720,672
22400088,4,58,-3.0,-3.103448275862069,654,596
22400088,4,36,-5.0,-8.333333333333334,582,546
22400088,4,87,4.0,2.7586206896551726,534,447
22400088,4,71,3.0,2.535211267605634,436,365
22400088,4,19,-2.0,-6.315789473684211,354,335
22400088,4,317,3.0,0.5678233438485805,317,0
22400089,1,330,-6.0,-1.0909090909090908,720,390
22400089,1,4,0.0,0.0,361,357
22400089,1,21,2.0,5.7142857142857135,348,327
22400089,1,61,0.0,0.0,219,158
22400089,1,39,-3.0,-4.615384615384616,151,112
22400089,1,7,-2.0,-17.142857142857142,112,105
22400089,1,105,-1.0,-0.5714285714285715,105,0
22400089,2,146,-4.0,-1.643835616438356,720,574
22400089,2,49,2.0,2.4489795918367343,559,510
22400089,2,139,-7.0,-3.0215827338129495,510,371
22400089,2,76,2.0,1.5789473684210527,351,275
22400089,2,106,5.0,2.8301886792452833,273,167
22400089,2,48,-2.0,-2.5,167,119
22400089,2,98,5.0,3.0612244897959187,98,0
22400089,3,424,6.0,0.8490566037735849,720,296
22400089,3,122,7.0,3.4426229508196724,287,165
22400089,3,151,-3.0,-1.1920529801324504,151,0
22400089,4,194,2.0,0.6185567010309279,720,526
22400089,4,30,0.0,0.0,526,496
22400089,4,37,4.0,6.486486486486487,496,459
22400089,4,40,0.0,0.0,459,419
22400089,4,57,0.0,0.0,419,362
22400089,4,76,2.0,1.5789473684210527,341,265
22400089,4,233,-10.0,-2.575107296137339,262,29
22400089,4,14,2.0,8.571428571428571,25,11
22400089,4,8,-2.0,-15.0,11,3
22400090,1,287,-2.0,-0.4181184668989547,720,433
22400090,1,38,2.0,3.1578947368421053,417,379
22400090,1,44,-1.0,-1.3636363636363638,379,335
22400090,1,117,-1.0,-0.5128205128205129,321,204
22400090,1,204,1.0,0.29411764705882354,204,0
22400090,2,90,0.0,0.0,720,630
22400090,2,151,0.0,0.0,627,476
22400090,2,94,0.0,0.0,462,368
22400090,2,44,0.0,0.0,357,313
22400090,2,34,-2.0,-3.5294117647058822,313,279
22400090,2,5,0.0,0.0,259,254
22400090,2,145,6.0,2.4827586206896552,244,99
22400090,2,72,-1.0,-0.8333333333333333,79,7
22400090,2,2,2.0,60.0,2,0
22400090,3,225,-8.0,-2.1333333333333333,720,495
22400090,3,67,1.0,0.8955223880597015,472,405
22400090,3,118,-4.0,-2.0338983050847457,405,287
22400090,3,15,1.0,4.0,270,255
22400090,3,95,0.0,0.0,255,160
22400090,4,134,-5.0,-2.2388059701492535,720,586
22400090,4,98,-2.0,-1.2244897959183672,571,473
22400090,4,94,-2.0,-1.2765957446808511,473,379
22400090,4,6,3.0,30.0,379,373
22400090,4,41,0.0,0.0,360,319
22400090,4,117,3.0,1.5384615384615383,319,202
22400091,1,285,-2.0,-0.4210526315789474,720,435
22400091,1,110,2.0,1.0909090909090908,424,314
22400091,1,90,-1.0,-0.6666666666666667,314,224
22400091,1,37,0.0,0.0,224,187
22400091,1,13,-2.0,-9.230769230769232,175,162
22400091,1,111,1.0,0.5405405405405406,162,51
22400091,1,32,-3.0,-5.625,51,19
22400091,1,19,1.0,3.1578947368421053,19,0
22400091,2,110,1.0,0.5454545454545454,720,610
22400091,2,5,-1.0,-12.0,602,597
22400091,2,61,-1.0,-0.9836065573770493,597,536
22400091,2,74,0.0,0.0,536,462
22400091,2,2,0.0,0.0,451,449
22400091,2,21,0.0,0.0,436,415
22400091,2,34,2.0,3.5294117647058822,415,381
22400091,2,47,0.0,0.0,381,334
22400091,2,30,-2.0,-4.0,317,287
22400091,2,139,-5.0,-2.158273381294964,274,135
22400091,2,10,-1.0,-6.0,30,20
22400091,2,20,-2.0,-6.0,20,0
22400091,3,337,2.0,0.3560830860534125,720,383
22400091,3,188,0.0,0.0,369,181
22400091,3,40,0.0,0.0,181,141
22400091,3,39,-2.0,-3.0769230769230766,132,93
22400091,3,93,-4.0,-2.580645161290323,93,0
22400091,4,30,-2.0,-4.0,720,690
22400091,4,36,5.0,8.333333333333334,690,654
22400091,4,45,-3.0,-4.0,654,609
22400091,4,40,3.0,4.5,602,562
22400091,4,16,-2.0,-7.5,554,538
22400091,4,117,1.0,0.5128205128205129,538,421
22400091,4,155,4.0,1.5483870967741935,421,266
22400091,4,7,0.0,0.0,241,234
22400091,4,33,1.0,1.8181818181818183,225,192
22400091,4,178,0.0,0.0,178,0
22400092,1,186,4.0,1.2903225806451615,720,534
22400092,1,18,0.0,0.0,522,504
22400092,1,104,0.0,0.0,504,400
22400092,1,155,6.0,2.3225806451612905,400,245
22400092,1,55,-4.0,-4.363636363636363,233,178
22400092,1,4,0.0,0.0,143,139
22400092,1,41,3.0,4.390243902439024,114,73
22400092,1,69,0.0,0.0,73,4
22400092,1,4,0.0,0.0,4,0
22400092,2,20,0.0,0.0,720,700
22400092,2,105,5.0,2.8571428571428568,700,595
22400092,2,79,1.0,0.7594936708860759,584,505
22400092,2,104,0.0,0.0,505,401
22400092,2,109,1.0,0.5504587155963303,401,292
22400092,2,81,-1.0,-0.7407407407407407,292,211
22400092,2,85,3.0,2.1176470588235294,211,126
22400092,2,62,5.0,4.838709677419355,109,47
22400092,3,198,-6.0,-1.8181818181818183,720,522
22400092,3,84,6.0,4.285714285714286,506,422
22400092,3,22,-3.0,-8.181818181818182,411,389
22400092,3,71,-4.0,-3.380281690140845,389,318
22400092,3,32,-1.0,-1.875,318,286
22400092,3,28,-3.0,-6.428571428571428,286,258
22400092,3,69,-5.0,-4.3478260869565215,246,177
22400092,3,52,4.0,4.615384615384616,177,125
22400092,3,46,2.0,2.608695652173913,103,57
22400092,3,57,0.0,0.0,57,0
22400092,4,157,2.0,0.7643312101910829,720,563
22400092,4,107,0.0,0.0,563,456
22400092,4,100,6.0,3.5999999999999996,435,335
22400092,4,24,3.0,7.5,317,293
22400092,4,95,-1.0,-0.631578947368421,278,183
22400092,4,46,3.0,3.9130434782608696,170,124
22400092,4,113,-8.0,-4.2477876106194685,113,0
22400093,1,334,9.0,1.6167664670658684,720,386
22400093,1,52,1.0,1.153846153846154,386,334
22400093,1,28,0.0,0.0,332,304
22400093,1,81,-1.0,-0.7407407407407407,304,223
22400093,1,24,0.0,0.0,217,193
22400093,1,64,1.0,0.9375,173,109
22400093,1,22,3.0,8.181818181818182,91,69
22400093,2,75,-2.0,-1.6,720,645
22400093,2,140,5.0,2.142857142857143,645,505
22400093,2,95,-2.0,-1.263157894736842,492,397
22400093,2,22,-2.0,-5.454545454545455,388,366
22400093,2,137,1.0,0.437956204379562,366,229
22400093,2,4,0.0,0.0,211,207
22400093,2,32,0.0,0.0,202,170
22400093,2,143,1.0,0.4195804195804196,162,19
22400093,2,19,-2.0,-6.315789473684211,19,0
22400093,3,350,5.0,0.8571428571428571,720,370
22400093,3,27,2.0,4.444444444444445,340,313
22400093,3,47,2.0,2.5531914893617023,302,255
22400093,3,47,-1.0,-1.2765957446808511,237,190
22400093,3,78,-3.0,-2.307692307692308,190,112
22400093,3,97,-1.0,-0.6185567010309279,97,0
22400093,4,180,-3.0,-1.0,720,540
22400093,4,13,1.0,4.615384615384616,528,515
22400093,4,21,0.0,0.0,515,494
22400093,4,80,-2.0,-1.5,492,412
22400093,4,55,-2.0,-2.1818181818181817,400,345
22400093,4,329,-3.0,-0.547112462006079,329,0
22400094,1,357,10.0,1.680672268907563,720,363
22400094,1,165,1.0,0.36363636363636365,342,177
22400094,1,122,4.0,1.9672131147540985,155,33
22400094,2,146,-3.0,-1.2328767123287672,720,574
22400094,2,73,4.0,3.287671232876712,553,480
22400094,2,15,0.0,0.0,462,447
22400094,2,15,0.0,0.0,432,417
22400094,2,101,1.0,0.594059405940594,415,314
22400094,2,100,4.0,2.4,314,214
22400094,2,49,0.0,0.0,214,165
22400094,2,31,2.0,3.870967741935484,151,120
22400094,2,110,2.0,1.0909090909090908,110,0
22400094,3,258,-9.0,-2.0930232558139537,720,462
22400094,3,31,0.0,0.0,456,425
22400094,3,30,0.0,0.0,425,395
22400094,3,45,2.0,2.666666666666667,389,344
22400094,3,53,-2.0,-2.2641509433962264,334,281
22400094,3,63,1.0,0.9523809523809523,281,218
22400094,3,68,2.0,1.7647058823529411,212,144
22400094,3,12,-1.0,-5.0,144,132
22400094,3,121,3.0,1.487603305785124,121,0
22400094,4,134,-5.0,-2.2388059701492535,720,586
22400094,4,65,-1.0,-0.9230769230769231,570,505
22400094,4,93,-5.0,-3.2258064516129035,505,412
22400094,4,36,-2.0,-3.333333333333333,406,370
22400094,4,128,-2.0,-0.9375,354,226
22400094,4,204,-1.0,-0.29411764705882354,226,22
22400094,4,5,1.0,12.0,22,17
22400094,4,5,-2.0,-24.0,17,12
22400094,4,7,1.0,8.571428571428571,7,0
22400095,1,229,0.0,0.0,720,491
22400095,1,65,3.0,2.769230769230769,491,426
22400095,1,108,-2.0,-1.1111111111111112,419,311
22400095,1,68,0.0,0.0,287,219
22400095,1,10,0.0,0.0,211,201
22400095,1,11,1.0,5.454545454545455,201,190
22400095,1,103,3.0,1.7475728155339807,190,87
22400095,1,71,1.0,0.8450704225352113,78,7
22400095,1,7,0.0,0.0,7,0
22400095,2,198,8.0,2.4242424242424243,720,522
22400095,2,17,1.0,3.5294117647058822,503,486
22400095,2,64,0.0,0.0,435,371
22400095,2,102,0.0,0.0,371,269
22400095,2,32,-1.0,-1.875,269,237
22400095,2,117,-5.0,-2.5641025641025643,237,120
22400095,2,112,1.0,0.5357142857142857,112,0
22400095,3,272,-4.0,-0.8823529411764706,720,448
22400095,3,107,7.0,3.9252336448598126,448,341
22400095,3,14,0.0,0.0,323,309
22400095,3,152,-3.0,-1.1842105263157894,299,147
22400095,3,36,0.0,0.0,134,98
22400095,3,74,2.0,1.6216216216216217,98,24
22400095,4,138,-3.0,-1.3043478260869565,720,582
22400095,4,78,0.0,0.0,560,482
22400095,4,80,7.0,5.25,474,394
22400095,4,44,0.0,0.0,394,350
22400095,4,101,-3.0,-1.782178217821782,338,237
22400095,4,130,2.0,0.9230769230769231,229,99
22400095,4,37,-2.0,-3.2432432432432434,98,61
22400095,4,16,0.0,0.0,61,45
22400095,4,45,0.0,0.0,45,0
22400096,1,313,10.0,1.9169329073482428,720,407
22400096,1,92,-1.0,-0.6521739130434783,393,301
22400096,1,52,-3.0,-3.4615384615384617,289,237
22400096,1,86,1.0,0.6976744186046512,223,137
22400096,1,24,-1.0,-2.5,137,113
22400096,1,113,-5.0,-2.6548672566371683,113,0
22400096,2,63,5.0,4.761904761904762,720,657
22400096,2,80,4.0,3.0,639,559
22400096,2,20,0.0,0.0,559,539
22400096,2,43,1.0,1.3953488372093024,523,480
22400096,2,112,-5.0,-2.678571428571429,480,368
22400096,2,74,-2.0,-1.6216216216216217,360,286
22400096,2,57,-5.0,-5.263157894736842,286,229
22400096,2,32,-5.0,-9.375,224,192
22400096,2,45,0.0,0.0,175,130
22400096,2,80,-3.0,-2.25,111,31
22400096,2,6,-1.0,-10.0,31,25
22400096,2,25,3.0,7.199999999999999,25,0
22400096,3,341,-8.0,-1.4076246334310851,720,379
22400096,3,19,0.0,0.0,314,295
22400096,3,52,1.0,1.153846153846154,281,229
22400096,3,125,1.0,0.48,229,104
22400096,3,104,-3.0,-1.7307692307692308,104,0
22400096,4,123,14.0,6.829268292682927,720,597
22400096,4,91,7.0,4.615384615384616,589,498
22400096,4,35,-3.0,-5.142857142857143,493,458
22400096,4,171,-1.0,-0.3508771929824561,446,275
22400096,4,68,1.0,0.8823529411764706,267,199
22400096,4,112,-4.0,-2.142857142857143,190,78
22400096,4,47,-1.0,-1.2765957446808511,58,11
22400096,4,1,1.0,60.0,11,10
22400096,4,3,0.0,0.0,3,0
22400097,1,311,1.0,0.19292604501607716,720,409
22400097,1,38,-2.0,-3.1578947368421053,397,359
22400097,1,16,0.0,0.0,335,319
22400097,1,190,-5.0,-1.5789473684210527,417,227
22400097,1,94,-4.0,-2.5531914893617023,220,126
22400097,1,60,3.0,3.0,126,66
22400097,1,48,-4.0,-5.0,55,7
22400097,1,7,2.0,17.142857142857142,7,0
22400097,2,102,-1.0,-0.5882352941176471,720,618
22400097,2,35,1.0,1.7142857142857142,584,549
22400097,2,8,0.0,0.0,537,529
22400097,2,62,0.0,0.0,529,467
22400097,2,33,0.0,0.0,467,434
22400097,2,73,-3.0,-2.4657534246575343,434,361
22400097,2,84,2.0,1.4285714285714284,347,263
22400097,2,31,-1.0,-1.935483870967742,263,232
22400097,2,131,8.0,3.66412213740458,232,101
22400097,2,91,0.0,0.0,91,0
22400097,3,281,1.0,0.21352313167259784,720,439
22400097,3,53,-2.0,-2.2641509433962264,431,378
22400097,3,128,-10.0,-4.6875,378,250
22400097,3,84,2.0,1.4285714285714284,236,152
22400097,3,16,0.0,0.0,111,95
22400097,3,67,3.0,2.6865671641791042,86,19
22400097,3,2,0.0,0.0,2,0
22400097,4,152,2.0,0.7894736842105263,720,568
22400097,4,129,0.0,0.0,568,439
22400097,4,121,-2.0,-0.9917355371900827,430,309
22400097,4,1,0.0,0.0,298,297
22400097,4,272,0.0,0.0,285,13
22400097,4,11,0.0,0.0,11,0
22400097,5,285,1.0,0.2105263157894737,300,15
22400097,5,1,1.0,60.0,14,13
22400097,5,4,0.0,0.0,13,9
22400097,5,7,-2.0,-17.142857142857142,9,2
22400097,5,2,0.0,0.0,2,0
22400098,1,289,-1.0,-0.20761245674740486,720,431
22400098,1,36,3.0,5.0,431,395
22400098,1,49,0.0,0.0,389,340
22400098,1,87,-1.0,-0.6896551724137931,324,237
22400098,1,9,0.0,0.0,227,218
22400098,1,83,5.0,3.6144578313253013,218,135
22400098,1,120,-4.0,-2.0,120,0
22400098,2,202,4.0,1.188118811881188,720,518
22400098,2,75,-2.0,-1.6,509,434
22400098,2,77,2.0,1.5584415584415585,434,357
22400098,2,143,1.0,0.4195804195804196,339,196
22400098,3,292,2.0,0.410958904109589,720,428
22400098,3,57,-2.0,-2.1052631578947367,428,371
22400098,3,84,0.0,0.0,366,282
22400098,3,85,0.0,0.0,282,197
22400098,3,169,2.0,0.7100591715976331,197,28
22400098,3,28,3.0,6.428571428571428,28,0
22400098,4,203,4.0,1.1822660098522169,720,517
22400098,4,26,0.0,0.0,500,474
22400098,4,113,5.0,2.6548672566371683,474,361
22400098,4,39,3.0,4.615384615384616,349,310
22400098,4,100,2.0,1.2,306,206
22400098,4,84,1.0,0.7142857142857142,202,118
22400098,4,118,-4.0,-2.0338983050847457,118,0
22400099,1,323,-1.0,-0.18575851393188855,720,397
22400099,1,175,10.0,3.4285714285714284,382,207
22400099,1,21,-1.0,-2.8571428571428568,187,166
22400099,1,11,0.0,0.0,166,155
22400099,1,155,-2.0,-0.7741935483870968,155,0
22400099,2,167,4.0,1.437125748502994,720,553
22400099,2,57,2.0,2.1052631578947367,537,480
22400099,2,12,0.0,0.0,388,376
22400099,2,12,-1.0,-5.0,348,336
22400099,2,34,0.0,0.0,336,302
22400099,2,51,-2.0,-2.3529411764705883,283,232
22400099,2,91,2.0,1.3186813186813189,224,133
22400099,2,133,0.0,0.0,133,0
22400099,3,298,4.0,0.8053691275167785,720,422
22400099,3,21,2.0,5.7142857142857135,405,384
22400099,3,204,0.0,0.0,369,165
22400099,3,148,-3.0,-1.2162162162162162,160,12
22400099,3,1,0.0,0.0,1,0
22400099,4,78,5.0,3.846153846153846,720,642
22400099,4,53,-3.0,-3.3962264150943398,625,572
22400099,4,130,1.0,0.46153846153846156,632,502
22400099,4,72,-4.0,-3.333333333333333,502,430
22400099,4,191,5.0,1.5706806282722514,414,223
22400099,4,15,0.0,0.0,223,208
22400099,4,60,2.0,2.0,192,132
22400100,1,317,1.0,0.1892744479495268,720,403
22400100,1,73,0.0,0.0,403,330
22400100,1,26,-2.0,-4.615384615384616,330,304
22400100,1,78,2.0,1.5384615384615383,304,226
22400100,1,73,0.0,0.0,226,153
22400100,1,143,0.0,0.0,143,0
22400100,2,235,1.0,0.2553191489361702,720,485
22400100,2,92,-2.0,-1.3043478260869565,472,380
22400100,2,117,-6.0,-3.0769230769230766,361,244
22400100,2,131,1.0,0.4580152671755725,244,113
22400100,2,98,5.0,3.0612244897959187,103,5
22400100,3,325,6.0,1.1076923076923078,720,395
22400100,3,131,-3.0,-1.3740458015267176,395,264
22400100,3,163,-1.0,-0.36809815950920244,249,86
22400100,3,14,0.0,0.0,86,72
22400100,4,169,2.0,0.7100591715976331,720,551
22400100,4,17,1.0,3.5294117647058822,548,531
22400100,4,40,3.0,4.5,531,491
22400100,4,57,1.0,1.0526315789473684,483,426
22400100,4,41,0.0,0.0,417,376
22400100,4,104,4.0,2.307692307692308,376,272
22400100,4,70,4.0,3.4285714285714284,253,183
22400100,4,62,1.0,0.967741935483871,175,113
22400100,4,96,0.0,0.0,96,0
22400101,1,244,0.0,0.0,720,476
22400101,1,183,-3.0,-0.9836065573770493,476,293
22400101,1,8,0.0,0.0,272,264
22400101,1,75,0.0,0.0,257,182
22400101,1,39,-4.0,-6.153846153846153,161,122
22400101,1,90,3.0,2.0,108,18
22400101,1,13,0.0,0.0,18,5
22400101,1,1,-1.0,-60.0,1,0
22400101,2,104,-4.0,-2.307692307692308,720,616
22400101,2,60,0.0,0.0,616,556
22400101,2,62,-2.0,-1.935483870967742,556,494
22400101,2,60,3.0,3.0,478,418
22400101,2,22,2.0,5.454545454545455,418,396
22400101,2,28,0.0,0.0,385,357
22400101,2,73,-2.0,-1.643835616438356,347,274
22400101,2,36,-4.0,-6.666666666666666,262,226
22400101,2,153,2.0,0.7843137254901961,226,73
22400101,3,200,0.0,0.0,720,520
22400101,3,109,3.0,1.651376146788991,506,397
22400101,3,111,-3.0,-1.6216216216216217,383,272
22400101,3,36,-3.0,-5.0,259,223
22400101,3,41,-2.0,-2.926829268292683,204,163
22400101,4,232,-1.0,-0.25862068965517243,720,488
22400101,4,5,0.0,0.0,485,480
22400101,4,33,-1.0,-1.8181818181818183,469,436
22400101,4,33,0.0,0.0,436,403
22400101,4,61,-2.0,-1.9672131147540985,392,331
22400101,4,66,5.0,4.545454545454546,331,265
22400101,4,14,0.0,0.0,249,235
22400101,4,195,-3.0,-0.9230769230769231,235,40
22400101,4,6,0.0,0.0,38,32
22400102,1,267,3.0,0.6741573033707865,720,453
22400102,1,43,-5.0,-6.976744186046512,453,410
22400102,1,72,4.0,3.333333333333333,410,338
22400102,1,75,2.0,1.6,326,251
22400102,1,112,-2.0,-1.0714285714285714,240,128
22400102,1,121,-2.0,-0.9917355371900827,128,7
22400102,2,47,2.0,2.5531914893617023,720,673
22400102,2,67,0.0,0.0,616,549
22400102,2,64,0.0,0.0,547,483
22400102,2,7,0.0,0.0,480,473
22400102,2,76,3.0,2.3684210526315788,460,384
22400102,2,73,5.0,4.10958904109589,370,297
22400102,2,281,5.0,1.0676156583629894,284,3
22400102,2,3,0.0,0.0,3,0
22400102,3,272,-8.0,-1.7647058823529411,720,448
22400102,3,69,-2.0,-1.7391304347826086,448,379
22400102,3,75,-5.0,-4.0,379,304
22400102,3,28,3.0,6.428571428571428,284,256
22400102,3,18,0.0,0.0,256,238
22400102,3,141,-1.0,-0.425531914893617,238,97
22400102,3,86,-2.0,-1.3953488372093024,97,11
22400102,3,11,0.0,0.0,11,0
22400102,4,72,-1.0,-0.8333333333333333,720,648
22400102,4,88,-2.0,-1.3636363636363638,648,560
22400102,4,86,-1.0,-0.6976744186046512,557,471
22400102,4,53,2.0,2.2641509433962264,469,416
22400102,4,142,4.0,1.6901408450704225,416,274
22400102,4,96,2.0,1.25,257,161
22400102,4,34,2.0,3.5294117647058822,161,127
22400102,4,117,2.0,1.0256410256410258,127,10
22400102,4,1,0.0,0.0,10,9
22400102,4,7,0.0,0.0,7,0
22400103,1,286,12.0,2.5174825174825175,720,434
22400103,1,9,0.0,0.0,425,416
22400103,1,46,-2.0,-2.608695652173913,408,362
22400103,1,128,-1.0,-0.46875,355,227
22400103,1,81,-3.0,-2.2222222222222223,214,133
22400103,1,105,0.0,0.0,121,16
22400103,1,6,0.0,0.0,6,0
22400103,2,204,6.0,1.7647058823529411,720,516
22400103,2,44,1.0,1.3636363636363638,516,472
22400103,2,13,0.0,0.0,460,447
22400103,2,88,3.0,2.0454545454545454,437,349
22400103,2,17,1.0,3.5294117647058822,341,324
22400103,2,145,-4.0,-1.6551724137931034,324,179
22400103,2,29,0.0,0.0,179,150
22400103,2,150,0.0,0.0,150,0
22400103,3,293,-3.0,-0.6143344709897611,720,427
22400103,3,65,5.0,4.615384615384616,427,362
22400103,3,141,-5.0,-2.127659574468085,346,205
22400103,3,3,0.0,0.0,181,178
22400103,3,34,0.0,0.0,167,133
22400103,3,72,1.0,0.8333333333333333,127,55
22400103,3,44,-3.0,-4.090909090909091,44,0
22400103,4,91,0.0,0.0,720,629
22400103,4,135,-2.0,-0.888888888888889,617,482
22400103,4,31,1.0,1.935483870967742,463,432
22400103,4,46,-2.0,-2.608695652173913,432,386
22400103,4,31,2.0,3.870967741935484,386,355
22400103,4,206,-5.0,-1.4563106796116505,336,130
22400103,4,79,1.0,0.7594936708860759,129,50
22400103,4,25,4.0,9.6,41,16
22400103,4,8,-1.0,-7.5,8,0
22400104,1,371,1.0,0.16172506738544476,720,349
22400104,1,75,-2.0,-1.6,330,255
22400104,1,65,5.0,4.615384615384616,235,170
22400104,1,113,0.0,0.0,154,41
22400104,1,30,0.0,0.0,30,0
22400104,2,275,-2.0,-0.43636363636363634,720,445
22400104,2,50,0.0,0.0,432,382
22400104,2,29,-1.0,-2.0689655172413794,376,347
22400104,2,123,0.0,0.0,347,224
22400104,2,99,-1.0,-0.6060606060606061,224,125
22400104,2,111,0.0,0.0,111,0
22400104,3,322,2.0,0.37267080745341613,720,398
22400104,3,62,0.0,0.0,390,328
22400104,3,67,7.0,6.26865671641791,311,244
22400104,3,61,0.0,0.0,229,168
22400104,3,15,-3.0,-12.0,163,148
22400104,3,63,6.0,5.7142857142857135,127,64
22400104,3,28,2.0,4.285714285714286,52,24
22400104,3,6,3.0,30.0,6,0
22400104,4,46,2.0,2.608695652173913,720,674
22400104,4,32,2.0,3.75,655,623
22400104,4,55,-3.0,-3.2727272727272725,623,568
22400104,4,84,-1.0,-0.7142857142857142,556,472
22400104,4,40,1.0,1.5,461,421
22400104,4,58,3.0,3.103448275862069,421,363
22400104,4,51,-3.0,-3.5294117647058822,345,294
22400104,4,130,5.0,2.307692307692308,294,164
22400104,4,52,1.0,1.153846153846154,161,109
22400104,4,13,0.0,0.0,109,96
22400104,4,89,-5.0,-3.3707865168539324,89,0
22400105,1,307,3.0,0.5863192182410423,720,413
22400105,1,138,-4.0,-1.7391304347826086,404,266
22400105,1,10,2.0,12.0,261,251
22400105,1,58,-2.0,-2.0689655172413794,243,185
22400105,1,166,1.0,0.3614457831325301,166,0
22400105,2,227,1.0,0.2643171806167401,720,493
22400105,2,52,3.0,3.4615384615384617,493,441
22400105,2,61,0.0,0.0,441,380
22400105,2,63,0.0,0.0,380,317
22400105,2,139,6.0,2.589928057553957,317,178
22400105,2,178,3.0,1.0112359550561798,178,0
22400105,3,356,-12.0,-2.0224719101123596,720,364
22400105,3,26,0.0,0.0,364,338
22400105,3,26,0.0,0.0,327,301
22400105,3,117,-3.0,-1.5384615384615383,292,175
22400105,3,40,0.0,0.0,176,136
22400105,3,90,-2.0,-1.3333333333333335,124,34
22400105,3,16,0.0,0.0,16,0
22400105,4,77,9.0,7.012987012987013,720,643
22400105,4,74,3.0,2.4324324324324325,630,556
22400105,4,82,-2.0,-1.4634146341463414,556,474
22400105,4,182,1.0,0.3296703296703297,454,272
22400105,4,259,-1.0,-0.23166023166023167,259,0
22400106,1,263,-1.0,-0.22813688212927757,720,457
22400106,1,143,1.0,0.4195804195804196,418,275
22400106,1,23,-1.0,-2.608695652173913,222,199
22400106,1,113,0.0,0.0,127,14
22400106,2,110,0.0,0.0,720,610
22400106,2,6,-1.0,-10.0,597,591
22400106,2,48,2.0,2.5,591,543
22400106,2,66,0.0,0.0,529,463
22400106,2,18,0.0,0.0,449,431
22400106,2,62,2.0,1.935483870967742,422,360
22400106,2,151,5.0,1.9867549668874174,360,209
22400106,2,11,0.0,0.0,197,186
22400106,2,50,-3.0,-3.5999999999999996,186,136
22400106,2,103,0.0,0.0,126,23
22400106,2,9,2.0,13.333333333333332,9,0
22400106,3,308,3.0,0.5844155844155844,720,412
22400106,3,105,2.0,1.142857142857143,400,295
22400106,3,53,1.0,1.1320754716981132,291,238
22400106,3,38,-1.0,-1.5789473684210527,232,194
22400106,3,106,-1.0,-0.5660377358490566,108,2
22400106,3,2,0.0,0.0,2,0
22400106,4,59,-2.0,-2.0338983050847457,720,661
22400106,4,75,-6.0,-4.8,649,574
22400106,4,63,2.0,1.9047619047619047,574,511
22400106,4,139,1.0,0.43165467625899284,511,372
22400106,4,37,-3.0,-4.864864864864865,372,335
22400106,4,67,-1.0,-0.8955223880597015,311,244
22400106,4,22,2.0,5.454545454545455,231,209
22400106,4,92,2.0,1.3043478260869565,195,103
22400106,4,16,-1.0,-3.75,101,85
22400106,4,45,0.0,0.0,85,40
22400106,4,30,3.0,6.0,34,4
22400106,4,4,-1.0,-15.0,4,0
22400107,1,294,-3.0,-0.6122448979591836,720,426
22400107,1,61,2.0,1.9672131147540985,419,358
22400107,1,16,0.0,0.0,347,331
22400107,1,21,0.0,0.0,312,291
22400107,1,72,-2.0,-1.6666666666666665,285,213
22400107,1,36,0.0,0.0,207,171
22400107,1,55,1.0,1.0909090909090908,167,112
22400107,1,101,4.0,2.376237623762376,112,11
22400107,1,1,0.0,0.0,1,0
22400107,2,144,3.0,1.25,720,576
22400107,2,9,2.0,13.333333333333332,567,558
22400107,2,76,-1.0,-0.7894736842105263,540,464
22400107,2,52,0.0,0.0,452,400
22400107,2,34,3.0,5.294117647058824,389,355
22400107,2,61,-1.0,-0.9836065573770493,355,294
22400107,2,62,0.0,0.0,282,220
22400107,2,207,2.0,0.5797101449275363,207,0
22400107,3,283,5.0,1.0600706713780919,720,437
22400107,3,54,-3.0,-3.333333333333333,434,380
22400107,3,1,-2.0,-120.0,369,368
22400107,3,64,-2.0,-1.875,348,284
22400107,3,36,4.0,6.666666666666666,284,248
22400107,3,31,1.0,1.935483870967742,225,194
22400107,3,125,-1.0,-0.48,194,69
22400107,3,63,-2.0,-1.9047619047619047,69,6
22400107,4,148,-3.0,-1.2162162162162162,720,572
22400107,4,28,2.0,4.285714285714286,563,535
22400107,4,34,-1.0,-1.7647058823529411,521,487
22400107,4,35,2.0,3.4285714285714284,487,452
22400107,4,66,1.0,0.9090909090909092,441,375
22400107,4,123,1.0,0.48780487804878053,372,249
22400107,4,188,-5.0,-1.5957446808510638,238,50
22400107,4,10,-2.0,-12.0,34,24
22400107,5,120,0.0,0.0,300,180
22400108,1,303,7.0,1.386138613861386,720,417
22400108,1,14,0.0,0.0,406,392
22400108,1,34,2.0,3.5294117647058822,378,344
22400108,1,58,-1.0,-1.0344827586206897,325,267
22400108,1,30,3.0,6.0,255,225
22400108,1,69,3.0,2.608695652173913,217,148
22400108,1,124,-1.0,-0.4838709677419355,141,17
22400108,1,11,1.0,5.454545454545455,13,2
22400108,1,2,0.0,0.0,2,0
22400108,2,77,2.0,1.5584415584415585,720,643
22400108,2,69,4.0,3.4782608695652173,643,574
22400108,2,17,0.0,0.0,559,542
22400108,2,75,4.0,3.2,538,463
22400108,2,72,0.0,0.0,446,374
22400108,2,5,0.0,0.0,374,369
22400108,2,9,0.0,0.0,359,350
22400108,2,65,-3.0,-2.769230769230769,336,271
22400108,2,66,-5.0,-4.545454545454546,265,199
22400108,2,188,2.0,0.6382978723404256,188,0
22400108,3,177,-2.0,-0.6779661016949152,720,543
22400108,3,58,-3.0,-3.103448275862069,533,475
22400108,3,120,2.0,1.0,475,355
22400108,3,7,1.0,8.571428571428571,282,275
22400108,3,110,-2.0,-1.0909090909090908,275,165
22400108,3,70,-5.0,-4.285714285714286,165,95
22400108,3,43,0.0,0.0,67,24
22400108,3,24,3.0,7.5,24,0
22400108,4,94,0.0,0.0,720,626
22400108,4,18,2.0,6.666666666666666,615,597
22400108,4,50,-3.0,-3.5999999999999996,587,537
22400108,4,28,2.0,4.285714285714286,532,504
22400108,4,38,-4.0,-6.315789473684211,493,455
22400108,4,226,-6.0,-1.592920353982301,449,223
22400108,4,186,2.0,0.6451612903225807,204,18
22400108,4,10,1.0,6.0,18,8
22400108,4,2,0.0,0.0,2,0
22400109,1,292,-6.0,-1.2328767123287672,720,428
22400109,1,19,-1.0,-3.1578947368421053,428,409
22400109,1,69,3.0,2.608695652173913,409,340
22400109,1,67,2.0,1.791044776119403,340,273
22400109,1,73,-3.0,-2.4657534246575343,262,189
22400109,1,10,0.0,0.0,189,179
22400109,1,146,-3.0,-1.2328767123287672,155,9
22400109,2,148,1.0,0.40540540540540543,720,572
22400109,2,153,-1.0,-0.39215686274509803,700,547
22400109,2,92,-2.0,-1.3043478260869565,531,439
22400109,2,21,0.0,0.0,426,405
22400109,2,23,2.0,5.217391304347826,347,324
22400109,2,79,-1.0,-0.7594936708860759,314,235
22400109,2,25,-1.0,-2.4,235,210
22400109,2,81,1.0,0.7407407407407407,210,129
22400109,2,103,-3.0,-1.7475728155339807,109,6
22400109,3,343,4.0,0.6997084548104956,720,377
22400109,3,53,-4.0,-4.528301886792453,377,324
22400109,3,100,-4.0,-2.4,311,211
22400109,3,34,1.0,1.7647058823529411,211,177
22400109,3,105,1.0,0.5714285714285715,177,72
22400109,3,72,4.0,3.333333333333333,72,0
22400109,4,135,4.0,1.777777777777778,720,585
22400109,4,30,2.0,4.0,569,539
22400109,4,93,-1.0,-0.6451612903225807,528,435
22400109,4,44,0.0,0.0,426,382
22400109,4,145,0.0,0.0,373,228
22400109,4,108,0.0,0.0,212,104
22400109,4,104,1.0,0.576923076923077,104,0
22400110,1,140,5.0,2.142857142857143,720,580
22400110,1,202,0.0,0.0,580,378
22400110,1,180,1.0,0.33333333333333337,378,198
22400110,1,57,2.0,2.1052631578947367,184,127
22400110,1,124,1.0,0.4838709677419355,124,0
22400110,2,140,0.0,0.0,720,580
22400110,2,38,2.0,3.1578947368421053,576,538
22400110,2,62,-2.0,-1.935483870967742,530,468
22400110,2,48,-2.0,-2.5,458,410
22400110,2,76,4.0,3.1578947368421053,398,322
22400110,2,36,0.0,0.0,319,283
22400110,2,94,0.0,0.0,275,181
22400110,2,135,-2.0,-0.888888888888889,181,46
22400110,2,46,2.0,2.608695652173913,46,0
22400110,3,344,0.0,0.0,720,376
22400110,3,17,0.0,0.0,376,359
22400110,3,80,-2.0,-1.5,351,271
22400110,3,42,-2.0,-2.8571428571428568,271,229
22400110,3,80,5.0,3.75,212,132
22400110,3,78,2.0,1.5384615384615383,113,35
22400110,3,35,3.0,5.142857142857143,35,0
22400110,4,212,-2.0,-0.5660377358490566,720,508
22400110,4,87,0.0,0.0,508,421
22400110,4,17,0.0,0.0,407,390
22400110,4,23,0.0,0.0,376,353
22400110,4,55,0.0,0.0,346,291
22400110,4,152,-3.0,-1.1842105263157894,275,123
22400110,4,57,4.0,4.2105263157894735,123,66
22400110,4,62,-3.0,-2.903225806451613,62,0
22400111,1,306,-11.0,-2.156862745098039,720,414
22400111,1,98,-9.0,-5.510204081632653,414,316
22400111,1,47,0.0,0.0,309,262
22400111,1,104,3.0,1.7307692307692308,262,158
22400111,1,32,0.0,0.0,134,102
22400111,1,91,5.0,3.2967032967032965,91,0
22400111,2,104,2.0,1.153846153846154,720,616
22400111,2,164,3.0,1.097560975609756,616,452
22400111,2,35,-3.0,-5.142857142857143,448,413
22400111,2,38,0.0,0.0,399,361
22400111,2,7,0.0,0.0,357,350
22400111,2,72,0.0,0.0,336,264
22400111,2,40,3.0,4.5,246,206
22400111,2,28,0.0,0.0,206,178
22400111,2,169,5.0,1.7751479289940828,169,0
22400111,3,310,-1.0,-0.1935483870967742,720,410
22400111,3,17,-2.0,-7.0588235294117645,403,386
22400111,3,101,-5.0,-2.9702970297029703,386,285
22400111,3,46,-1.0,-1.3043478260869565,271,225
22400111,3,109,1.0,0.5504587155963303,225,116
22400111,3,69,0.0,0.0,116,47
22400111,3,29,0.0,0.0,39,10
22400111,3,8,2.0,15.0,8,0
22400111,4,146,8.0,3.287671232876712,720,574
22400111,4,72,2.0,1.6666666666666665,574,502
22400111,4,55,-3.0,-3.2727272727272725,491,436
22400111,4,41,-2.0,-2.926829268292683,436,395
22400111,4,86,1.0,0.6976744186046512,395,309
22400111,4,52,2.0,2.307692307692308,309,257
22400111,4,217,4.0,1.1059907834101383,257,40
22400111,4,13,0.0,0.0,37,24
22400111,4,3,0.0,0.0,10,7
22400111,4,6,1.0,10.0,6,0
22400112,1,338,7.0,1.2426035502958581,720,382
22400112,1,36,-1.0,-1.6666666666666665,382,346
22400112,1,55,-1.0,-1.0909090909090908,338,283
22400112,1,86,1.0,0.6976744186046512,283,197
22400112,1,29,-2.0,-4.137931034482759,193,164
22400112,1,180,1.0,0.33333333333333337,267,87
22400112,1,23,0.0,0.0,87,64
22400112,1,61,-4.0,-3.934426229508197,61,0
22400112,2,120,1.0,0.5,720,600
22400112,2,10,0.0,0.0,600,590
22400112,2,23,-1.0,-2.608695652173913,573,550
22400112,2,69,0.0,0.0,550,481
22400112,2,61,2.0,1.9672131147540985,467,406
22400112,2,41,-1.0,-1.4634146341463414,383,342
22400112,2,59,0.0,0.0,342,283
22400112,2,50,-3.0,-3.5999999999999996,269,219
22400112,2,62,3.0,2.903225806451613,219,157
22400112,2,57,-2.0,-2.1052631578947367,157,100
22400112,2,92,4.0,2.608695652173913,92,0
22400112,3,233,-2.0,-0.5150214592274678,720,487
22400112,3,82,-2.0,-1.4634146341463414,487,405
22400112,3,112,7.0,3.75,392,280
22400112,3,88,-1.0,-0.6818181818181819,267,179
22400112,3,13,0.0,0.0,171,158
22400112,3,44,1.0,1.3636363636363638,150,106
22400112,3,57,2.0,2.1052631578947367,96,39
22400112,3,31,1.0,1.935483870967742,39,8
22400112,4,55,0.0,0.0,720,665
22400112,4,50,5.0,6.0,650,600
22400112,4,73,3.0,2.4657534246575343,578,505
22400112,4,33,-3.0,-5.454545454545455,496,463
22400112,4,53,-4.0,-4.528301886792453,463,410
22400112,4,180,-1.0,-0.33333333333333337,393,213
22400112,4,28,-2.0,-4.285714285714286,197,169
22400112,4,53,0.0,0.0,169,116
22400112,4,105,-5.0,-2.8571428571428568,105,0
22400113,1,203,-4.0,-1.1822660098522169,720,517
22400113,1,145,3.0,1.2413793103448276,517,372
22400113,1,54,4.0,4.444444444444445,307,253
22400113,1,97,4.0,2.4742268041237114,253,156
22400113,1,106,5.0,2.8301886792452833,145,39
22400113,1,39,2.0,3.0769230769230766,39,0
22400113,2,177,2.0,0.6779661016949152,720,543
22400113,2,22,-2.0,-5.454545454545455,540,518
22400113,2,20,1.0,3.0,508,488
22400113,2,38,-2.0,-3.1578947368421053,488,450
22400113,2,91,-2.0,-1.3186813186813189,434,343
22400113,2,32,0.0,0.0,332,300
22400113,2,33,0.0,0.0,300,267
22400113,2,229,-3.0,-0.7860262008733624,234,5
22400113,2,5,0.0,0.0,5,0
22400113,3,296,-5.0,-1.0135135135135136,720,424
22400113,3,131,0.0,0.0,414,283
22400113,3,25,0.0,0.0,283,258
22400113,3,35,0.0,0.0,257,222
22400113,3,36,-2.0,-3.333333333333333,222,186
22400113,3,74,2.0,1.6216216216216217,170,96
22400113,3,76,4.0,3.1578947368421053,96,20
22400113,3,4,0.0,0.0,4,0
22400113,4,194,-6.0,-1.8556701030927836,720,526
22400113,4,62,0.0,0.0,517,455
22400113,4,53,0.0,0.0,440,387
22400113,4,22,2.0,5.454545454545455,369,347
22400113,4,48,-2.0,-2.5,347,299
22400113,4,39,-2.0,-3.0769230769230766,299,260
22400113,4,252,1.0,0.23809523809523808,260,8
22400113,5,278,-6.0,-1.2949640287769786,300,22
22400113,5,22,0.0,0.0,22,0
22400114,1,307,0.0,0.0,720,413
22400114,1,51,0.0,0.0,413,362
22400114,1,27,0.0,0.0,359,332
22400114,1,84,2.0,1.4285714285714284,332,248
22400114,1,142,3.0,1.267605633802817,239,97
22400114,1,84,4.0,2.8571428571428568,84,0
22400114,2,36,-2.0,-3.333333333333333,720,684
22400114,2,83,1.0,0.7228915662650602,671,588
22400114,2,114,-2.0,-1.0526315789473684,569,455
22400114,2,25,0.0,0.0,441,416
22400114,2,13,-2.0,-9.230769230769232,412,399
22400114,2,188,-6.0,-1.9148936170212765,399,211
22400114,2,134,3.0,1.3432835820895521,204,70
22400114,2,55,0.0,0.0,58,3
22400114,2,1,0.0,0.0,1,0
22400114,3,311,1.0,0.19292604501607716,720,409
22400114,3,5,-1.0,-12.0,409,404
22400114,3,71,2.0,1.6901408450704225,404,333
22400114,3,65,0.0,0.0,326,261
22400114,3,29,0.0,0.0,258,229
22400114,3,48,-1.0,-1.25,220,172
22400114,3,42,2.0,2.8571428571428568,153,111
22400114,3,111,-4.0,-2.1621621621621623,111,0
22400114,4,161,1.0,0.37267080745341613,720,559
22400114,4,68,-1.0,-0.8823529411764706,536,468
22400114,4,84,3.0,2.142857142857143,468,384
22400114,4,162,3.0,1.1111111111111112,384,222
22400114,4,158,-4.0,-1.5189873417721518,222,64
22400114,4,21,0.0,0.0,59,38
22400114,4,19,3.0,9.473684210526315,38,19
22400114,4,19,-2.0,-6.315789473684211,19,0
22400115,1,430,-2.0,-0.27906976744186046,720,290
22400115,1,50,-2.0,-2.4,275,225
22400115,1,28,-3.0,-6.428571428571428,211,183
22400115,1,121,1.0,0.49586776859504134,170,49
22400115,2,68,3.0,2.647058823529412,720,652
22400115,2,118,0.0,0.0,638,520
22400115,2,37,-2.0,-3.2432432432432434,520,483
22400115,2,88,1.0,0.6818181818181819,483,395
22400115,2,68,0.0,0.0,384,316
22400115,2,97,-3.0,-1.8556701030927836,298,201
22400115,2,2,0.0,0.0,189,187
22400115,2,169,-4.0,-1.4201183431952662,173,4
22400115,3,281,-4.0,-0.8540925266903914,720,439
22400115,3,53,-2.0,-2.2641509433962264,432,379
22400115,3,12,0.0,0.0,372,360
22400115,3,45,2.0,2.666666666666667,360,315
22400115,3,76,-2.0,-1.5789473684210527,312,236
22400115,3,61,-1.0,-0.9836065573770493,232,171
22400115,3,30,-2.0,-4.0,171,141
22400115,3,141,-6.0,-2.5531914893617023,141,0
22400115,4,134,3.0,1.3432835820895521,720,586
22400115,4,119,-1.0,-0.5042016806722689,572,453
22400115,4,137,-2.0,-0.875912408759124,453,316
22400115,4,46,-2.0,-2.608695652173913,316,270
22400115,4,54,6.0,6.666666666666666,270,216
22400115,4,81,-1.0,-0.7407407407407407,204,123
22400115,4,115,4.0,2.0869565217391304,115,0
22400116,1,290,-7.0,-1.4482758620689655,720,430
22400116,1,12,-2.0,-10.0,425,413
22400116,1,45,0.0,0.0,413,368
22400116,1,178,-3.0,-1.0112359550561798,357,179
22400116,1,101,-1.0,-0.594059405940594,172,71
22400116,1,40,-2.0,-3.0,47,7
22400116,2,187,5.0,1.6042780748663101,720,533
22400116,2,66,0.0,0.0,485,419
22400116,2,97,3.0,1.8556701030927836,400,303
22400116,2,58,1.0,1.0344827586206897,297,239
22400116,2,167,1.0,0.3592814371257485,228,61
22400116,2,54,1.0,1.1111111111111112,54,0
22400116,3,133,0.0,0.0,720,587
22400116,3,165,3.0,1.0909090909090908,587,422
22400116,3,36,5.0,8.333333333333334,422,386
22400116,3,68,0.0,0.0,370,302
22400116,3,82,2.0,1.4634146341463414,302,220
22400116,3,53,-2.0,-2.2641509433962264,209,156
22400116,3,156,1.0,0.3846153846153846,156,0
22400116,4,230,5.0,1.3043478260869565,720,490
22400116,4,46,-2.0,-2.608695652173913,475,429
22400116,4,94,-1.0,-0.6382978723404256,420,326
22400116,4,74,1.0,0.8108108108108109,326,252
22400116,4,47,3.0,3.829787234042553,246,199
22400116,4,25,5.0,12.0,188,163
22400117,1,284,0.0,0.0,720,436
22400117,1,39,2.0,3.0769230769230766,422,383
22400117,1,76,-2.0,-1.5789473684210527,378,302
22400117,1,70,0.0,0.0,290,220
22400117,1,11,0.0,0.0,220,209
22400117,1,52,6.0,6.923076923076923,205,153
22400117,1,67,4.0,3.582089552238806,135,68
22400117,1,32,0.0,0.0,61,29
22400117,1,13,1.0,4.615384615384616,13,0
22400117,2,162,3.0,1.1111111111111112,720,558
22400117,2,56,5.0,5.357142857142858,558,502
22400117,2,115,-1.0,-0.5217391304347826,502,387
22400117,2,59,-5.0,-5.084745762711864,372,313
22400117,2,66,-2.0,-1.8181818181818183,297,231
22400117,2,170,-3.0,-1.0588235294117647,221,51
22400117,2,32,-2.0,-3.75,51,19
22400117,2,13,0.0,0.0,13,0
22400117,3,315,-4.0,-0.7619047619047619,720,405
22400117,3,73,-3.0,-2.4657534246575343,405,332
22400117,3,86,2.0,1.3953488372093024,332,246
22400117,3,97,-2.0,-1.2371134020618557,246,149
22400117,3,87,2.0,1.3793103448275863,149,62
22400117,3,30,3.0,6.0,62,32
22400117,4,79,4.0,3.0379746835443036,720,641
22400117,4,88,-1.0,-0.6818181818181819,641,553
22400117,4,48,-2.0,-2.5,552,504
22400117,4,77,0.0,0.0,504,427
22400117,4,78,-1.0,-0.7692307692307692,410,332
22400117,4,54,0.0,0.0,332,278
22400117,4,84,4.0,2.8571428571428568,260,176
22400117,4,30,1.0,2.0,176,146
22400117,4,53,-3.0,-3.3962264150943398,131,78
22400117,4,77,-2.0,-1.5584415584415585,78,1
22400117,4,1,1.0,60.0,1,0
22400118,1,148,1.0,0.40540540540540543,720,572
22400118,1,148,6.0,2.4324324324324325,563,415
22400118,1,214,6.0,1.6822429906542056,395,181
22400118,1,66,4.0,3.6363636363636367,170,104
22400118,1,94,5.0,3.1914893617021276,94,0
22400118,2,22,0.0,0.0,720,698
22400118,2,135,6.0,2.666666666666667,683,548
22400118,2,20,-2.0,-6.0,540,520
22400118,2,43,-2.0,-2.7906976744186047,520,477
22400118,2,109,1.0,0.5504587155963303,473,364
22400118,2,123,1.0,0.48780487804878053,364,241
22400118,2,130,-3.0,-1.3846153846153846,218,88
22400118,2,88,2.0,1.3636363636363638,88,0
22400118,3,96,1.0,0.625,720,624
22400118,3,179,-3.0,-1.005586592178771,624,445
22400118,3,31,0.0,0.0,432,401
22400118,3,95,-1.0,-0.631578947368421,385,290
22400118,3,96,5.0,3.125,290,194
22400118,3,37,2.0,3.2432432432432434,180,143
22400118,3,16,0.0,0.0,143,127
22400118,3,15,-1.0,-4.0,127,112
22400118,3,112,3.0,1.607142857142857,112,0
22400118,4,67,4.0,3.582089552238806,720,653
22400118,4,100,1.0,0.6,653,553
22400118,4,14,-2.0,-8.571428571428571,534,520
22400118,4,19,-1.0,-3.1578947368421053,510,491
22400118,4,65,-4.0,-3.6923076923076925,491,426
22400118,4,110,3.0,1.6363636363636362,426,316
22400118,4,316,2.0,0.37974683544303794,316,0
22400119,1,303,1.0,0.19801980198019803,720,417
22400119,1,46,3.0,3.9130434782608696,410,364
22400119,1,24,-1.0,-2.5,362,338
22400119,1,151,3.0,1.1920529801324504,338,187
22400119,1,50,0.0,0.0,174,124
22400119,1,115,-1.0,-0.5217391304347826,115,0
22400119,2,223,-2.0,-0.5381165919282511,720,497
22400119,2,78,-1.0,-0.7692307692307692,486,408
22400119,2,48,5.0,6.25,407,359
22400119,2,58,1.0,1.0344827586206897,355,297
22400119,2,49,3.0,3.673469387755102,297,248
22400119,2,238,-1.0,-0.25210084033613445,238,0
22400119,3,251,6.0,1.4342629482071714,720,469
22400119,3,55,3.0,3.2727272727272725,460,405
22400119,3,2,0.0,0.0,393,391
22400119,3,17,0.0,0.0,372,355
22400119,3,113,0.0,0.0,341,228
22400119,3,96,-2.0,-1.25,228,132
22400119,3,28,-2.0,-4.285714285714286,123,95
22400119,3,59,0.0,0.0,83,24
22400119,3,5,0.0,0.0,13,8
22400119,4,186,7.0,2.2580645161290325,720,534
22400119,4,27,-3.0,-6.666666666666666,520,493
22400119,4,161,-2.0,-0.7453416149068323,478,317
22400119,4,95,0.0,0.0,317,222
22400119,4,112,-1.0,-0.5357142857142857,214,102
22400119,4,6,0.0,0.0,94,88
22400119,4,88,-3.0,-2.0454545454545454,88,0
22400119,5,264,-5.0,-1.1363636363636365,300,36
22400119,5,5,0.0,0.0,32,27
22400119,5,19,5.0,15.789473684210526,25,6
22400119,5,2,0.0,0.0,5,3
22400120,1,345,8.0,1.391304347826087,720,375
22400120,1,115,-1.0,-0.5217391304347826,360,245
22400120,1,40,-4.0,-6.0,232,192
22400120,1,163,1.0,0.36809815950920244,192,29
22400120,1,29,0.0,0.0,29,0
22400120,2,154,-6.0,-2.3376623376623376,720,566
22400120,2,138,-6.0,-2.608695652173913,547,409
22400120,2,50,4.0,4.8,409,359
22400120,2,52,1.0,1.153846153846154,345,293
22400120,2,121,-5.0,-2.479338842975207,293,172
22400120,2,145,-2.0,-0.8275862068965517,172,27
22400120,2,8,0.0,0.0,9,1
22400120,2,1,0.0,0.0,1,0
22400120,3,36,0.0,0.0,720,684
22400120,3,236,-3.0,-0.7627118644067797,668,432
22400120,3,167,-3.0,-1.0778443113772456,424,257
22400120,3,141,1.0,0.425531914893617,257,116
22400120,3,17,0.0,0.0,97,80
22400120,3,52,0.0,0.0,80,28
22400120,3,10,-2.0,-12.0,10,0
22400120,4,105,2.0,1.142857142857143,720,615
22400120,4,61,4.0,3.934426229508197,597,536
22400120,4,125,-3.0,-1.44,515,390
22400120,4,122,-3.0,-1.4754098360655736,365,243
22400120,4,27,2.0,4.444444444444445,237,210
22400120,4,13,0.0,0.0,210,197
22400120,4,75,0.0,0.0,188,113
22400120,4,2,0.0,0.0,113,111
22400120,4,95,6.0,3.7894736842105265,95,0
22400121,1,292,3.0,0.6164383561643836,720,428
22400121,1,51,3.0,3.5294117647058822,428,377
22400121,1,19,3.0,9.473684210526315,370,351
22400121,1,87,-7.0,-4.827586206896552,340,253
22400121,1,51,-3.0,-3.5294117647058822,253,202
22400121,1,1,0.0,0.0,178,177
22400121,1,165,-3.0,-1.0909090909090908,165,0
22400121,2,281,-5.0,-1.0676156583629894,720,439
22400121,2,28,-4.0,-8.571428571428571,417,389
22400121,2,165,0.0,0.0,376,211
22400121,2,98,1.0,0.6122448979591836,202,104
22400121,2,61,-1.0,-0.9836065573770493,91,30
22400121,2,10,0.0,0.0,12,2
22400121,3,324,1.0,0.18518518518518517,720,396
22400121,3,29,-2.0,-4.137931034482759,385,356
22400121,3,80,1.0,0.75,348,268
22400121,3,52,3.0,3.4615384615384617,262,210
22400121,3,198,3.0,0.9090909090909092,198,0
22400121,4,80,6.0,4.5,720,640
22400121,4,82,3.0,2.195121951219512,629,547
22400121,4,42,-2.0,-2.8571428571428568,532,490
22400121,4,90,-1.0,-0.6666666666666667,479,389
22400121,4,28,-3.0,-6.428571428571428,389,361
22400121,4,98,4.0,2.4489795918367343,356,258
22400121,4,65,0.0,0.0,258,193
22400121,4,143,-2.0,-0.8391608391608392,190,47
22400121,4,47,0.0,0.0,47,0
22400122,1,383,-2.0,-0.3133159268929504,720,337
22400122,1,54,2.0,2.2222222222222223,311,257
22400122,1,48,3.0,3.75,257,209
22400122,1,3,0.0,0.0,195,192
22400122,1,104,5.0,2.8846153846153846,191,87
22400122,1,76,2.0,1.5789473684210527,76,0
22400122,2,129,-4.0,-1.8604651162790697,720,591
22400122,2,71,0.0,0.0,591,520
22400122,2,129,2.0,0.9302325581395349,513,384
22400122,2,32,0.0,0.0,372,340
22400122,2,66,0.0,0.0,335,269
22400122,2,370,0.0,0.0,569,199
22400122,2,180,4.0,1.3333333333333335,189,9
22400122,3,325,-1.0,-0.18461538461538463,720,395
22400122,3,121,-2.0,-0.9917355371900827,388,267
22400122,3,12,-1.0,-5.0,264,252
22400122,3,58,-3.0,-3.103448275862069,252,194
22400122,3,10,0.0,0.0,172,162
22400122,3,140,-2.0,-0.8571428571428571,140,0
22400122,4,144,1.0,0.41666666666666663,720,576
22400122,4,93,4.0,2.580645161290323,555,462
22400122,4,113,-1.0,-0.5309734513274336,462,349
22400122,4,211,-5.0,-1.4218009478672984,340,129
22400123,1,404,-8.0,-1.188118811881188,720,316
22400123,1,119,-5.0,-2.521008403361345,312,193
22400123,1,137,-1.0,-0.437956204379562,172,35
22400123,2,65,-1.0,-0.9230769230769231,720,655
22400123,2,114,-1.0,-0.5263157894736842,655,541
22400123,2,98,1.0,0.6122448979591836,541,443
22400123,2,18,-2.0,-6.666666666666666,427,409
22400123,2,42,3.0,4.285714285714286,409,367
22400123,2,82,4.0,2.926829268292683,367,285
22400123,2,66,1.0,0.9090909090909092,285,219
22400123,2,189,0.0,0.0,205,16
22400123,2,7,0.0,0.0,7,0
22400123,3,365,11.0,1.808219178082192,720,355
22400123,3,19,3.0,9.473684210526315,338,319
22400123,3,36,2.0,3.333333333333333,306,270
22400123,3,4,0.0,0.0,258,254
22400123,3,15,-1.0,-4.0,199,184
22400123,3,21,0.0,0.0,184,163
22400123,3,52,-3.0,-3.4615384615384617,147,95
22400123,3,48,0.0,0.0,95,47
22400123,3,43,0.0,0.0,43,0
22400123,4,85,0.0,0.0,720,635
22400123,4,75,0.0,0.0,617,542
22400123,4,54,0.0,0.0,523,469
22400123,4,40,0.0,0.0,469,429
22400123,4,47,0.0,0.0,429,382
22400123,4,148,1.0,0.40540540540540543,363,215
22400123,4,26,0.0,0.0,215,189
22400123,4,47,0.0,0.0,180,133
22400123,4,108,2.0,1.1111111111111112,133,25
22400123,4,1,0.0,0.0,20,19
22400124,1,69,0.0,0.0,720,651
22400124,1,192,2.0,0.625,641,449
22400124,1,56,2.0,2.142857142857143,444,388
22400124,1,89,0.0,0.0,366,277
22400124,1,36,0.0,0.0,268,232
22400124,1,34,-3.0,-5.294117647058824,221,187
22400124,1,10,0.0,0.0,187,177
22400124,1,51,-3.0,-3.5294117647058822,177,126
22400124,1,47,0.0,0.0,126,79
22400124,1,13,1.0,4.615384615384616,69,56
22400124,1,45,-1.0,-1.3333333333333335,56,11
22400124,1,3,0.0,0.0,3,0
22400124,2,50,1.0,1.2,720,670
22400124,2,161,3.0,1.1180124223602486,670,509
22400124,2,32,-2.0,-3.75,507,475
22400124,2,118,2.0,1.0169491525423728,462,344
22400124,2,108,4.0,2.2222222222222223,344,236
22400124,2,57,-1.0,-1.0526315789473684,219,162
22400124,2,44,-1.0,-1.3636363636363638,146,102
22400124,2,38,1.0,1.5789473684210527,92,54
22400124,2,52,-4.0,-4.615384615384616,54,2
22400124,2,2,2.0,60.0,2,0
22400124,3,126,-8.0,-3.8095238095238093,720,594
22400124,3,60,0.0,0.0,578,518
22400124,3,97,4.0,2.4742268041237114,518,421
22400124,3,29,2.0,4.137931034482759,421,392
22400124,3,27,1.0,2.2222222222222223,369,342
22400124,3,97,5.0,3.092783505154639,342,245
22400124,3,30,0.0,0.0,232,202
22400124,3,18,0.0,0.0,192,174
22400124,3,65,-1.0,-0.9230769230769231,119,54
22400124,3,12,2.0,10.0,40,28
22400124,3,19,3.0,9.473684210526315,19,0
22400124,4,106,-5.0,-2.8301886792452833,720,614
22400124,4,32,1.0,1.875,592,560
22400124,4,101,-3.0,-1.782178217821782,555,454
22400124,4,48,0.0,0.0,440,392
22400124,4,23,-2.0,-5.217391304347826,381,358
22400124,4,20,-2.0,-6.0,343,323
22400124,4,75,-1.0,-0.8,323,248
22400124,4,97,3.0,1.8556701030927836,248,151
22400124,4,23,1.0,2.608695652173913,149,126
22400124,4,48,-5.0,-6.25,126,78
22400124,4,2,0.0,0.0,69,67
22400125,1,316,3.0,0.569620253164557,720,404
22400125,1,70,0.0,0.0,404,334
22400125,1,19,0.0,0.0,318,299
22400125,1,198,2.0,0.6060606060606061,293,95
22400125,1,80,0.0,0.0,80,0
22400125,2,77,2.0,1.5584415584415585,720,643
22400125,2,129,0.0,0.0,622,493
22400125,2,71,5.0,4.225352112676057,487,416
22400125,2,62,1.0,0.967741935483871,408,346
22400125,2,66,-2.0,-1.8181818181818183,325,259
22400125,2,85,1.0,0.7058823529411764,257,172
22400125,2,36,-6.0,-10.0,132,96
22400125,3,324,1.0,0.18518518518518517,720,396
22400125,3,38,-3.0,-4.7368421052631575,388,350
22400125,3,51,0.0,0.0,336,285
22400125,3,62,-1.0,-0.967741935483871,284,222
22400125,3,131,2.0,0.916030534351145,204,73
22400125,3,63,0.0,0.0,63,0
22400125,4,231,-2.0,-0.5194805194805194,720,489
22400125,4,65,4.0,3.6923076923076925,489,424
22400125,4,49,0.0,0.0,401,352
22400125,4,8,0.0,0.0,352,344
22400125,4,162,3.0,1.1111111111111112,328,166
22400125,4,90,-1.0,-0.6666666666666667,150,60
22400125,4,51,-3.0,-3.5294117647058822,51,0
22400126,1,316,4.0,0.7594936708860759,720,404
22400126,1,74,-2.0,-1.6216216216216217,388,314
22400126,1,64,0.0,0.0,302,238
22400126,1,44,5.0,6.818181818181818,229,185
22400126,1,7,0.0,0.0,129,122
22400126,2,199,-4.0,-1.206030150753769,720,521
22400126,2,74,0.0,0.0,508,434
22400126,2,15,-2.0,-8.0,415,400
22400126,2,16,0.0,0.0,400,384
22400126,2,5,-3.0,-36.0,360,355
22400126,2,110,-3.0,-1.6363636363636362,343,233
22400126,2,47,6.0,7.659574468085106,213,166
22400126,2,31,0.0,0.0,104,73
22400126,2,73,0.0,0.0,73,0
22400126,3,237,9.0,2.278481012658228,720,483
22400126,3,69,4.0,3.4782608695652173,471,402
22400126,3,4,0.0,0.0,396,392
22400126,3,54,-1.0,-1.1111111111111112,386,332
22400126,3,69,-2.0,-1.7391304347826086,320,251
22400126,3,109,-2.0,-1.1009174311926606,237,128
22400126,3,104,0.0,0.0,111,7
22400126,3,7,0.0,0.0,7,0
22400126,4,35,0.0,0.0,720,685
22400126,4,123,4.0,1.9512195121951221,675,552
22400126,4,61,-3.0,-2.9508196721311473,532,471
22400126,4,29,3.0,6.206896551724138,471,442
22400126,4,76,-1.0,-0.7894736842105263,428,352
22400126,4,270,-2.0,-0.4444444444444445,352,82
22400126,4,456,0.0,0.0,456,0
22400127,1,263,4.0,0.9125475285171103,720,457
22400127,1,108,-2.0,-1.1111111111111112,442,334
22400127,1,50,5.0,6.0,315,265
22400127,1,16,0.0,0.0,265,249
22400127,1,54,-3.0,-3.333333333333333,240,186
22400127,1,49,-1.0,-1.2244897959183672,172,123
22400127,1,95,0.0,0.0,123,28
22400127,2,64,4.0,3.75,720,656
22400127,2,94,2.0,1.2765957446808511,643,549
22400127,2,106,-3.0,-1.6981132075471699,544,438
22400127,2,141,-8.0,-3.404255319148936,435,294
22400127,2,135,-2.0,-0.888888888888889,282,147
22400127,2,58,-3.0,-3.103448275862069,147,89
22400127,2,85,5.0,3.5294117647058822,89,4
22400127,3,397,3.0,0.4534005037783375,720,323
22400127,3,79,7.0,5.3164556962025316,317,238
22400127,3,30,0.0,0.0,238,208
22400127,3,39,0.0,0.0,188,149
22400127,3,1,0.0,0.0,135,134
22400127,3,27,0.0,0.0,128,101
22400127,4,108,1.0,0.5555555555555556,720,612
22400127,4,115,-1.0,-0.5217391304347826,612,497
22400127,4,109,-2.0,-1.1009174311926606,478,369
22400127,4,22,3.0,8.181818181818182,359,337
22400127,4,318,-5.0,-0.9433962264150944,318,0
22400128,1,259,9.0,2.0849420849420848,720,461
22400128,1,14,0.0,0.0,453,439
22400128,1,28,1.0,2.142857142857143,435,407
22400128,1,119,7.0,3.5294117647058822,394,275
22400128,1,78,5.0,3.846153846153846,263,185
22400128,1,10,1.0,6.0,175,165
22400128,1,89,0.0,0.0,165,76
22400128,1,57,-2.0,-2.1052631578947367,76,19
22400128,1,15,-1.0,-4.0,19,4
22400128,1,4,0.0,0.0,4,0
22400128,2,111,-2.0,-1.0810810810810811,720,609
22400128,2,126,-5.0,-2.380952380952381,609,483
22400128,2,92,-2.0,-1.3043478260869565,472,380
22400128,2,71,0.0,0.0,371,300
22400128,2,26,2.0,4.615384615384616,296,270
22400128,2,83,4.0,2.891566265060241,249,166
22400128,2,78,3.0,2.307692307692308,153,75
22400128,2,23,0.0,0.0,75,52
22400128,2,11,1.0,5.454545454545455,46,35
22400128,2,35,0.0,0.0,35,0
22400128,3,272,0.0,0.0,720,448
22400128,3,99,0.0,0.0,433,334
22400128,3,29,-1.0,-2.0689655172413794,330,301
22400128,3,41,2.0,2.926829268292683,301,260
22400128,3,3,-2.0,-40.0,253,250
22400128,3,141,5.0,2.127659574468085,246,105
22400128,3,95,2.0,1.263157894736842,96,1
22400128,3,1,0.0,0.0,1,0
22400128,4,108,-2.0,-1.1111111111111112,720,612
22400128,4,43,3.0,4.186046511627907,597,554
22400128,4,54,-7.0,-7.777777777777778,539,485
22400128,4,184,-3.0,-0.9782608695652174,468,284
22400128,4,41,3.0,4.390243902439024,284,243
22400128,4,58,-3.0,-3.103448275862069,233,175
22400128,4,58,2.0,2.0689655172413794,161,103
22400128,4,103,-1.0,-0.5825242718446602,103,0
22400129,1,272,-1.0,-0.22058823529411764,720,448
22400129,1,93,0.0,0.0,448,355
22400129,1,176,-5.0,-1.7045454545454546,345,169
22400129,1,151,-3.0,-1.1920529801324504,151,0
22400129,2,136,-3.0,-1.323529411764706,720,584
22400129,2,10,0.0,0.0,584,574
22400129,2,33,0.0,0.0,574,541
22400129,2,40,0.0,0.0,524,484
22400129,2,57,0.0,0.0,469,412
22400129,2,82,2.0,1.4634146341463414,395,313
22400129,2,83,0.0,0.0,305,222
22400129,2,12,-2.0,-10.0,211,199
22400129,2,43,2.0,2.7906976744186047,199,156
22400129,2,12,1.0,5.0,156,144
22400129,2,69,3.0,2.608695652173913,144,75
22400129,2,75,0.0,0.0,75,0
22400129,3,159,-2.0,-0.7547169811320755,720,561
22400129,3,141,0.0,0.0,561,420
22400129,3,87,2.0,1.3793103448275863,420,333
22400129,3,103,-5.0,-2.912621359223301,333,230
22400129,3,35,-2.0,-3.4285714285714284,219,184
22400129,3,26,-4.0,-9.230769230769232,169,143
22400129,3,127,4.0,1.889763779527559,127,0
22400129,4,63,5.0,4.761904761904762,720,657
22400129,4,215,7.0,1.9534883720930232,638,423
22400129,4,174,5.0,1.7241379310344827,410,236
22400129,4,21,0.0,0.0,232,211
22400129,4,162,-1.0,-0.37037037037037035,195,33
22400129,4,1,0.0,0.0,18,17
22400129,4,1,2.0,120.0,12,11
22400129,4,5,-1.0,-12.0,5,0
22400130,1,415,-5.0,-0.7228915662650602,720,305
22400130,1,3,0.0,0.0,305,302
22400130,1,111,2.0,1.0810810810810811,291,180
22400130,1,163,12.0,4.41717791411043,167,4
22400130,2,145,-8.0,-3.310344827586207,720,575
22400130,2,4,0.0,0.0,560,556
22400130,2,78,3.0,2.307692307692308,542,464
22400130,2,67,0.0,0.0,464,397
22400130,2,59,1.0,1.0169491525423728,389,330
22400130,2,40,2.0,3.0,330,290
22400130,2,65,0.0,0.0,290,225
22400130,2,107,-4.0,-2.2429906542056073,225,118
22400130,3,207,-2.0,-0.5797101449275363,720,513
22400130,3,158,-5.0,-1.89873417721519,500,342
22400130,3,32,-2.0,-3.75,342,310
22400130,3,19,-2.0,-6.315789473684211,310,291
22400130,3,26,0.0,0.0,291,265
22400130,3,43,2.0,2.7906976744186047,250,207
22400130,3,94,3.0,1.9148936170212765,192,98
22400130,4,148,-4.0,-1.6216216216216217,720,572
22400130,4,133,-4.0,-1.8045112781954886,572,439
22400130,4,34,-2.0,-3.5294117647058822,431,397
22400130,4,101,1.0,0.594059405940594,386,285
22400130,4,8,2.0,15.0,277,269
22400130,4,229,-3.0,-0.7860262008733624,255,26
22400130,4,23,2.0,5.217391304347826,23,0
22400131,1,430,5.0,0.6976744186046512,720,290
22400131,1,97,8.0,4.948453608247423,290,193
22400131,1,95,3.0,1.8947368421052633,178,83
22400131,1,39,-2.0,-3.0769230769230766,74,35
22400131,1,35,0.0,0.0,35,0
22400131,2,53,-3.0,-3.3962264150943398,720,667
22400131,2,62,0.0,0.0,667,605
22400131,2,8,-1.0,-7.5,589,581
22400131,2,31,0.0,0.0,581,550
22400131,2,71,0.0,0.0,541,470
22400131,2,67,-1.0,-0.8955223880597015,470,403
22400131,2,13,-1.0,-4.615384615384616,395,382
22400131,2,13,1.0,4.615384615384616,382,369
22400131,2,58,-2.0,-2.0689655172413794,365,307
22400131,2,17,3.0,10.588235294117649,307,290
22400131,2,23,0.0,0.0,278,255
22400131,2,113,1.0,0.5309734513274336,255,142
22400131,2,128,2.0,0.9375,142,14
22400131,3,286,-7.0,-1.4685314685314685,720,434
22400131,3,127,-8.0,-3.779527559055118,414,287
22400131,3,34,-1.0,-1.7647058823529411,277,243
22400131,3,29,-3.0,-6.206896551724138,243,214
22400131,3,106,0.0,0.0,207,101
22400131,3,86,-1.0,-0.6976744186046512,86,0
22400131,4,148,-6.0,-2.4324324324324325,720,572
22400131,4,78,3.0,2.307692307692308,556,478
22400131,4,50,-2.0,-2.4,465,415
22400131,4,53,-2.0,-2.2641509433962264,383,330
22400131,4,28,0.0,0.0,320,292
22400131,4,79,1.0,0.7594936708860759,281,202
22400131,4,13,0.0,0.0,202,189
22400131,4,16,-2.0,-7.5,178,162
22400131,4,19,2.0,6.315789473684211,85,66
22400131,4,22,-3.0,-8.181818181818182,66,44
22400131,4,42,0.0,0.0,42,0
22400132,1,294,5.0,1.0204081632653061,720,426
22400132,1,50,-6.0,-7.199999999999999,426,376
22400132,1,100,-8.0,-4.8,360,260
22400132,1,88,5.0,3.409090909090909,241,153
22400132,1,25,0.0,0.0,149,124
22400132,2,135,8.0,3.555555555555556,720,585
22400132,2,84,-2.0,-1.4285714285714284,570,486
22400132,2,18,-1.0,-3.333333333333333,479,461
22400132,2,52,-1.0,-1.153846153846154,461,409
22400132,2,28,-3.0,-6.428571428571428,393,365
22400132,2,105,2.0,1.142857142857143,352,247
22400132,2,240,4.0,1.0,240,0
22400132,3,331,-4.0,-0.7250755287009063,720,389
22400132,3,38,3.0,4.7368421052631575,352,314
22400132,3,282,3.0,0.6382978723404256,314,32
22400132,4,175,3.0,1.0285714285714287,720,545
22400132,4,68,3.0,2.647058823529412,545,477
22400132,4,19,0.0,0.0,474,455
22400132,4,23,-1.0,-2.608695652173913,450,427
22400132,4,61,-2.0,-1.9672131147540985,427,366
22400132,4,21,0.0,0.0,360,339
22400132,4,39,-2.0,-3.0769230769230766,325,286
22400132,4,29,-2.0,-4.137931034482759,282,253
22400132,4,131,0.0,0.0,253,122
22400132,4,6,-1.0,-10.0,122,116
22400132,4,77,-1.0,-0.7792207792207793,110,33
22400133,1,326,5.0,0.9202453987730062,720,394
22400133,1,249,2.0,0.48192771084337344,559,310
22400133,1,40,-2.0,-3.0,310,270
22400133,1,18,2.0,6.666666666666666,265,247
22400133,1,68,5.0,4.411764705882353,230,162
22400133,1,63,2.0,1.9047619047619047,137,74
22400133,1,74,2.0,1.6216216216216217,74,0
22400133,2,140,-3.0,-1.2857142857142858,720,580
22400133,2,39,3.0,4.615384615384616,566,527
22400133,2,72,-4.0,-3.333333333333333,520,448
22400133,2,28,0.0,0.0,448,420
22400133,2,38,-3.0,-4.7368421052631575,408,370
22400133,2,73,2.0,1.643835616438356,366,293
22400133,2,23,0.0,0.0,290,267
22400133,2,30,5.0,10.0,257,227
22400133,2,189,3.0,0.9523809523809523,213,24
22400133,2,24,0.0,0.0,24,0
22400133,3,288,-4.0,-0.8333333333333333,720,432
22400133,3,19,0.0,0.0,430,411
22400133,3,154,1.0,0.38961038961038963,397,243
22400133,3,38,-3.0,-4.7368421052631575,243,205
22400133,3,31,1.0,1.935483870967742,205,174
22400133,4,113,3.0,1.592920353982301,720,607
22400133,4,70,-2.0,-1.7142857142857142,593,523
22400133,4,59,-3.0,-3.050847457627119,518,459
22400133,4,186,1.0,0.32258064516129037,434,248
22400133,4,238,-5.0,-1.2605042016806725,238,0
22400134,1,265,-5.0,-1.1320754716981132,720,455
22400134,1,118,-4.0,-2.0338983050847457,455,337
22400134,1,15,0.0,0.0,332,317
22400134,1,57,-5.0,-5.263157894736842,305,248
22400134,1,181,-5.0,-1.6574585635359116,237,56
22400134,1,38,-3.0,-4.7368421052631575,38,0
22400134,2,146,-6.0,-2.4657534246575343,720,574
22400134,2,97,0.0,0.0,553,456
22400134,2,49,0.0,0.0,444,395
22400134,2,19,1.0,3.1578947368421053,395,376
22400134,2,172,6.0,2.0930232558139537,376,204
22400134,2,163,-1.0,-0.36809815950920244,195,32
22400134,2,27,3.0,6.666666666666666,27,0
22400134,3,216,-6.0,-1.6666666666666665,720,504
22400134,3,132,3.0,1.3636363636363638,488,356
22400134,3,136,-3.0,-1.323529411764706,339,203
22400134,3,86,2.0,1.3953488372093024,201,115
22400134,3,100,-1.0,-0.6,100,0
22400134,4,99,-3.0,-1.8181818181818183,720,621
22400134,4,82,0.0,0.0,614,532
22400134,4,83,3.0,2.1686746987951806,532,449
22400134,4,109,0.0,0.0,439,330
22400134,4,10,0.0,0.0,316,306
22400134,4,80,5.0,3.75,290,210
22400134,4,150,-8.0,-3.2,206,56
22400134,4,56,2.0,2.142857142857143,56,0
22400135,1,259,-8.0,-1.8532818532818534,720,461
22400135,1,60,1.0,1.0,449,389
22400135,1,32,0.0,0.0,389,357
22400135,1,99,-6.0,-3.6363636363636367,351,252
22400135,1,15,3.0,12.0,236,221
22400135,1,24,-2.0,-5.0,221,197
22400135,1,9,0.0,0.0,186,177
22400135,1,101,0.0,0.0,175,74
22400135,1,72,3.0,2.5,72,0
22400135,2,144,-7.0,-2.9166666666666665,720,576
22400135,2,72,0.0,0.0,571,499
22400135,2,47,4.0,5.1063829787234045,499,452
22400135,2,86,2.0,1.3953488372093024,438,352
22400135,2,71,1.0,0.8450704225352113,352,281
22400135,2,54,-1.0,-1.1111111111111112,281,227
22400135,3,232,-8.0,-2.0689655172413794,720,488
22400135,3,189,9.0,2.8571428571428568,479,290
22400135,3,149,2.0,0.8053691275167785,274,125
22400135,3,99,-4.0,-2.4242424242424243,110,11
22400135,4,136,3.0,1.323529411764706,720,584
22400135,4,118,-2.0,-1.0169491525423728,584,466
22400135,4,53,5.0,5.660377358490567,435,382
22400135,4,261,-4.0,-0.9195402298850575,382,121
22400135,4,103,-2.0,-1.1650485436893203,103,0
22400136,1,301,4.0,0.7973421926910299,720,419
22400136,1,39,2.0,3.0769230769230766,406,367
22400136,1,57,1.0,1.0526315789473684,360,303
22400136,1,69,0.0,0.0,296,227
22400136,1,218,-2.0,-0.5504587155963303,218,0
22400136,2,181,3.0,0.9944751381215469,720,539
22400136,2,109,7.0,3.853211009174312,526,417
22400136,2,166,-1.0,-0.3614457831325301,404,238
22400136,2,221,-6.0,-1.6289592760180995,221,0
22400136,3,299,-4.0,-0.802675585284281,720,421
22400136,3,44,0.0,0.0,421,377
22400136,3,54,1.0,1.1111111111111112,359,305
22400136,3,83,-1.0,-0.7228915662650602,290,207
22400136,3,190,0.0,0.0,190,0
22400136,4,151,-6.0,-2.384105960264901,720,569
22400136,4,41,0.0,0.0,561,520
22400136,4,16,4.0,15.0,509,493
22400136,4,50,4.0,4.8,481,431
22400136,4,130,-3.0,-1.3846153846153846,416,286
22400136,4,43,0.0,0.0,286,243
22400136,4,105,5.0,2.8571428571428568,243,138
22400136,4,108,2.0,1.1111111111111112,136,28
22400136,4,10,0.0,0.0,10,0
22400137,1,333,-14.0,-2.5225225225225225,720,387
22400137,1,39,-4.0,-6.153846153846153,332,293
22400137,1,113,1.0,0.5309734513274336,293,180
22400137,1,26,1.0,2.307692307692308,174,148
22400137,1,34,-2.0,-3.5294117647058822,148,114
22400137,1,106,-3.0,-1.6981132075471699,106,0
22400137,2,68,-1.0,-0.8823529411764706,720,652
22400137,2,136,2.0,0.8823529411764706,652,516
22400137,2,70,2.0,1.7142857142857142,497,427
22400137,2,40,0.0,0.0,410,370
22400137,2,22,2.0,5.454545454545455,370,348
22400137,2,124,1.0,0.4838709677419355,340,216
22400137,2,214,-6.0,-1.6822429906542056,216,2
22400137,3,342,9.0,1.5789473684210527,720,378
22400137,3,23,2.0,5.217391304347826,378,355
22400137,3,1,0.0,0.0,344,343
22400137,3,80,5.0,3.75,325,245
22400137,3,40,-2.0,-3.0,235,195
22400137,3,79,1.0,0.7594936708860759,184,105
22400137,3,90,-1.0,-0.6666666666666667,98,8
22400137,3,8,0.0,0.0,8,0
22400137,4,141,0.0,0.0,720,579
22400137,4,41,3.0,4.390243902439024,579,538
22400137,4,43,2.0,2.7906976744186047,527,484
22400137,4,15,0.0,0.0,484,469
22400137,4,57,-4.0,-4.2105263157894735,466,409
22400137,4,75,-3.0,-2.4,395,320
22400137,4,52,4.0,4.615384615384616,305,253
22400137,4,175,4.0,1.3714285714285714,250,75
22400137,4,46,0.0,0.0,75,29
22400137,4,7,2.0,17.142857142857142,20,13
22400137,4,2,-2.0,-60.0,9,7
22400137,4,2,0.0,0.0,2,0
22400138,1,368,1.0,0.16304347826086957,720,352
22400138,1,76,1.0,0.7894736842105263,341,265
22400138,1,27,2.0,4.444444444444445,257,230
22400138,1,95,0.0,0.0,219,124
22400138,1,115,4.0,2.0869565217391304,115,0
22400138,2,149,-3.0,-1.2080536912751678,720,571
22400138,2,109,-2.0,-1.1009174311926606,549,440
22400138,2,28,-5.0,-10.714285714285715,427,399
22400138,2,72,1.0,0.8333333333333333,385,313
22400138,2,113,6.0,3.185840707964602,313,200
22400138,2,58,0.0,0.0,185,127
22400138,2,120,0.0,0.0,120,0
22400138,3,229,6.0,1.5720524017467248,720,491
22400138,3,49,-2.0,-2.4489795918367343,472,423
22400138,3,69,0.0,0.0,410,341
22400138,3,118,0.0,0.0,341,223
22400138,3,52,2.0,2.307692307692308,213,161
22400138,3,147,1.0,0.40816326530612246,147,0
22400138,4,137,-5.0,-2.18978102189781,720,583
22400138,4,85,1.0,0.7058823529411764,583,498
22400138,4,20,0.0,0.0,498,478
22400138,4,61,-1.0,-0.9836065573770493,473,412
22400138,4,95,1.0,0.631578947368421,401,306
22400138,4,502,3.0,0.35856573705179284,538,36
22400138,4,24,2.0,5.0,34,10
22400138,4,10,0.0,0.0,10,0
22400139,1,345,-5.0,-0.8695652173913043,720,375
22400139,1,72,-2.0,-1.6666666666666665,368,296
22400139,1,27,0.0,0.0,275,248
22400139,1,29,3.0,6.206896551724138,236,207
22400139,1,30,-2.0,-4.0,207,177
22400139,1,75,3.0,2.4,177,102
22400139,1,87,3.0,2.0689655172413794,87,0
22400139,2,79,4.0,3.0379746835443036,720,641
22400139,2,90,4.0,2.666666666666667,629,539
22400139,2,60,-2.0,-2.0,528,468
22400139,2,89,-7.0,-4.719101123595506,468,379
22400139,2,92,-3.0,-1.9565217391304348,365,273
22400139,2,121,0.0,0.0,273,152
22400139,2,139,0.0,0.0,145,6
22400139,3,152,-2.0,-0.7894736842105263,720,568
22400139,3,148,6.0,2.4324324324324325,555,407
22400139,3,43,-3.0,-4.186046511627907,396,353
22400139,3,59,7.0,7.118644067796611,353,294
22400139,3,58,-1.0,-1.0344827586206897,280,222
22400139,3,171,1.0,0.3508771929824561,213,42
22400139,3,1,0.0,0.0,30,29
22400139,3,11,0.0,0.0,11,0
22400139,4,162,0.0,0.0,720,558
22400139,4,30,-2.0,-4.0,548,518
22400139,4,23,0.0,0.0,518,495
22400139,4,9,-6.0,-40.0,488,479
22400139,4,10,-2.0,-12.0,384,374
22400139,4,46,-4.0,-5.217391304347826,360,314
22400139,4,283,9.0,1.9081272084805652,308,25
22400139,4,3,1.0,20.0,13,10
22400139,4,10,0.0,0.0,10,0
22400140,1,311,-4.0,-0.7717041800643086,720,409
22400140,1,83,2.0,1.4457831325301205,396,313
22400140,1,79,-8.0,-6.075949367088607,300,221
22400140,1,9,1.0,6.666666666666666,198,189
22400140,1,154,0.0,0.0,189,35
22400140,1,31,-2.0,-3.870967741935484,35,4
22400140,2,148,-1.0,-0.40540540540540543,720,572
22400140,2,98,-2.0,-1.2244897959183672,566,468
22400140,2,82,5.0,3.6585365853658534,468,386
22400140,2,112,-1.0,-0.5357142857142857,379,267
22400140,2,216,8.0,2.2222222222222223,257,41
22400140,2,41,4.0,5.853658536585366,41,0
22400140,3,90,0.0,0.0,720,630
22400140,3,157,-6.0,-2.2929936305732483,618,461
22400140,3,54,0.0,0.0,461,407
22400140,3,43,2.0,2.7906976744186047,395,352
22400140,3,65,-5.0,-4.615384615384616,352,287
22400140,3,37,-3.0,-4.864864864864865,266,229
22400140,3,87,-2.0,-1.3793103448275863,229,142
22400140,3,35,0.0,0.0,142,107
22400140,4,26,-1.0,-2.307692307692308,720,694
22400140,4,39,1.0,1.5384615384615383,694,655
22400140,4,15,-1.0,-4.0,655,640
22400140,4,85,-5.0,-3.5294117647058822,640,555
22400140,4,52,4.0,4.615384615384616,540,488
22400140,4,76,1.0,0.7894736842105263,488,412
22400140,4,84,3.0,2.142857142857143,412,328
22400140,4,119,-4.0,-2.0168067226890756,328,209
22400140,4,209,-1.0,-0.28708133971291866,209,0
22400141,1,284,-5.0,-1.0563380281690142,720,436
22400141,1,80,-4.0,-3.0,436,356
22400141,1,22,-1.0,-2.7272727272727275,336,314
22400141,1,40,-3.0,-4.5,314,274
22400141,1,45,0.0,0.0,274,229
22400141,1,40,-3.0,-4.5,216,176
22400141,1,87,5.0,3.4482758620689653,176,89
22400141,1,86,-3.0,-2.0930232558139537,86,0
22400141,2,31,-2.0,-3.870967741935484,720,689
22400141,2,126,2.0,0.9523809523809523,689,563
22400141,2,122,-3.0,-1.4754098360655736,563,441
22400141,2,112,-4.0,-2.142857142857143,420,308
22400141,2,91,1.0,0.6593406593406594,299,208
22400141,2,17,1.0,3.5294117647058822,204,187
22400141,2,105,-2.0,-1.142857142857143,169,64
22400141,2,64,3.0,2.8125,64,0
22400141,3,340,12.0,2.1176470588235294,720,380
22400141,3,19,-2.0,-6.315789473684211,365,346
22400141,3,77,-2.0,-1.5584415584415585,337,260
22400141,3,64,1.0,0.9375,260,196
22400141,3,186,-3.0,-0.967741935483871,186,0
22400141,4,234,2.0,0.5128205128205129,720,486
22400141,4,30,0.0,0.0,470,440
22400141,4,156,-3.0,-1.153846153846154,432,276
22400141,4,70,-1.0,-0.8571428571428571,276,206
22400141,4,161,0.0,0.0,194,33
22400141,4,6,2.0,20.0,26,20
22400141,4,3,1.0,20.0,20,17
22400141,4,17,0.0,0.0,17,0
22400142,1,261,-1.0,-0.22988505747126436,720,459
22400142,1,54,-3.0,-3.333333333333333,446,392
22400142,1,184,7.0,2.282608695652174,387,203
22400142,1,62,1.0,0.967741935483871,184,122
22400142,1,101,1.0,0.594059405940594,121,20
22400142,1,20,0.0,0.0,20,0
22400142,2,157,1.0,0.3821656050955414,720,563
22400142,2,67,-1.0,-0.8955223880597015,547,480
22400142,2,27,-1.0,-2.2222222222222223,471,444
22400142,2,120,-5.0,-2.5,434,314
22400142,2,64,1.0,0.9375,293,229
22400142,2,70,-4.0,-3.4285714285714284,218,148
22400142,2,94,-5.0,-3.1914893617021276,132,38
22400142,2,6,-1.0,-10.0,38,32
22400142,2,32,-1.0,-1.875,32,0
22400142,3,250,-4.0,-0.96,720,470
22400142,3,25,-1.0,-2.4,450,425
22400142,3,12,0.0,0.0,415,403
22400142,3,93,2.0,1.2903225806451615,398,305
22400142,3,37,-2.0,-3.2432432432432434,305,268
22400142,3,31,-5.0,-9.67741935483871,268,237
22400142,3,106,-2.0,-1.1320754716981132,237,131
22400142,3,124,2.0,0.967741935483871,124,0
22400142,4,249,-1.0,-0.24096385542168672,720,471
22400142,4,136,3.0,1.323529411764706,465,329
22400142,4,117,0.0,0.0,320,203
22400142,4,105,2.0,1.142857142857143,192,87
22400142,4,46,-3.0,-3.9130434782608696,87,41
22400142,4,35,2.0,3.4285714285714284,35,0
22400143,1,439,0.0,0.0,720,281
22400143,1,67,2.0,1.791044776119403,266,199
22400143,1,103,6.0,3.4951456310679614,199,96
22400143,1,53,2.0,2.2641509433962264,53,0
22400143,2,138,2.0,0.8695652173913043,720,582
22400143,2,12,0.0,0.0,582,570
22400143,2,23,-3.0,-7.826086956521739,554,531
22400143,2,53,0.0,0.0,516,463
22400143,2,47,3.0,3.829787234042553,463,416
22400143,2,29,0.0,0.0,416,387
22400143,2,104,0.0,0.0,374,270
22400143,2,120,2.0,1.0,270,150
22400143,2,117,-5.0,-2.5641025641025643,143,26
22400143,2,25,-1.0,-2.4,26,1
22400143,3,292,8.0,1.643835616438356,720,428
22400143,3,76,-1.0,-0.7894736842105263,408,332
22400143,3,44,-2.0,-2.7272727272727275,318,274
22400143,3,126,-4.0,-1.9047619047619047,260,134
22400143,3,57,6.0,6.315789473684211,123,66
22400143,3,17,2.0,7.0588235294117645,51,34
22400143,4,91,-6.0,-3.956043956043956,720,629
22400143,4,77,3.0,2.3376623376623376,613,536
22400143,4,16,0.0,0.0,534,518
22400143,4,61,0.0,0.0,507,446
22400143,4,73,6.0,4.931506849315069,425,352
22400143,4,158,-9.0,-3.4177215189873418,336,178
22400143,4,159,0.0,0.0,178,19
22400143,4,6,0.0,0.0,16,10
22400143,4,10,1.0,6.0,10,0
22400143,5,124,0.0,0.0,300,176
22400143,5,167,2.0,0.718562874251497,176,9
22400143,5,6,0.0,0.0,6,0
22400144,1,356,-7.0,-1.1797752808988764,720,364
22400144,1,60,0.0,0.0,355,295
22400144,1,59,-6.0,-6.101694915254238,278,219
22400144,1,58,-2.0,-2.0689655172413794,201,143
22400144,1,131,1.0,0.4580152671755725,131,0
22400144,2,100,2.0,1.2,720,620
22400144,2,60,-3.0,-3.0,620,560
22400144,2,17,-2.0,-7.0588235294117645,560,543
22400144,2,67,-3.0,-2.6865671641791042,528,461
22400144,2,104,-5.0,-2.8846153846153846,461,357
22400144,2,50,2.0,2.4,337,287
22400144,2,274,1.0,0.218978102189781,274,0
22400144,3,290,2.0,0.41379310344827586,720,430
22400144,3,35,-1.0,-1.7142857142857142,424,389
22400144,3,42,2.0,2.8571428571428568,389,347
22400144,3,82,7.0,5.121951219512195,347,265
22400144,3,152,-2.0,-0.7894736842105263,265,113
22400144,3,91,2.0,1.3186813186813189,98,7
22400144,3,7,2.0,17.142857142857142,7,0
22400144,4,74,6.0,4.864864864864865,720,646
22400144,4,104,7.0,4.038461538461538,637,533
22400144,4,50,2.0,2.4,516,466
22400144,4,141,0.0,0.0,466,325
22400144,4,11,1.0,5.454545454545455,308,297
22400144,4,100,-2.0,-1.2,297,197
22400144,4,90,0.0,0.0,197,107
22400144,4,56,-2.0,-2.142857142857143,107,51
22400144,4,10,0.0,0.0,43,33
22400144,4,5,0.0,0.0,33,28
22400144,4,13,3.0,13.846153846153847,28,15
22400144,4,7,0.0,0.0,15,8
22400144,4,8,0.0,0.0,8,0
22400144,5,125,-2.0,-0.96,300,175
22400144,5,78,0.0,0.0,162,84
22400144,5,61,0.0,0.0,78,17
22400144,5,8,0.0,0.0,8,0
22400145,1,328,9.0,1.646341463414634,720,392
22400145,1,70,1.0,0.8571428571428571,392,322
22400145,1,8,0.0,0.0,322,314
22400145,1,75,-5.0,-4.0,267,192
22400145,1,83,0.0,0.0,176,93
22400145,1,53,3.0,3.3962264150943398,93,40
22400145,2,91,3.0,1.978021978021978,720,629
22400145,2,42,2.0,2.8571428571428568,629,587
22400145,2,27,-1.0,-2.2222222222222223,580,553
22400145,2,80,0.0,0.0,542,462
22400145,2,56,0.0,0.0,439,383
22400145,2,9,0.0,0.0,367,358
22400145,2,123,-3.0,-1.4634146341463414,350,227
22400145,2,37,-4.0,-6.486486486486487,214,177
22400145,2,70,-3.0,-2.5714285714285716,177,107
22400145,2,102,6.0,3.5294117647058822,102,0
22400145,3,340,-2.0,-0.3529411764705882,720,380
22400145,3,76,-2.0,-1.5789473684210527,380,304
22400145,3,23,0.0,0.0,304,281
22400145,3,16,-1.0,-3.75,266,250
22400145,3,74,0.0,0.0,238,164
22400145,3,41,5.0,7.317073170731707,151,110
22400145,3,74,-4.0,-3.2432432432432434,96,22
22400145,3,22,0.0,0.0,22,0
22400145,4,122,-2.0,-0.9836065573770493,720,598
22400145,4,24,-2.0,-5.0,587,563
22400145,4,95,1.0,0.631578947368421,547,452
22400145,4,126,3.0,1.4285714285714284,438,312
22400145,4,279,-1.0,-0.21505376344086022,288,9
22400146,1,357,4.0,0.6722689075630253,720,363
22400146,1,16,0.0,0.0,363,347
22400146,1,9,-1.0,-6.666666666666666,337,328
22400146,1,86,1.0,0.6976744186046512,312,226
22400146,1,118,-3.0,-1.5254237288135595,216,98
22400146,1,24,1.0,2.5,98,74
22400146,1,74,0.0,0.0,74,0
22400146,2,56,0.0,0.0,720,664
22400146,2,126,0.0,0.0,664,538
22400146,2,36,3.0,5.0,529,493
22400146,2,55,-7.0,-7.636363636363636,493,438
22400146,2,63,2.0,1.9047619047619047,420,357
22400146,2,134,5.0,2.2388059701492535,357,223
22400146,2,137,0.0,0.0,213,76
22400146,2,26,2.0,4.615384615384616,63,37
22400146,3,255,7.0,1.6470588235294117,720,465
22400146,3,57,1.0,1.0526315789473684,456,399
22400146,3,31,3.0,5.806451612903226,399,368
22400146,3,60,1.0,1.0,358,298
22400146,3,23,0.0,0.0,286,263
22400146,3,24,-4.0,-10.0,251,227
22400146,3,92,-4.0,-2.608695652173913,209,117
22400146,3,87,5.0,3.4482758620689653,108,21
22400146,3,2,0.0,0.0,2,0
22400146,4,128,2.0,0.9375,720,592
22400146,4,50,2.0,2.4,589,539
22400146,4,74,0.0,0.0,523,449
22400146,4,25,-2.0,-4.8,449,424
22400146,4,28,-2.0,-4.285714285714286,424,396
22400146,4,113,2.0,1.0619469026548671,385,272
22400146,4,74,1.0,0.8108108108108109,262,188
22400146,4,88,1.0,0.6818181818181819,167,79
22400146,4,64,-5.0,-4.6875,64,0
22400147,1,316,-6.0,-1.139240506329114,720,404
22400147,1,52,-2.0,-2.307692307692308,393,341
22400147,1,108,-3.0,-1.6666666666666665,319,211
22400147,1,192,3.0,0.9375,192,0
22400147,2,27,2.0,4.444444444444445,720,693
22400147,2,214,-3.0,-0.8411214953271028,686,472
22400147,2,45,0.0,0.0,472,427
22400147,2,81,-2.0,-1.4814814814814814,383,302
22400147,2,35,0.0,0.0,295,260
22400147,2,21,-4.0,-11.428571428571427,250,229
22400147,2,43,-2.0,-2.7906976744186047,218,175
22400147,2,13,-1.0,-4.615384615384616,175,162
22400147,2,73,3.0,2.4657534246575343,151,78
22400147,2,78,5.0,3.846153846153846,78,0
22400147,3,159,-3.0,-1.1320754716981132,720,561
22400147,3,46,-2.0,-2.608695652173913,561,515
22400147,3,45,3.0,4.0,499,454
22400147,3,32,-2.0,-3.75,449,417
22400147,3,30,-4.0,-8.0,404,374
22400147,3,56,-1.0,-1.0714285714285714,374,318
22400147,3,101,-2.0,-1.188118811881188,318,217
22400147,3,16,2.0,7.5,203,187
22400147,3,168,-1.0,-0.3571428571428571,168,0
22400147,4,65,-2.0,-1.8461538461538463,720,655
22400147,4,113,4.0,2.1238938053097343,655,542
22400147,4,84,-1.0,-0.7142857142857142,522,438
22400147,4,51,0.0,0.0,431,380
22400147,4,103,4.0,2.3300970873786406,380,277
22400147,4,74,-3.0,-2.4324324324324325,270,196
22400147,4,48,-2.0,-2.5,194,146
22400147,4,114,2.0,1.0526315789473684,114,0
22400148,1,231,4.0,1.0389610389610389,720,489
22400148,1,29,6.0,12.413793103448276,479,450
22400148,1,38,4.0,6.315789473684211,432,394
22400148,1,105,-4.0,-2.285714285714286,394,289
22400148,1,16,-3.0,-11.25,289,273
22400148,1,19,1.0,3.1578947368421053,259,240
22400148,1,65,2.0,1.8461538461538463,240,175
22400148,1,12,-2.0,-10.0,166,154
22400148,1,2,1.0,30.0,154,152
22400148,1,140,2.0,0.8571428571428571,140,0
22400148,2,37,1.0,1.6216216216216217,720,683
22400148,2,120,-5.0,-2.5,683,563
22400148,2,54,-2.0,-2.2222222222222223,548,494
22400148,2,71,0.0,0.0,481,410
22400148,2,4,3.0,45.0,393,389
22400148,2,67,4.0,3.582089552238806,317,250
22400148,2,29,-1.0,-2.0689655172413794,250,221
22400148,2,161,-2.0,-0.7453416149068323,214,53
22400148,2,53,0.0,0.0,53,0
22400148,3,285,4.0,0.8421052631578948,720,435
22400148,3,163,4.0,1.4723926380368098,435,272
22400148,3,203,3.0,0.8866995073891625,272,69
22400148,3,26,3.0,6.923076923076923,58,32
22400148,3,32,0.0,0.0,32,0
22400148,4,128,0.0,0.0,720,592
22400148,4,249,1.0,0.24096385542168672,592,343
22400148,4,118,1.0,0.5084745762711864,248,130
22400148,4,104,2.0,1.153846153846154,104,0
22400149,1,299,0.0,0.0,720,421
22400149,1,12,0.0,0.0,421,409
22400149,1,13,2.0,9.230769230769232,395,382
22400149,1,111,0.0,0.0,382,271
22400149,1,52,-2.0,-2.307692307692308,271,219
22400149,1,24,0.0,0.0,219,195
22400149,1,32,0.0,0.0,195,163
22400149,1,115,3.0,1.5652173913043477,147,32
22400149,1,4,1.0,15.0,30,26
22400149,1,26,-2.0,-4.615384615384616,26,0
22400149,2,72,7.0,5.833333333333333,720,648
22400149,2,97,1.0,0.6185567010309279,636,539
22400149,2,55,-2.0,-2.1818181818181817,539,484
22400149,2,66,-1.0,-0.9090909090909092,484,418
22400149,2,134,0.0,0.0,418,284
22400149,2,31,-3.0,-5.806451612903226,284,253
22400149,2,134,-1.0,-0.44776119402985076,234,100
22400149,2,77,-1.0,-0.7792207792207793,77,0
22400149,3,270,11.0,2.4444444444444446,720,450
22400149,3,24,3.0,7.5,443,419
22400149,3,66,5.0,4.545454545454546,413,347
22400149,3,101,3.0,1.782178217821782,335,234
22400149,3,115,2.0,1.0434782608695652,224,109
22400149,3,104,2.0,1.153846153846154,104,0
22400149,4,188,-2.0,-0.6382978723404256,720,532
22400149,4,45,-4.0,-5.333333333333334,529,484
22400149,4,78,0.0,0.0,475,397
22400149,4,34,-3.0,-5.294117647058824,397,363
22400149,4,50,-2.0,-2.4,356,306
22400149,4,222,-10.0,-2.7027027027027026,243,21
22400149,4,17,2.0,7.0588235294117645,17,0
22400150,1,303,5.0,0.99009900990099,720,417
22400150,1,27,0.0,0.0,408,381
22400150,1,32,-3.0,-5.625,369,337
22400150,1,46,-4.0,-5.217391304347826,328,282
22400150,1,82,3.0,2.195121951219512,282,200
22400150,1,181,4.0,1.3259668508287292,181,0
22400150,2,226,0.0,0.0,720,494
22400150,2,13,0.0,0.0,483,470
22400150,2,25,-3.0,-7.199999999999999,470,445
22400150,2,33,0.0,0.0,422,389
22400150,2,41,0.0,0.0,389,348
22400150,2,55,-6.0,-6.545454545454545,335,280
22400150,2,69,-5.0,-4.3478260869565215,233,164
22400150,2,64,8.0,7.5,154,90
22400150,2,25,1.0,2.4,79,54
22400150,2,54,-3.0,-3.333333333333333,54,0
22400150,3,242,-2.0,-0.49586776859504134,720,478
22400150,3,128,1.0,0.46875,478,350
22400150,3,51,-5.0,-5.88235294117647,335,284
22400150,3,16,2.0,7.5,262,246
22400150,3,128,-2.0,-0.9375,246,118
22400150,3,118,-1.0,-0.5084745762711864,118,0
22400150,4,288,-10.0,-2.0833333333333335,720,432
22400150,4,98,0.0,0.0,411,313
22400150,4,52,-4.0,-4.615384615384616,305,253
22400150,4,39,-2.0,-3.0769230769230766,243,204
22400150,4,204,4.0,1.1764705882352942,204,0
22400151,1,294,1.0,0.20408163265306123,720,426
22400151,1,101,-2.0,-1.188118811881188,409,308
22400151,1,6,-3.0,-30.0,291,285
22400151,1,25,2.0,4.8,266,241
22400151,1,43,3.0,4.186046511627907,241,198
22400151,1,188,-1.0,-0.3191489361702128,198,10
22400151,2,101,-1.0,-0.594059405940594,720,619
22400151,2,18,1.0,3.333333333333333,619,601
22400151,2,106,7.0,3.9622641509433962,601,495
22400151,2,23,0.0,0.0,495,472
22400151,2,9,0.0,0.0,472,463
22400151,2,14,3.0,12.857142857142856,450,436
22400151,2,42,1.0,1.4285714285714284,436,394
22400151,2,197,-1.0,-0.3045685279187817,394,197
22400151,2,14,0.0,0.0,197,183
22400151,2,99,-1.0,-0.6060606060606061,162,63
22400151,2,60,0.0,0.0,63,3
22400151,3,276,3.0,0.6521739130434783,720,444
22400151,3,61,-4.0,-3.934426229508197,435,374
22400151,3,38,-2.0,-3.1578947368421053,362,324
22400151,3,73,0.0,0.0,324,251
22400151,3,61,-5.0,-4.918032786885245,249,188
22400151,3,188,-3.0,-0.9574468085106382,188,0
22400151,4,62,-3.0,-2.903225806451613,720,658
22400151,4,105,2.0,1.142857142857143,658,553
22400151,4,30,0.0,0.0,553,523
22400151,4,37,-4.0,-6.486486486486487,519,482
22400151,4,26,2.0,4.615384615384616,463,437
22400151,4,85,0.0,0.0,437,352
22400151,4,51,-2.0,-2.3529411764705883,352,301
22400151,4,37,-3.0,-4.864864864864865,133,96
22400151,4,42,1.0,1.4285714285714284,96,54
22400151,4,54,-2.0,-2.2222222222222223,54,0
22400152,1,357,-5.0,-0.8403361344537815,720,363
22400152,1,16,0.0,0.0,353,337
22400152,1,40,-2.0,-3.0,337,297
22400152,1,32,1.0,1.875,287,255
22400152,1,56,0.0,0.0,255,199
22400152,1,13,-1.0,-4.615384615384616,172,159
22400152,1,137,3.0,1.3138686131386863,159,22
22400152,1,20,2.0,6.0,20,0
22400152,2,300,2.0,0.4,720,420
22400152,2,69,3.0,2.608695652173913,420,351
22400152,2,81,4.0,2.962962962962963,344,263
22400152,2,37,-2.0,-3.2432432432432434,263,226
22400152,2,115,-5.0,-2.608695652173913,226,111
22400152,2,52,0.0,0.0,95,43
22400152,2,35,2.0,3.4285714285714284,35,0
22400152,3,281,-7.0,-1.4946619217081851,720,439
22400152,3,60,-2.0,-2.0,425,365
22400152,3,76,-2.0,-1.5789473684210527,299,223
22400152,3,89,1.0,0.6741573033707865,219,130
22400152,3,153,0.0,0.0,223,70
22400152,3,44,1.0,1.3636363636363638,55,11
22400152,3,1,0.0,0.0,1,0
22400152,4,93,-1.0,-0.6451612903225807,720,627
22400152,4,151,-1.0,-0.3973509933774834,604,453
22400152,4,86,-6.0,-4.186046511627907,432,346
22400152,4,79,2.0,1.5189873417721518,346,267
22400152,4,38,-4.0,-6.315789473684211,251,213
22400152,4,136,10.0,4.411764705882353,136,0
22400153,1,246,-4.0,-0.9756097560975611,720,474
22400153,1,11,0.0,0.0,474,463
22400153,1,121,5.0,2.479338842975207,444,323
22400153,1,133,0.0,0.0,323,190
22400153,1,42,4.0,5.7142857142857135,190,148
22400153,1,66,2.0,1.8181818181818183,136,70
22400153,1,54,5.0,5.555555555555555,54,0
22400153,2,56,5.0,5.357142857142858,720,664
22400153,2,77,4.0,3.116883116883117,664,587
22400153,2,90,-2.0,-1.3333333333333335,572,482
22400153,2,19,2.0,6.315789473684211,471,452
22400153,2,32,0.0,0.0,452,420
22400153,2,25,-2.0,-4.8,399,374
22400153,2,56,6.0,6.428571428571428,368,312
22400153,2,18,0.0,0.0,292,274
22400153,2,78,0.0,0.0,263,185
22400153,2,126,-3.0,-1.4285714285714284,175,49
22400153,2,49,0.0,0.0,49,0
22400153,3,230,0.0,0.0,720,490
22400153,3,112,4.0,2.142857142857143,477,365
22400153,3,133,-2.0,-0.9022556390977443,365,232
22400153,3,81,-3.0,-2.2222222222222223,223,142
22400153,3,31,-1.0,-1.935483870967742,142,111
22400153,3,111,4.0,2.1621621621621623,111,0
22400153,4,136,4.0,1.7647058823529411,720,584
22400153,4,10,1.0,6.0,584,574
22400153,4,60,-2.0,-2.0,574,514
22400153,4,30,-2.0,-4.0,507,477
22400153,4,35,0.0,0.0,454,419
22400153,4,56,-1.0,-1.0714285714285714,413,357
22400153,4,10,0.0,0.0,356,346
22400153,4,32,2.0,3.75,346,314
22400153,4,292,-4.0,-0.821917808219178,292,0
22400154,1,241,6.0,1.4937759336099583,720,479
22400154,1,122,1.0,0.49180327868852464,479,357
22400154,1,34,0.0,0.0,357,323
22400154,1,72,0.0,0.0,314,242
22400154,1,95,-5.0,-3.1578947368421053,224,129
22400154,1,104,0.0,0.0,104,0
22400154,2,129,0.0,0.0,720,591
22400154,2,37,2.0,3.2432432432432434,573,536
22400154,2,28,3.0,6.428571428571428,524,496
22400154,2,10,0.0,0.0,485,475
22400154,2,7,0.0,0.0,464,457
22400154,2,50,-4.0,-4.8,442,392
22400154,2,92,0.0,0.0,380,288
22400154,2,55,6.0,6.545454545454545,288,233
22400154,2,137,5.0,2.18978102189781,220,83
22400154,2,12,-1.0,-5.0,83,71
22400154,2,71,-1.0,-0.8450704225352113,71,0
22400154,3,293,-7.0,-1.4334470989761092,720,427
22400154,3,45,3.0,4.0,427,382
22400154,3,273,-5.0,-1.098901098901099,380,107
22400154,3,75,0.0,0.0,94,19
22400154,3,1,0.0,0.0,1,0
22400154,4,231,-5.0,-1.2987012987012987,720,489
22400154,4,130,2.0,0.9230769230769231,473,343
22400154,4,108,2.0,1.1111111111111112,329,221
22400154,4,209,6.0,1.722488038277512,221,12
22400154,4,2,0.0,0.0,8,6
22400154,4,3,-3.0,-60.0,3,0
22400155,1,331,-4.0,-0.7250755287009063,720,389
22400155,1,43,0.0,0.0,376,333
22400155,1,54,2.0,2.2222222222222223,318,264
22400155,1,81,0.0,0.0,255,174
22400155,1,161,-6.0,-2.236024844720497,161,0
22400155,2,197,-2.0,-0.6091370558375634,720,523
22400155,2,57,0.0,0.0,509,452
22400155,2,77,-1.0,-0.7792207792207793,452,375
22400155,2,61,3.0,2.9508196721311473,370,309
22400155,2,105,-3.0,-1.7142857142857142,309,204
22400155,2,119,0.0,0.0,204,85
22400155,2,85,4.0,2.8235294117647056,85,0
22400155,3,52,0.0,0.0,720,668
22400155,3,222,-5.0,-1.3513513513513513,658,436
22400155,3,22,-1.0,-2.7272727272727275,436,414
22400155,3,48,-5.0,-6.25,406,358
22400155,3,93,1.0,0.6451612903225807,333,240
22400155,3,31,-1.0,-1.935483870967742,240,209
22400155,3,17,2.0,7.0588235294117645,209,192
22400155,3,151,3.0,1.1920529801324504,175,24
22400155,3,9,0.0,0.0,24,15
22400155,3,15,0.0,0.0,15,0
22400155,4,206,4.0,1.1650485436893203,720,514
22400155,4,35,-2.0,-3.4285714285714284,508,473
22400155,4,47,0.0,0.0,469,422
22400155,4,65,0.0,0.0,410,345
22400155,4,42,2.0,2.8571428571428568,345,303
22400155,4,68,0.0,0.0,292,224
22400155,4,18,-2.0,-6.666666666666666,224,206
22400155,4,94,3.0,1.9148936170212765,190,96
22400155,4,48,-3.0,-3.75,78,30
22400155,4,30,0.0,0.0,30,0
22400156,1,277,9.0,1.9494584837545124,720,443
22400156,1,132,-4.0,-1.8181818181818183,435,303
22400156,1,136,-1.0,-0.4411764705882353,281,145
22400156,1,83,3.0,2.1686746987951806,134,51
22400156,1,51,3.0,3.5294117647058822,51,0
22400156,2,281,1.0,0.21352313167259784,720,439
22400156,2,61,2.0,1.9672131147540985,430,369
22400156,2,78,-1.0,-0.7692307692307692,369,291
22400156,2,41,4.0,5.853658536585366,291,250
22400156,2,114,2.0,1.0526315789473684,250,136
22400156,2,19,-3.0,-9.473684210526315,136,117
22400156,2,117,0.0,0.0,117,0
22400156,3,373,4.0,0.6434316353887399,720,347
22400156,3,49,1.0,1.2244897959183672,332,283
22400156,3,85,-3.0,-2.1176470588235294,283,198
22400156,3,21,0.0,0.0,176,155
22400156,3,122,-4.0,-1.9672131147540985,155,33
22400156,3,22,0.0,0.0,22,0
22400156,4,101,4.0,2.376237623762376,720,619
22400156,4,24,0.0,0.0,619,595
22400156,4,122,1.0,0.49180327868852464,595,473
22400156,4,84,0.0,0.0,458,374
22400156,4,59,-3.0,-3.050847457627119,374,315
22400156,4,49,0.0,0.0,315,266
22400156,4,51,3.0,3.5294117647058822,250,199
22400156,4,36,0.0,0.0,199,163
22400156,4,163,5.0,1.8404907975460123,163,0
22400157,1,281,-3.0,-0.6405693950177936,720,439
22400157,1,13,-3.0,-13.846153846153847,425,412
22400157,1,118,2.0,1.0169491525423728,402,284
22400157,1,26,-3.0,-6.923076923076923,268,242
22400157,1,10,0.0,0.0,227,217
22400157,1,199,-2.0,-0.6030150753768845,199,0
22400157,2,143,8.0,3.3566433566433567,720,577
22400157,2,81,0.0,0.0,566,485
22400157,2,50,-10.0,-12.0,478,428
22400157,2,39,3.0,4.615384615384616,428,389
22400157,2,80,-3.0,-2.25,389,309
22400157,2,71,-5.0,-4.225352112676057,299,228
22400157,2,32,-1.0,-1.875,211,179
22400157,2,42,1.0,1.4285714285714284,174,132
22400157,2,7,-1.0,-8.571428571428571,108,101
22400157,3,303,-4.0,-0.7920792079207921,720,417
22400157,3,143,4.0,1.6783216783216783,330,187
22400157,3,187,-2.0,-0.6417112299465241,187,0
22400157,4,155,-3.0,-1.1612903225806452,720,565
22400157,4,51,-2.0,-2.3529411764705883,552,501
22400157,4,140,-4.0,-1.7142857142857142,492,352
22400157,4,99,3.0,1.8181818181818183,342,243
22400158,1,231,0.0,0.0,720,489
22400158,1,12,2.0,10.0,482,470
22400158,1,41,0.0,0.0,470,429
22400158,1,80,-2.0,-1.5,429,349
22400158,1,39,0.0,0.0,333,294
22400158,1,112,-2.0,-1.0714285714285714,281,169
22400158,2,116,2.0,1.0344827586206897,720,604
22400158,2,111,3.0,1.6216216216216217,594,483
22400158,2,85,0.0,0.0,471,386
22400158,2,80,0.0,0.0,370,290
22400158,2,1,0.0,0.0,276,275
22400158,2,22,0.0,0.0,275,253
22400158,2,46,0.0,0.0,243,197
22400158,2,70,-2.0,-1.7142857142857142,197,127
22400158,2,102,4.0,2.3529411764705883,127,25
22400158,2,2,0.0,0.0,2,0
22400158,3,242,4.0,0.9917355371900827,720,478
22400158,3,35,0.0,0.0,471,436
22400158,3,160,1.0,0.375,433,273
22400158,3,63,-1.0,-0.9523809523809523,263,200
22400158,3,107,0.0,0.0,200,93
22400158,3,70,0.0,0.0,77,7
22400158,3,7,0.0,0.0,7,0
22400158,4,72,-2.0,-1.6666666666666665,720,648
22400158,4,158,2.0,0.7594936708860759,648,490
22400158,4,30,0.0,0.0,478,448
22400158,4,70,-1.0,-0.8571428571428571,441,371
22400158,4,24,0.0,0.0,371,347
22400158,4,107,0.0,0.0,347,240
22400158,4,77,1.0,0.7792207792207793,222,145
22400158,4,22,0.0,0.0,29,7
22400158,4,3,0.0,0.0,7,4
22400159,1,251,0.0,0.0,720,469
22400159,1,87,-4.0,-2.7586206896551726,469,382
22400159,1,107,4.0,2.2429906542056073,366,259
22400159,1,10,0.0,0.0,246,236
22400159,1,10,2.0,12.0,229,219
22400159,1,36,3.0,5.0,209,173
22400159,1,32,-2.0,-3.75,158,126
22400159,1,40,-1.0,-1.5,116,76
22400159,1,75,1.0,0.8,76,1
22400159,2,117,3.0,1.5384615384615383,720,603
22400159,2,139,-4.0,-1.7266187050359714,603,464
22400159,2,88,-4.0,-2.7272727272727275,454,366
22400159,2,84,0.0,0.0,361,277
22400159,2,45,0.0,0.0,267,222
22400159,2,25,0.0,0.0,211,186
22400159,2,117,8.0,4.102564102564103,178,61
22400159,2,61,3.0,2.9508196721311473,61,0
22400159,3,386,-9.0,-1.3989637305699483,720,334
22400159,3,79,-3.0,-2.278481012658228,321,242
22400159,3,67,-4.0,-3.582089552238806,242,175
22400159,3,69,-4.0,-3.4782608695652173,175,106
22400159,3,69,-1.0,-0.8695652173913043,93,24
22400159,3,24,0.0,0.0,24,0
22400159,4,125,2.0,0.96,720,595
22400159,4,28,0.0,0.0,582,554
22400159,4,30,2.0,4.0,551,521
22400159,4,47,-1.0,-1.2765957446808511,497,450
22400159,4,32,0.0,0.0,450,418
22400159,4,11,0.0,0.0,418,407
22400159,4,45,0.0,0.0,384,339
22400159,4,106,1.0,0.5660377358490566,382,276
22400159,4,261,0.0,0.0,261,0
22400160,1,234,-1.0,-0.25641025641025644,720,486
22400160,1,62,2.0,1.935483870967742,480,418
22400160,1,112,-4.0,-2.142857142857143,396,284
22400160,1,156,5.0,1.923076923076923,284,128
22400160,1,78,1.0,0.7692307692307692,78,0
22400160,2,124,-3.0,-1.4516129032258065,720,596
22400160,2,13,0.0,0.0,587,574
22400160,2,113,-3.0,-1.592920353982301,574,461
22400160,2,47,1.0,1.2765957446808511,461,414
22400160,2,25,2.0,4.8,414,389
22400160,2,93,-6.0,-3.870967741935484,373,280
22400160,2,32,2.0,3.75,277,245
22400160,2,25,-1.0,-2.4,235,210
22400160,2,210,3.0,0.8571428571428571,210,0
22400160,3,148,3.0,1.2162162162162162,720,572
22400160,3,95,0.0,0.0,572,477
22400160,3,17,-1.0,-3.5294117647058822,468,451
22400160,3,65,0.0,0.0,451,386
22400160,3,32,2.0,3.75,371,339
22400160,3,24,-3.0,-7.5,335,311
22400160,3,18,1.0,3.333333333333333,311,293
22400160,3,66,4.0,3.6363636363636367,282,216
22400160,3,8,0.0,0.0,216,208
22400160,3,125,1.0,0.48,184,59
22400160,3,59,3.0,3.050847457627119,59,0
22400160,4,155,-5.0,-1.935483870967742,720,565
22400160,4,41,1.0,1.4634146341463414,552,511
22400160,4,52,1.0,1.153846153846154,511,459
22400160,4,65,-1.0,-0.9230769230769231,444,379
22400160,4,23,0.0,0.0,361,338
22400160,4,19,-1.0,-3.1578947368421053,323,304
22400160,4,46,-5.0,-6.521739130434782,304,258
22400160,4,52,0.0,0.0,239,187
22400160,4,154,5.0,1.9480519480519478,177,23
22400160,4,23,-2.0,-5.217391304347826,23,0
22400161,1,373,3.0,0.48257372654155495,720,347
22400161,1,116,2.0,1.0344827586206897,347,231
22400161,1,101,0.0,0.0,211,110
22400161,1,82,-2.0,-1.4634146341463414,110,28
22400161,1,28,0.0,0.0,28,0
22400161,2,196,8.0,2.4489795918367343,720,524
22400161,2,62,-1.0,-0.967741935483871,524,462
22400161,2,11,0.0,0.0,462,451
22400161,2,33,-3.0,-5.454545454545455,447,414
22400161,2,1,-1.0,-60.0,389,388
22400161,2,36,1.0,1.6666666666666665,388,352
22400161,2,111,2.0,1.0810810810810811,352,241
22400161,2,159,-1.0,-0.37735849056603776,222,63
22400161,2,39,-2.0,-3.0769230769230766,42,3
22400161,2,3,0.0,0.0,3,0
22400161,3,153,2.0,0.7843137254901961,720,567
22400161,3,294,4.0,0.8163265306122449,556,262
22400161,3,14,0.0,0.0,248,234
22400161,3,49,0.0,0.0,218,169
22400161,3,134,-1.0,-0.44776119402985076,169,35
22400161,3,24,0.0,0.0,24,0
22400161,4,92,-3.0,-1.9565217391304348,720,628
22400161,4,30,1.0,2.0,605,575
22400161,4,51,2.0,2.3529411764705883,575,524
22400161,4,60,-2.0,-2.0,501,441
22400161,4,113,0.0,0.0,441,328
22400161,4,270,7.0,1.5555555555555556,328,58
22400161,4,53,4.0,4.528301886792453,53,0
22400162,1,263,-1.0,-0.22813688212927757,720,457
22400162,1,72,-2.0,-1.6666666666666665,457,385
22400162,1,83,6.0,4.337349397590361,385,302
22400162,1,178,3.0,1.0112359550561798,300,122
22400162,1,12,0.0,0.0,115,103
22400162,1,85,0.0,0.0,85,0
22400162,2,149,7.0,2.8187919463087248,720,571
22400162,2,88,1.0,0.6818181818181819,545,457
22400162,2,58,2.0,2.0689655172413794,443,385
22400162,2,80,1.0,0.75,385,305
22400162,2,69,-1.0,-0.8695652173913043,290,221
22400162,2,57,0.0,0.0,214,157
22400162,2,102,1.0,0.5882352941176471,136,34
22400162,2,34,-2.0,-3.5294117647058822,34,0
22400162,3,226,-2.0,-0.5309734513274336,720,494
22400162,3,64,-1.0,-0.9375,484,420
22400162,3,52,4.0,4.615384615384616,420,368
22400162,3,175,3.0,1.0285714285714287,368,193
22400162,3,27,0.0,0.0,193,166
22400162,3,100,-7.0,-4.2,158,58
22400162,3,50,6.0,7.199999999999999,58,8
22400162,4,215,8.0,2.2325581395348837,720,505
22400162,4,66,2.0,1.8181818181818183,479,413
22400162,4,69,0.0,0.0,408,339
22400162,4,321,-7.0,-1.308411214953271,321,0
22400163,1,308,5.0,0.9740259740259739,720,412
22400163,1,17,0.0,0.0,403,386
22400163,1,42,1.0,1.4285714285714284,386,344
22400163,1,84,-2.0,-1.4285714285714284,344,260
22400163,1,18,0.0,0.0,260,242
22400163,1,26,-1.0,-2.307692307692308,227,201
22400163,1,81,1.0,0.7407407407407407,201,120
22400163,1,110,2.0,1.0909090909090908,110,0
22400163,2,101,3.0,1.782178217821782,720,619
22400163,2,109,-1.0,-0.5504587155963303,597,488
22400163,2,27,-2.0,-4.444444444444445,488,461
22400163,2,198,3.0,0.9090909090909092,445,247
22400163,2,55,0.0,0.0,232,177
22400163,2,14,1.0,4.285714285714286,160,146
22400163,2,93,-1.0,-0.6451612903225807,146,53
22400163,2,48,2.0,2.5,53,5
22400163,2,2,0.0,0.0,2,0
22400163,3,308,0.0,0.0,720,412
22400163,3,87,-3.0,-2.0689655172413794,412,325
22400163,3,32,2.0,3.75,325,293
22400163,3,22,0.0,0.0,276,254
22400163,3,206,10.0,2.912621359223301,241,35
22400163,4,110,-3.0,-1.6363636363636362,720,610
22400163,4,74,-7.0,-5.675675675675676,593,519
22400163,4,49,1.0,1.2244897959183672,519,470
22400163,4,277,3.0,0.6498194945848376,470,193
22400163,4,3,-1.0,-20.0,193,190
22400163,4,16,0.0,0.0,178,162
22400164,1,353,2.0,0.33994334277620397,720,367
22400164,1,119,4.0,2.0168067226890756,348,229
22400164,1,52,2.0,2.307692307692308,229,177
22400164,1,42,1.0,1.4285714285714284,159,117
22400164,1,72,-3.0,-2.5,117,45
22400164,1,45,0.0,0.0,45,0
22400164,2,121,3.0,1.487603305785124,720,599
22400164,2,130,-5.0,-2.307692307692308,599,469
22400164,2,9,0.0,0.0,445,436
22400164,2,56,-4.0,-4.285714285714286,417,361
22400164,2,136,-3.0,-1.323529411764706,356,220
22400164,2,204,5.0,1.4705882352941175,204,0
22400164,3,282,-5.0,-1.0638297872340425,720,438
22400164,3,100,0.0,0.0,427,327
22400164,3,104,-1.0,-0.576923076923077,327,223
22400164,3,73,3.0,2.4657534246575343,223,150
22400164,3,126,2.0,0.9523809523809523,126,0
22400164,4,143,0.0,0.0,720,577
22400164,4,31,-2.0,-3.870967741935484,576,545
22400164,4,94,-2.0,-1.2765957446808511,536,442
22400164,4,22,-2.0,-5.454545454545455,431,409
22400164,4,116,-3.0,-1.5517241379310345,409,293
22400164,4,13,0.0,0.0,287,274
22400164,4,161,-9.0,-3.3540372670807455,274,113
22400164,4,113,0.0,0.0,113,0
22400165,1,262,-10.0,-2.290076335877863,720,458
22400165,1,15,0.0,0.0,452,437
22400165,1,116,4.0,2.0689655172413794,420,304
22400165,1,66,0.0,0.0,304,238
22400165,1,17,-2.0,-7.0588235294117645,232,215
22400165,1,59,4.0,4.067796610169491,201,142
22400165,1,117,-3.0,-1.5384615384615383,118,1
22400165,1,1,0.0,0.0,1,0
22400165,2,255,4.0,0.9411764705882353,720,465
22400165,2,54,2.0,2.2222222222222223,452,398
22400165,2,119,3.0,1.5126050420168067,390,271
22400165,2,39,-1.0,-1.5384615384615383,271,232
22400165,2,52,0.0,0.0,232,180
22400165,2,175,0.0,0.0,180,5
22400165,3,182,-2.0,-0.6593406593406594,720,538
22400165,3,75,-2.0,-1.6,538,463
22400165,3,40,4.0,6.0,453,413
22400165,3,4,0.0,0.0,413,409
22400165,3,60,-1.0,-1.0,409,349
22400165,3,103,1.0,0.5825242718446602,336,233
22400165,3,88,-3.0,-2.0454545454545454,233,145
22400165,3,44,2.0,2.7272727272727275,135,91
22400165,3,44,5.0,6.818181818181818,81,37
22400165,3,24,0.0,0.0,24,0
22400165,4,242,-3.0,-0.743801652892562,720,478
22400165,4,42,-2.0,-2.8571428571428568,464,422
22400165,4,49,1.0,1.2244897959183672,422,373
22400165,4,88,-1.0,-0.6818181818181819,373,285
22400165,4,124,-4.0,-1.935483870967742,285,161
22400165,4,154,-1.0,-0.38961038961038963,154,0
22400166,1,256,0.0,0.0,720,464
22400166,1,109,-2.0,-1.1009174311926606,445,336
22400166,1,57,-3.0,-3.1578947368421053,336,279
22400166,1,47,-3.0,-3.829787234042553,277,230
22400166,1,53,0.0,0.0,211,158
22400166,1,35,0.0,0.0,143,108
22400166,1,68,3.0,2.647058823529412,108,40
22400166,2,60,0.0,0.0,720,660
22400166,2,92,0.0,0.0,660,568
22400166,2,59,-3.0,-3.050847457627119,568,509
22400166,2,41,4.0,5.853658536585366,500,459
22400166,2,46,-2.0,-2.608695652173913,446,400
22400166,2,118,-2.0,-1.0169491525423728,397,279
22400166,2,86,3.0,2.0930232558139537,275,189
22400166,2,173,0.0,0.0,180,7
22400166,3,244,-5.0,-1.2295081967213113,720,476
22400166,3,254,5.0,1.1811023622047243,460,206
22400166,3,62,2.0,1.935483870967742,198,136
22400166,3,58,-1.0,-1.0344827586206897,136,78
22400166,4,164,1.0,0.36585365853658536,720,556
22400166,4,45,-1.0,-1.3333333333333335,546,501
22400166,4,65,0.0,0.0,439,374
22400166,4,60,3.0,3.0,374,314
22400166,4,81,2.0,1.4814814814814814,314,233
22400166,4,534,5.0,0.5617977528089888,573,39
22400166,4,10,0.0,0.0,25,15
22400166,4,4,0.0,0.0,15,11
22400166,4,5,0.0,0.0,5,0
22400167,1,307,3.0,0.5863192182410423,720,413
22400167,1,64,5.0,4.6875,398,334
22400167,1,62,1.0,0.967741935483871,315,253
22400167,1,71,-1.0,-0.8450704225352113,251,180
22400167,1,160,-5.0,-1.875,160,0
22400167,2,43,-1.0,-1.3953488372093024,720,677
22400167,2,60,-5.0,-5.0,661,601
22400167,2,38,-1.0,-1.5789473684210527,591,553
22400167,2,54,-1.0,-1.1111111111111112,553,499
22400167,2,17,-1.0,-3.5294117647058822,485,468
22400167,2,56,4.0,4.285714285714286,468,412
22400167,2,58,2.0,2.0689655172413794,398,340
22400167,2,13,0.0,0.0,340,327
22400167,2,91,3.0,1.978021978021978,327,236
22400167,2,76,-1.0,-0.7894736842105263,218,142
22400167,2,98,-5.0,-3.0612244897959187,129,31
22400167,2,16,0.0,0.0,16,0
22400167,3,295,0.0,0.0,720,425
22400167,3,102,0.0,0.0,414,312
22400167,3,92,-1.0,-0.6521739130434783,291,199
22400167,3,43,0.0,0.0,186,143
22400167,3,19,0.0,0.0,143,124
22400167,3,98,0.0,0.0,124,26
22400167,3,26,0.0,0.0,26,0
22400167,4,129,-4.0,-1.8604651162790697,720,591
22400167,4,22,-2.0,-5.454545454545455,571,549
22400167,4,39,0.0,0.0,530,491
22400167,4,27,0.0,0.0,487,460
22400167,4,96,-3.0,-1.875,446,350
22400167,4,70,-1.0,-0.8571428571428571,340,270
22400167,4,69,2.0,1.7391304347826086,262,193
22400167,4,80,2.0,1.5,180,100
22400167,4,100,4.0,2.4,100,0
22400168,1,265,-5.0,-1.1320754716981132,720,455
22400168,1,109,-5.0,-2.7522935779816518,433,324
22400168,1,39,2.0,3.0769230769230766,312,273
22400168,1,51,-4.0,-4.705882352941177,273,222
22400168,1,138,-5.0,-2.1739130434782608,208,70
22400168,1,57,-5.0,-5.263157894736842,57,0
22400168,2,266,14.0,3.1578947368421053,720,454
22400168,2,61,2.0,1.9672131147540985,434,373
22400168,2,7,-1.0,-8.571428571428571,360,353
22400168,2,16,1.0,3.75,353,337
22400168,2,11,0.0,0.0,337,326
22400168,2,52,0.0,0.0,311,259
22400168,2,31,-2.0,-3.870967741935484,242,211
22400168,2,39,-2.0,-3.0769230769230766,198,159
22400168,2,131,4.0,1.83206106870229,155,24
22400168,3,325,-6.0,-1.1076923076923078,720,395
22400168,3,89,2.0,1.348314606741573,385,296
22400168,3,79,0.0,0.0,296,217
22400168,3,20,0.0,0.0,217,197
22400168,3,69,2.0,1.7391304347826086,197,128
22400168,3,128,7.0,3.28125,128,0
22400168,4,71,-1.0,-0.8450704225352113,720,649
22400168,4,192,7.0,2.1875,637,445
22400168,4,26,-1.0,-2.307692307692308,431,405
22400168,4,90,7.0,4.666666666666667,405,315
22400168,4,260,-2.0,-0.46153846153846156,315,55
22400168,4,52,2.0,2.307692307692308,52,0
22400169,1,258,-6.0,-1.3953488372093024,720,462
22400169,1,67,3.0,2.6865671641791042,433,366
22400169,1,97,-1.0,-0.6185567010309279,366,269
22400169,1,34,-2.0,-3.5294117647058822,263,229
22400169,1,103,3.0,1.7475728155339807,210,107
22400169,1,11,3.0,16.363636363636363,94,83
22400169,2,115,-5.0,-2.608695652173913,720,605
22400169,2,71,0.0,0.0,604,533
22400169,2,43,4.0,5.5813953488372094,519,476
22400169,2,82,0.0,0.0,459,377
22400169,2,29,0.0,0.0,370,341
22400169,2,85,0.0,0.0,313,228
22400169,2,53,0.0,0.0,213,160
22400169,2,44,2.0,2.7272727272727275,151,107
22400169,2,63,-3.0,-2.8571428571428568,107,44
22400169,2,41,0.0,0.0,44,3
22400169,3,327,3.0,0.5504587155963303,720,393
22400169,3,59,0.0,0.0,393,334
22400169,3,35,-2.0,-3.4285714285714284,322,287
22400169,3,94,1.0,0.6382978723404256,271,177
22400169,3,17,1.0,3.5294117647058822,177,160
22400169,3,160,-4.0,-1.5,160,0
22400169,4,56,2.0,2.142857142857143,720,664
22400169,4,47,0.0,0.0,654,607
22400169,4,2,0.0,0.0,599,597
22400169,4,193,-5.0,-1.5544041450777202,587,394
22400169,4,43,1.0,1.3953488372093024,388,345
22400169,4,35,-2.0,-3.4285714285714284,331,296
22400169,4,33,2.0,3.6363636363636367,281,248
22400169,4,174,3.0,1.0344827586206897,242,68
22400169,4,44,5.0,6.818181818181818,68,24
22400169,4,9,-2.0,-13.333333333333332,15,6
22400169,4,3,2.0,40.0,3,0
22400170,1,366,4.0,0.6557377049180327,720,354
22400170,1,52,1.0,1.153846153846154,339,287
22400170,1,73,0.0,0.0,287,214
22400170,1,44,1.0,1.3636363636363638,213,169
22400170,1,19,-1.0,-3.1578947368421053,158,139
22400170,1,80,1.0,0.75,139,59
22400170,1,59,3.0,3.050847457627119,59,0
22400170,2,94,3.0,1.9148936170212765,720,626
22400170,2,26,0.0,0.0,619,593
22400170,2,106,-5.0,-2.8301886792452833,570,464
22400170,2,69,-2.0,-1.7391304347826086,445,376
22400170,2,41,-2.0,-2.926829268292683,367,326
22400170,2,253,-7.0,-1.6600790513833992,312,59
22400170,2,18,0.0,0.0,58,40
22400170,2,38,2.0,3.1578947368421053,38,0
22400170,3,298,3.0,0.6040268456375839,720,422
22400170,3,45,-1.0,-1.3333333333333335,422,377
22400170,3,69,-1.0,-0.8695652173913043,367,298
22400170,3,25,1.0,2.4,298,273
22400170,3,78,0.0,0.0,273,195
22400170,3,57,3.0,3.1578947368421053,184,127
22400170,3,16,-2.0,-7.5,124,108
22400170,3,104,-2.0,-1.153846153846154,104,0
22400170,4,128,2.0,0.9375,720,592
22400170,4,18,-1.0,-3.333333333333333,580,562
22400170,4,135,4.0,1.777777777777778,562,427
22400170,4,33,2.0,3.6363636363636367,427,394
22400170,4,52,4.0,4.615384615384616,394,342
22400170,4,93,0.0,0.0,323,230
22400170,4,178,-3.0,-1.0112359550561798,209,31
22400170,4,14,0.0,0.0,30,16
22400170,4,4,0.0,0.0,14,10
22400171,1,321,4.0,0.7476635514018691,720,399
22400171,1,30,-1.0,-2.0,384,354
22400171,1,18,0.0,0.0,354,336
22400171,1,27,-1.0,-2.2222222222222223,171,144
22400171,1,80,3.0,2.25,126,46
22400171,1,32,0.0,0.0,32,0
22400171,2,158,1.0,0.37974683544303794,720,562
22400171,2,92,-1.0,-0.6521739130434783,556,464
22400171,2,81,-2.0,-1.4814814814814814,446,365
22400171,2,57,-8.0,-8.421052631578947,349,292
22400171,2,54,-3.0,-3.333333333333333,277,223
22400171,2,30,3.0,6.0,221,191
22400171,2,30,0.0,0.0,182,152
22400171,3,385,4.0,0.6233766233766234,720,335
22400171,3,117,-4.0,-2.0512820512820515,324,207
22400171,3,46,0.0,0.0,196,150
22400171,3,121,-3.0,-1.487603305785124,150,29
22400171,3,29,0.0,0.0,29,0
22400171,4,123,5.0,2.4390243902439024,720,597
22400171,4,108,-3.0,-1.6666666666666665,584,476
22400171,4,223,3.0,0.8071748878923767,476,253
22400171,4,230,3.0,0.7826086956521738,245,15
22400171,4,13,0.0,0.0,13,0
22400172,1,279,9.0,1.935483870967742,720,441
22400172,1,65,-2.0,-1.8461538461538463,423,358
22400172,1,4,0.0,0.0,339,335
22400172,1,83,-4.0,-2.891566265060241,320,237
22400172,1,45,0.0,0.0,212,167
22400172,1,72,-1.0,-0.8333333333333333,89,17
22400172,2,282,-9.0,-1.9148936170212765,720,438
22400172,2,56,0.0,0.0,424,368
22400172,2,72,1.0,0.8333333333333333,351,279
22400172,2,137,-3.0,-1.3138686131386863,264,127
22400172,2,51,-1.0,-1.1764705882352942,119,68
22400172,2,68,-5.0,-4.411764705882353,68,0
22400172,3,308,5.0,0.9740259740259739,720,412
22400172,3,62,-4.0,-3.870967741935484,406,344
22400172,3,69,4.0,3.4782608695652173,344,275
22400172,3,13,0.0,0.0,275,262
22400172,3,93,0.0,0.0,251,158
22400172,4,195,3.0,0.9230769230769231,720,525
22400172,4,32,2.0,3.75,525,493
22400172,4,86,3.0,2.0930232558139537,483,397
22400172,4,46,-2.0,-2.608695652173913,374,328
22400172,4,70,-3.0,-2.5714285714285716,328,258
22400172,4,199,-6.0,-1.809045226130653,245,46
22400172,4,19,2.0,6.315789473684211,35,16
22400172,4,5,0.0,0.0,16,11
22400172,4,11,-2.0,-10.90909090909091,11,0
22400173,1,390,5.0,0.7692307692307692,720,330
22400173,1,65,2.0,1.8461538461538463,318,253
22400173,1,58,5.0,5.172413793103448,248,190
22400173,1,39,0.0,0.0,180,141
22400173,1,141,1.0,0.425531914893617,141,0
22400173,2,245,5.0,1.2244897959183672,720,475
22400173,2,28,-2.0,-4.285714285714286,458,430
22400173,2,27,3.0,6.666666666666666,425,398
22400173,2,231,-2.0,-0.5194805194805194,386,155
22400173,3,229,-5.0,-1.3100436681222707,720,491
22400173,3,128,-2.0,-0.9375,484,356
22400173,3,140,1.0,0.42857142857142855,346,206
22400173,3,33,-2.0,-3.6363636363636367,189,156
22400173,3,3,2.0,40.0,156,153
22400173,4,115,1.0,0.5217391304347826,720,605
22400173,4,80,2.0,1.5,582,502
22400173,4,10,1.0,6.0,502,492
22400173,4,87,0.0,0.0,492,405
22400173,4,77,1.0,0.7792207792207793,393,316
22400173,4,7,0.0,0.0,316,309
22400173,4,171,1.0,0.3508771929824561,296,125
22400173,4,125,-1.0,-0.48,125,0
22400174,1,249,4.0,0.9638554216867469,720,471
22400174,1,128,1.0,0.46875,446,318
22400174,1,63,-2.0,-1.9047619047619047,318,255
22400174,1,24,0.0,0.0,255,231
22400174,1,93,2.0,1.2903225806451615,219,126
22400174,1,120,2.0,1.0,120,0
22400174,2,180,-4.0,-1.3333333333333335,720,540
22400174,2,93,2.0,1.2903225806451615,540,447
22400174,2,35,-1.0,-1.7142857142857142,444,409
22400174,2,76,1.0,0.7894736842105263,409,333
22400174,2,96,-4.0,-2.5,333,237
22400174,2,58,-1.0,-1.0344827586206897,237,179
22400174,2,48,-2.0,-2.5,179,131
22400174,2,81,4.0,2.962962962962963,118,37
22400174,2,28,0.0,0.0,33,5
22400174,2,2,0.0,0.0,2,0
22400174,3,249,2.0,0.48192771084337344,720,471
22400174,3,117,5.0,2.5641025641025643,471,354
22400174,3,84,3.0,2.142857142857143,354,270
22400174,3,63,-1.0,-0.9523809523809523,270,207
22400174,3,78,-2.0,-1.5384615384615383,191,113
22400174,3,106,4.0,2.2641509433962264,106,0
22400174,4,137,7.0,3.065693430656934,720,583
22400174,4,97,-2.0,-1.2371134020618557,572,475
22400174,4,21,2.0,5.7142857142857135,475,454
22400174,4,82,-1.0,-0.7317073170731707,442,360
22400174,4,24,2.0,5.0,360,336
22400174,4,44,1.0,1.3636363636363638,319,275
22400174,4,147,1.0,0.40816326530612246,263,116
22400174,4,100,-1.0,-0.6,100,0
22400175,1,211,0.0,0.0,720,509
22400175,1,63,5.0,4.761904761904762,502,439
22400175,1,107,6.0,3.364485981308411,426,319
22400175,1,67,2.0,1.791044776119403,319,252
22400175,1,93,0.0,0.0,245,152
22400175,1,152,-3.0,-1.1842105263157894,152,0
22400175,2,47,3.0,3.829787234042553,720,673
22400175,2,43,0.0,0.0,667,624
22400175,2,90,-4.0,-2.666666666666667,606,516
22400175,2,97,1.0,0.6185567010309279,504,407
22400175,2,77,-1.0,-0.7792207792207793,399,322
22400175,2,145,-6.0,-2.4827586206896552,311,166
22400175,2,16,0.0,0.0,166,150
22400175,2,122,3.0,1.4754098360655736,135,13
22400175,2,1,0.0,0.0,1,0
22400175,3,23,0.0,0.0,720,697
22400175,3,145,-9.0,-3.7241379310344827,697,552
22400175,3,147,-1.0,-0.40816326530612246,532,385
22400175,3,10,0.0,0.0,385,375
22400175,3,95,0.0,0.0,371,276
22400175,3,107,-8.0,-4.485981308411215,276,169
22400175,3,153,2.0,0.7843137254901961,160,7
22400175,4,35,0.0,0.0,720,685
22400175,4,142,3.0,1.267605633802817,685,543
22400175,4,64,1.0,0.9375,526,462
22400175,4,109,0.0,0.0,451,342
22400175,4,37,-2.0,-3.2432432432432434,330,293
22400175,4,205,0.0,0.0,275,70
22400175,4,29,0.0,0.0,70,41
22400175,4,41,-2.0,-2.926829268292683,41,0
22400176,1,321,8.0,1.4953271028037383,720,399
22400176,1,115,2.0,1.0434782608695652,386,271
22400176,1,23,2.0,5.217391304347826,271,248
22400176,1,58,-4.0,-4.137931034482759,241,183
22400176,1,70,-6.0,-5.142857142857143,183,113
22400176,1,102,5.0,2.941176470588235,102,0
22400176,2,187,3.0,0.9625668449197862,720,533
22400176,2,19,0.0,0.0,533,514
22400176,2,40,3.0,4.5,510,470
22400176,2,115,-9.0,-4.695652173913044,470,355
22400176,2,81,4.0,2.962962962962963,346,265
22400176,2,70,0.0,0.0,251,181
22400176,2,72,3.0,2.5,173,101
22400176,2,101,-3.0,-1.782178217821782,101,0
22400176,3,135,6.0,2.666666666666667,720,585
22400176,3,174,2.0,0.6896551724137931,574,400
22400176,3,24,2.0,5.0,359,335
22400176,3,63,-3.0,-2.8571428571428568,327,264
22400176,3,30,3.0,6.0,264,234
22400176,3,99,0.0,0.0,234,135
22400176,3,14,0.0,0.0,135,121
22400176,3,113,-1.0,-0.5309734513274336,113,0
22400176,4,67,1.0,0.8955223880597015,720,653
22400176,4,51,4.0,4.705882352941177,643,592
22400176,4,23,0.0,0.0,582,559
22400176,4,75,-2.0,-1.6,553,478
22400176,4,10,1.0,6.0,466,456
22400176,4,12,-2.0,-10.0,456,444
22400176,4,67,3.0,2.6865671641791042,444,377
22400176,4,73,4.0,3.287671232876712,365,292
22400176,4,82,-3.0,-2.195121951219512,292,210
22400176,4,210,-5.0,-1.4285714285714284,210,0
22400177,1,434,-2.0,-0.2764976958525346,720,286
22400177,1,66,3.0,2.7272727272727275,286,220
22400177,1,41,-2.0,-2.926829268292683,214,173
22400177,1,144,0.0,0.0,163,19
22400177,1,19,0.0,0.0,19,0
22400177,2,175,-1.0,-0.34285714285714286,720,545
22400177,2,96,-4.0,-2.5,521,425
22400177,2,46,-2.0,-2.608695652173913,410,364
22400177,2,47,-3.0,-3.829787234042553,364,317
22400177,2,17,1.0,3.5294117647058822,307,290
22400177,2,87,0.0,0.0,290,203
22400177,2,159,-4.0,-1.509433962264151,194,35
22400177,3,417,1.0,0.14388489208633093,720,303
22400177,3,94,9.0,5.74468085106383,294,200
22400177,3,76,0.0,0.0,200,124
22400177,3,27,-1.0,-2.2222222222222223,116,89
22400177,3,31,0.0,0.0,89,58
22400177,3,50,-3.0,-3.5999999999999996,50,0
22400177,4,132,3.0,1.3636363636363638,720,588
22400177,4,59,-2.0,-2.0338983050847457,582,523
22400177,4,11,-1.0,-5.454545454545455,511,500
22400177,4,34,0.0,0.0,500,466
22400177,4,15,0.0,0.0,446,431
22400177,4,35,0.0,0.0,431,396
22400177,4,82,4.0,2.926829268292683,389,307
22400177,4,240,2.0,0.5,283,43
22400177,4,409,0.0,0.0,523,114
22400177,4,12,-2.0,-10.0,27,15
22400178,1,316,-3.0,-0.569620253164557,720,404
22400178,1,129,4.0,1.8604651162790697,401,272
22400178,1,52,0.0,0.0,259,207
22400178,1,71,1.0,0.8450704225352113,207,136
22400178,1,123,-3.0,-1.4634146341463414,123,0
22400178,2,183,1.0,0.32786885245901637,720,537
22400178,2,54,0.0,0.0,537,483
22400178,2,49,-2.0,-2.4489795918367343,467,418
22400178,2,106,4.0,2.2641509433962264,418,312
22400178,2,58,0.0,0.0,312,254
22400178,2,31,-2.0,-3.870967741935484,254,223
22400178,2,45,0.0,0.0,223,178
22400178,2,80,-1.0,-0.75,178,98
22400178,3,382,-4.0,-0.6282722513089005,720,338
22400178,3,148,-8.0,-3.2432432432432434,329,181
22400178,3,32,2.0,3.75,174,142
22400178,3,112,7.0,3.75,119,7
22400178,4,83,-1.0,-0.7228915662650602,720,637
22400178,4,64,0.0,0.0,624,560
22400178,4,9,0.0,0.0,558,549
22400178,4,68,2.0,1.7647058823529411,549,481
22400178,4,131,3.0,1.3740458015267176,464,333
22400178,4,59,-3.0,-3.050847457627119,333,274
22400178,4,229,6.0,1.5720524017467248,273,44
22400178,4,11,-2.0,-10.90909090909091,44,33
22400178,4,17,2.0,7.0588235294117645,33,16
22400178,4,3,0.0,0.0,10,7
22400179,1,323,-5.0,-0.9287925696594427,720,397
22400179,1,26,0.0,0.0,389,363
22400179,1,79,0.0,0.0,363,284
22400179,1,46,-2.0,-2.608695652173913,276,230
22400179,1,46,-2.0,-2.608695652173913,230,184
22400179,1,99,0.0,0.0,184,85
22400179,1,75,1.0,0.8,75,0
22400179,2,154,0.0,0.0,720,566
22400179,2,60,4.0,4.0,550,490
22400179,2,97,-1.0,-0.6185567010309279,480,383
22400179,2,141,-3.0,-1.2765957446808511,383,242
22400179,2,76,5.0,3.9473684210526314,237,161
22400179,2,120,-1.0,-0.5,147,27
22400179,2,27,0.0,0.0,27,0
22400179,3,287,5.0,1.0452961672473866,720,433
22400179,3,198,-3.0,-0.9090909090909092,419,221
22400179,3,19,2.0,6.315789473684211,203,184
22400179,3,134,8.0,3.582089552238806,134,0
22400179,4,144,3.0,1.25,720,576
22400179,4,28,-3.0,-6.428571428571428,565,537
22400179,4,25,-2.0,-4.8,526,501
22400179,4,15,0.0,0.0,485,470
22400179,4,53,1.0,1.1320754716981132,455,402
22400179,4,146,0.0,0.0,390,244
22400179,4,16,0.0,0.0,233,217
22400179,4,4,0.0,0.0,206,202
22400179,4,191,-9.0,-2.8272251308900525,191,0
22400180,1,375,-1.0,-0.16,720,345
22400180,1,182,-4.0,-1.3186813186813189,339,157
22400180,1,75,3.0,2.4,157,82
22400180,1,4,-2.0,-30.0,6,2
22400180,2,126,-4.0,-1.9047619047619047,720,594
22400180,2,71,1.0,0.8450704225352113,577,506
22400180,2,50,3.0,3.5999999999999996,498,448
22400180,2,29,2.0,4.137931034482759,425,396
22400180,2,67,0.0,0.0,375,308
22400180,2,105,1.0,0.5714285714285715,308,203
22400180,2,123,3.0,1.4634146341463414,203,80
22400180,2,80,2.0,1.5,80,0
22400180,3,203,-5.0,-1.477832512315271,720,517
22400180,3,161,-8.0,-2.981366459627329,517,356
22400180,3,25,4.0,9.6,356,331
22400180,3,82,-1.0,-0.7317073170731707,309,227
22400180,3,81,1.0,0.7407407407407407,219,138
22400180,3,69,-2.0,-1.7391304347826086,138,69
22400180,3,60,-2.0,-2.0,69,9
22400180,4,159,6.0,2.2641509433962264,720,561
22400180,4,69,0.0,0.0,561,492
22400180,4,31,-1.0,-1.935483870967742,492,461
22400180,4,41,0.0,0.0,461,420
22400180,4,45,3.0,4.0,413,368
22400180,4,198,6.0,1.8181818181818183,350,152
22400180,4,67,2.0,1.791044776119403,135,68
22400180,4,50,0.0,0.0,50,0
22400181,1,440,8.0,1.0909090909090908,720,280
22400181,1,41,0.0,0.0,260,219
22400181,1,29,-3.0,-6.206896551724138,195,166
22400181,1,150,0.0,0.0,150,0
22400181,2,104,3.0,1.7307692307692308,720,616
22400181,2,30,6.0,12.0,611,581
22400181,2,47,-2.0,-2.5531914893617023,571,524
22400181,2,49,-4.0,-4.897959183673469,518,469
22400181,2,105,1.0,0.5714285714285715,443,338
22400181,2,42,3.0,4.285714285714286,338,296
22400181,2,32,2.0,3.75,287,255
22400181,2,37,1.0,1.6216216216216217,241,204
22400181,2,17,0.0,0.0,204,187
22400181,2,67,1.0,0.8955223880597015,177,110
22400181,3,245,-3.0,-0.7346938775510203,720,475
22400181,3,101,-1.0,-0.594059405940594,458,357
22400181,3,20,2.0,6.0,344,324
22400181,3,26,-1.0,-2.307692307692308,315,289
22400181,3,71,-1.0,-0.8450704225352113,289,218
22400181,3,125,0.0,0.0,210,85
22400181,4,161,-2.0,-0.7453416149068323,720,559
22400181,4,36,-1.0,-1.6666666666666665,559,523
22400181,4,48,-6.0,-7.5,407,359
22400181,4,244,-10.0,-2.4590163934426226,352,108
22400181,4,92,1.0,0.6521739130434783,92,0
22400182,1,326,9.0,1.656441717791411,720,394
22400182,1,114,2.0,1.0526315789473684,379,265
22400182,1,190,0.0,0.0,265,75
22400182,1,75,-6.0,-4.8,75,0
22400182,2,149,-4.0,-1.610738255033557,720,571
22400182,2,58,-2.0,-2.0689655172413794,571,513
22400182,2,9,0.0,0.0,501,492
22400182,2,94,8.0,5.1063829787234045,486,392
22400182,2,22,1.0,2.7272727272727275,366,344
22400182,2,14,0.0,0.0,344,330
22400182,2,30,2.0,4.0,316,286
22400182,2,286,-5.0,-1.048951048951049,286,0
22400182,3,383,5.0,0.7832898172323759,720,337
22400182,3,45,3.0,4.0,325,280
22400182,3,78,6.0,4.615384615384616,280,202
22400182,3,107,5.0,2.803738317757009,184,77
22400182,3,34,0.0,0.0,77,43
22400182,3,24,-2.0,-5.0,34,10
22400182,3,10,0.0,0.0,10,0
22400182,4,191,5.0,1.5706806282722514,720,529
22400182,4,77,4.0,3.116883116883117,529,452
22400182,4,21,1.0,2.8571428571428568,430,409
22400182,4,156,1.0,0.3846153846153846,409,253
22400182,4,48,3.0,3.75,253,205
22400182,4,162,-1.0,-0.37037037037037035,162,0
22400183,1,359,-4.0,-0.6685236768802229,720,361
22400183,1,127,5.0,2.3622047244094486,339,212
22400183,1,88,0.0,0.0,106,18
22400183,1,1,0.0,0.0,1,0
22400183,2,142,0.0,0.0,720,578
22400183,2,33,-1.0,-1.8181818181818183,566,533
22400183,2,95,0.0,0.0,517,422
22400183,2,103,6.0,3.4951456310679614,422,319
22400183,2,125,0.0,0.0,303,178
22400183,2,164,-6.0,-2.195121951219512,165,1
22400183,3,286,1.0,0.2097902097902098,720,434
22400183,3,145,5.0,2.0689655172413794,434,289
22400183,3,32,-2.0,-3.75,270,238
22400183,3,41,3.0,4.390243902439024,223,182
22400183,3,50,0.0,0.0,155,105
22400183,3,13,1.0,4.615384615384616,105,92
22400183,3,92,1.0,0.6521739130434783,92,0
22400183,4,38,-1.0,-1.5789473684210527,720,682
22400183,4,77,-3.0,-2.3376623376623376,682,605
22400183,4,47,-3.0,-3.829787234042553,593,546
22400183,4,50,2.0,2.4,518,468
22400183,4,33,-2.0,-3.6363636363636367,468,435
22400183,4,115,1.0,0.5217391304347826,423,308
22400183,4,23,1.0,2.608695652173913,277,254
22400183,4,167,2.0,0.718562874251497,245,78
22400183,4,25,2.0,4.8,53,28
22400183,4,28,0.0,0.0,28,0
22400184,1,251,3.0,0.7171314741035857,720,469
22400184,1,70,0.0,0.0,459,389
22400184,1,109,3.0,1.651376146788991,383,274
22400184,1,7,0.0,0.0,262,255
22400184,1,85,7.0,4.9411764705882355,232,147
22400184,1,31,-2.0,-3.870967741935484,133,102
22400184,1,16,-1.0,-3.75,102,86
22400184,2,147,0.0,0.0,720,573
22400184,2,22,-2.0,-5.454545454545455,556,534
22400184,2,13,0.0,0.0,534,521
22400184,2,16,0.0,0.0,498,482
22400184,2,10,-2.0,-12.0,468,458
22400184,2,136,4.0,1.7647058823529411,435,299
22400184,2,82,0.0,0.0,286,204
22400184,2,44,0.0,0.0,195,151
22400184,2,89,-3.0,-2.0224719101123596,124,35
22400184,2,28,-1.0,-2.142857142857143,30,2
22400184,2,2,0.0,0.0,2,0
22400184,3,183,-12.0,-3.934426229508197,720,537
22400184,3,54,-2.0,-2.2222222222222223,537,483
22400184,3,58,0.0,0.0,483,425
22400184,3,47,-1.0,-1.2765957446808511,413,366
22400184,3,55,6.0,6.545454545454545,366,311
22400184,3,70,3.0,2.5714285714285716,292,222
22400184,3,75,3.0,2.4,222,147
22400184,3,65,4.0,3.6923076923076925,147,82
22400184,4,142,-5.0,-2.1126760563380285,720,578
22400184,4,71,2.0,1.6901408450704225,566,495
22400184,4,31,-2.0,-3.870967741935484,479,448
22400184,4,8,1.0,7.5,426,418
22400184,4,104,4.0,2.307692307692308,418,314
22400184,4,170,9.0,3.176470588235294,301,131
22400184,4,26,0.0,0.0,100,74
22400184,4,63,0.0,0.0,63,0
22400185,1,381,9.0,1.4173228346456692,720,339
22400185,1,2,0.0,0.0,282,280
22400185,1,83,5.0,3.6144578313253013,280,197
22400185,1,89,-5.0,-3.3707865168539324,190,101
22400185,1,101,6.0,3.564356435643564,101,0
22400185,2,67,2.0,1.791044776119403,720,653
22400185,2,90,4.0,2.666666666666667,653,563
22400185,2,71,-1.0,-0.8450704225352113,542,471
22400185,2,10,0.0,0.0,471,461
22400185,2,14,0.0,0.0,452,438
22400185,2,24,-2.0,-5.0,426,402
22400185,2,47,-2.0,-2.5531914893617023,386,339
22400185,2,84,-2.0,-1.4285714285714284,295,211
22400185,3,218,-3.0,-0.8256880733944955,720,502
22400185,3,119,1.0,0.5042016806722689,502,383
22400185,3,11,1.0,5.454545454545455,378,367
22400185,3,108,-7.0,-3.888888888888889,367,259
22400185,3,10,2.0,12.0,251,241
22400185,3,35,0.0,0.0,241,206
22400185,3,32,-2.0,-3.75,194,162
22400185,3,100,-1.0,-0.6,162,62
22400185,3,50,1.0,1.2,62,12
22400185,3,1,0.0,0.0,1,0
22400185,4,120,-4.0,-2.0,720,600
22400185,4,95,-5.0,-3.1578947368421053,444,349
22400185,4,198,-1.0,-0.30303030303030304,349,151
22400185,4,139,-5.0,-2.158273381294964,151,12
22400186,1,293,6.0,1.2286689419795223,720,427
22400186,1,115,4.0,2.0869565217391304,422,307
22400186,1,100,3.0,1.7999999999999998,295,195
22400186,1,115,2.0,1.0434782608695652,195,80
22400186,1,5,3.0,36.0,71,66
22400186,1,52,-5.0,-5.769230769230769,52,0
22400186,2,157,3.0,1.1464968152866242,720,563
22400186,2,49,-1.0,-1.2244897959183672,555,506
22400186,2,8,-2.0,-15.0,506,498
22400186,2,116,6.0,3.103448275862069,498,382
22400186,2,53,2.0,2.2641509433962264,367,314
22400186,2,38,0.0,0.0,304,266
22400186,2,248,-14.0,-3.3870967741935485,248,0
22400186,3,278,3.0,0.6474820143884893,720,442
22400186,3,80,-4.0,-3.0,420,340
22400186,3,77,0.0,0.0,340,263
22400186,3,79,-3.0,-2.278481012658228,252,173
22400186,3,60,3.0,3.0,173,113
22400186,3,93,0.0,0.0,98,5
22400186,3,5,0.0,0.0,5,0
22400186,4,206,5.0,1.4563106796116505,720,514
22400186,4,186,3.0,0.967741935483871,499,313
22400186,4,42,2.0,2.8571428571428568,299,257
22400186,4,61,1.0,0.9836065573770493,243,182
22400186,4,49,0.0,0.0,182,133
22400186,4,128,3.0,1.40625,128,0
22400187,1,352,-12.0,-2.0454545454545454,720,368
22400187,1,20,-2.0,-6.0,242,222
22400187,1,97,-4.0,-2.4742268041237114,220,123
22400187,1,97,8.0,4.948453608247423,116,19
22400187,2,184,-1.0,-0.32608695652173914,720,536
22400187,2,9,0.0,0.0,503,494
22400187,2,104,0.0,0.0,494,390
22400187,2,125,3.0,1.44,378,253
22400187,2,43,0.0,0.0,240,197
22400187,2,12,-1.0,-5.0,193,181
22400187,2,181,5.0,1.6574585635359116,181,0
22400187,3,308,-5.0,-0.9740259740259739,720,412
22400187,3,91,3.0,1.978021978021978,338,247
22400187,3,247,1.0,0.24291497975708504,247,0
22400187,4,203,-2.0,-0.5911330049261084,720,517
22400187,4,34,2.0,3.5294117647058822,511,477
22400187,4,55,-2.0,-2.1818181818181817,466,411
22400187,4,67,1.0,0.8955223880597015,397,330
22400187,4,211,4.0,1.137440758293839,313,102
22400187,4,95,0.0,0.0,102,7
22400187,4,6,0.0,0.0,6,0
22400187,5,135,-1.0,-0.4444444444444445,300,165
22400187,5,154,2.0,0.7792207792207793,165,11
22400187,5,11,-1.0,-5.454545454545455,11,0
22400188,1,339,12.0,2.1238938053097343,720,381
22400188,1,78,0.0,0.0,367,289
22400188,1,86,0.0,0.0,289,203
22400188,1,185,0.0,0.0,185,0
22400188,2,115,0.0,0.0,720,605
22400188,2,51,6.0,7.0588235294117645,605,554
22400188,2,13,1.0,4.615384615384616,546,533
22400188,2,102,1.0,0.5882352941176471,533,431
22400188,2,74,7.0,5.675675675675676,414,340
22400188,2,190,6.0,1.8947368421052633,298,108
22400188,2,108,2.0,1.1111111111111112,108,0
22400188,3,390,-5.0,-0.7692307692307692,720,330
22400188,3,88,0.0,0.0,330,242
22400188,3,76,-1.0,-0.7894736842105263,225,149
22400188,3,137,-7.0,-3.065693430656934,137,0
22400188,4,50,-1.0,-1.2,720,670
22400188,4,85,-5.0,-3.5294117647058822,670,585
22400188,4,75,-2.0,-1.6,579,504
22400188,4,76,-2.0,-1.5789473684210527,504,428
22400188,4,136,-2.0,-0.8823529411764706,420,284
22400188,4,74,8.0,6.486486486486487,280,206
22400188,4,72,-1.0,-0.8333333333333333,191,119
22400189,1,350,5.0,0.8571428571428571,720,370
22400189,1,36,2.0,3.333333333333333,362,326
22400189,1,124,1.0,0.4838709677419355,326,202
22400189,1,82,0.0,0.0,202,120
22400189,1,62,0.0,0.0,120,58
22400189,1,58,-4.0,-4.137931034482759,58,0
22400189,2,149,2.0,0.8053691275167785,720,571
22400189,2,155,8.0,3.096774193548387,557,402
22400189,2,93,2.0,1.2903225806451615,306,213
22400189,2,136,-2.0,-0.8823529411764706,213,77
22400189,2,73,2.0,1.643835616438356,73,0
22400189,3,472,-2.0,-0.2542372881355932,720,248
22400189,3,133,2.0,0.9022556390977443,242,109
22400189,3,96,2.0,1.25,96,0
22400189,4,127,7.0,3.3070866141732282,720,593
22400189,4,75,4.0,3.2,578,503
22400189,4,123,-2.0,-0.9756097560975611,491,368
22400189,4,76,-2.0,-1.5789473684210527,368,292
22400189,4,88,3.0,2.0454545454545454,282,194
22400189,4,182,-4.0,-1.3186813186813189,182,0
22400190,1,279,1.0,0.21505376344086022,720,441
22400190,1,49,-7.0,-8.571428571428571,429,380
22400190,1,196,1.0,0.3061224489795918,380,184
22400190,1,24,0.0,0.0,184,160
22400190,1,50,-6.0,-7.199999999999999,149,99
22400190,1,85,-1.0,-0.7058823529411764,85,0
22400190,2,163,1.0,0.36809815950920244,720,557
22400190,2,153,1.0,0.39215686274509803,557,404
22400190,2,82,0.0,0.0,401,319
22400190,2,16,0.0,0.0,319,303
22400190,2,97,2.0,1.2371134020618557,292,195
22400190,2,11,0.0,0.0,183,172
22400190,2,49,3.0,3.673469387755102,167,118
22400190,2,36,-2.0,-3.333333333333333,105,69
22400190,2,52,1.0,1.153846153846154,52,0
22400190,3,167,8.0,2.874251497005988,720,553
22400190,3,155,3.0,1.1612903225806452,547,392
22400190,3,33,0.0,0.0,374,341
22400190,3,5,0.0,0.0,323,318
22400190,3,8,-4.0,-30.0,307,299
22400190,3,71,-2.0,-1.6901408450704225,299,228
22400190,3,40,-1.0,-1.5,228,188
22400190,3,29,0.0,0.0,188,159
22400190,3,18,0.0,0.0,159,141
22400190,3,141,0.0,0.0,141,0
22400190,4,39,2.0,3.0769230769230766,720,681
22400190,4,103,6.0,3.4951456310679614,681,578
22400190,4,61,0.0,0.0,567,506
22400190,4,34,2.0,3.5294117647058822,493,459
22400190,4,87,-2.0,-1.3793103448275863,450,363
22400190,4,150,2.0,0.8,347,197
22400190,4,142,1.0,0.4225352112676056,178,36
22400190,4,3,-4.0,-80.0,34,31
22400190,4,23,0.0,0.0,23,0
22400191,1,225,2.0,0.5333333333333333,720,495
22400191,1,44,-2.0,-2.7272727272727275,495,451
22400191,1,66,0.0,0.0,441,375
22400191,1,218,15.0,4.128440366972478,363,145
22400191,2,79,0.0,0.0,720,641
22400191,2,174,2.0,0.6896551724137931,635,461
22400191,2,27,1.0,2.2222222222222223,448,421
22400191,2,39,-2.0,-3.0769230769230766,421,382
22400191,2,180,0.0,0.0,369,189
22400191,2,34,3.0,5.294117647058824,177,143
22400191,2,91,-3.0,-1.978021978021978,128,37
22400191,2,34,-3.0,-5.294117647058824,34,0
22400191,3,304,9.0,1.776315789473684,720,416
22400191,3,116,-2.0,-1.0344827586206897,395,279
22400191,3,39,0.0,0.0,279,240
22400191,3,47,-3.0,-3.829787234042553,233,186
22400191,3,63,3.0,2.8571428571428568,186,123
22400191,3,109,4.0,2.2018348623853212,109,0
22400191,4,306,0.0,0.0,720,414
22400191,4,129,-1.0,-0.46511627906976744,408,279
22400191,4,7,-1.0,-8.571428571428571,279,272
22400191,4,142,-2.0,-0.8450704225352113,272,130
22400192,1,404,4.0,0.594059405940594,720,316
22400192,1,29,0.0,0.0,314,285
22400192,1,69,0.0,0.0,254,185
22400192,1,26,0.0,0.0,173,147
22400192,1,131,4.0,1.83206106870229,131,0
22400192,2,187,4.0,1.2834224598930482,720,533
22400192,2,53,4.0,4.528301886792453,527,474
22400192,2,54,2.0,2.2222222222222223,474,420
22400192,2,53,3.0,3.3962264150943398,397,344
22400192,2,32,2.0,3.75,334,302
22400192,2,36,4.0,6.666666666666666,293,257
22400192,2,45,0.0,0.0,257,212
22400192,2,25,-2.0,-4.8,193,168
22400192,2,168,1.0,0.3571428571428571,168,0
22400192,3,342,-1.0,-0.17543859649122806,720,378
22400192,3,238,1.0,0.25210084033613445,378,140
22400192,3,92,-1.0,-0.6521739130434783,140,48
22400192,3,48,0.0,0.0,48,0
22400192,4,357,1.0,0.16806722689075632,720,363
22400192,4,6,-1.0,-10.0,342,336
22400192,4,103,5.0,2.912621359223301,336,233
22400192,4,5,0.0,0.0,233,228
22400192,4,18,-9.0,-30.0,212,194
22400193,1,289,9.0,1.8685121107266436,720,431
22400193,1,110,-4.0,-2.1818181818181817,411,301
22400193,1,26,3.0,6.923076923076923,292,266
22400193,1,65,5.0,4.615384615384616,258,193
22400193,1,314,5.0,0.9554140127388535,317,3
22400193,2,136,8.0,3.5294117647058822,720,584
22400193,2,37,-3.0,-4.864864864864865,584,547
22400193,2,98,-3.0,-1.836734693877551,547,449
22400193,2,89,-5.0,-3.3707865168539324,449,360
22400193,2,32,-3.0,-5.625,343,311
22400193,2,41,2.0,2.926829268292683,311,270
22400193,2,19,3.0,9.473684210526315,270,251
22400193,2,3,0.0,0.0,237,234
22400193,2,23,-3.0,-7.826086956521739,234,211
22400193,2,95,-6.0,-3.7894736842105265,211,116
22400193,3,191,4.0,1.256544502617801,720,529
22400193,3,91,2.0,1.3186813186813189,516,425
22400193,3,26,0.0,0.0,404,378
22400193,3,1,0.0,0.0,362,361
22400193,3,204,7.0,2.058823529411765,355,151
22400193,3,106,-2.0,-1.1320754716981132,151,45
22400193,4,103,3.0,1.7475728155339807,720,617
22400193,4,45,0.0,0.0,602,557
22400193,4,122,-2.0,-0.9836065573770493,540,418
22400193,4,16,-1.0,-3.75,401,385
22400193,4,43,1.0,1.3953488372093024,385,342
22400193,4,50,0.0,0.0,342,292
22400193,4,28,2.0,4.285714285714286,275,247
22400193,4,45,-2.0,-2.666666666666667,235,190
22400194,1,404,8.0,1.188118811881188,720,316
22400194,1,89,-4.0,-2.696629213483146,306,217
22400194,1,49,4.0,4.897959183673469,204,155
22400194,1,20,1.0,3.0,136,116
22400194,1,28,0.0,0.0,116,88
22400194,1,66,3.0,2.7272727272727275,78,12
22400194,1,12,-3.0,-15.0,12,0
22400194,2,188,-10.0,-3.1914893617021276,720,532
22400194,2,128,2.0,0.9375,514,386
22400194,2,65,2.0,1.8461538461538463,372,307
22400194,2,14,1.0,4.285714285714286,307,293
22400194,2,142,0.0,0.0,293,151
22400194,2,88,-1.0,-0.6818181818181819,143,55
22400194,2,43,6.0,8.372093023255815,43,0
22400194,3,183,11.0,3.6065573770491803,720,537
22400194,3,180,-4.0,-1.3333333333333335,532,352
22400194,3,55,0.0,0.0,338,283
22400194,3,26,-3.0,-6.923076923076923,260,234
22400194,3,148,-5.0,-2.027027027027027,226,78
22400194,3,61,4.0,3.934426229508197,68,7
22400194,3,1,0.0,0.0,1,0
22400194,4,245,3.0,0.7346938775510203,720,475
22400194,4,2,0.0,0.0,465,463
22400194,4,15,-2.0,-8.0,450,435
22400194,4,114,-1.0,-0.5263157894736842,435,321
22400194,4,55,-5.0,-5.454545454545455,315,260
22400194,4,181,2.0,0.6629834254143646,239,58
22400194,4,58,2.0,2.0689655172413794,58,0
22400195,1,320,8.0,1.5,720,400
22400195,1,132,-5.0,-2.272727272727273,382,250
22400195,1,44,-4.0,-5.454545454545455,243,199
22400195,1,199,4.0,1.206030150753769,199,0
22400195,2,103,4.0,2.3300970873786406,720,617
22400195,2,18,-1.0,-3.333333333333333,609,591
22400195,2,11,0.0,0.0,572,561
22400195,2,161,-6.0,-2.236024844720497,561,400
22400195,2,62,-2.0,-1.935483870967742,384,322
22400195,2,109,-1.0,-0.5504587155963303,322,213
22400195,2,32,0.0,0.0,208,176
22400195,2,109,2.0,1.1009174311926606,176,67
22400195,2,67,7.0,6.26865671641791,67,0
22400195,3,279,4.0,0.8602150537634409,720,441
22400195,3,137,-2.0,-0.875912408759124,441,304
22400195,3,15,1.0,4.0,297,282
22400195,3,76,2.0,1.5789473684210527,282,206
22400195,3,1,0.0,0.0,203,202
22400195,3,45,-1.0,-1.3333333333333335,179,134
22400195,3,134,-2.0,-0.8955223880597015,134,0
22400195,4,153,3.0,1.1764705882352942,720,567
22400195,4,39,-1.0,-1.5384615384615383,551,512
22400195,4,76,-2.0,-1.5789473684210527,500,424
22400195,4,24,0.0,0.0,424,400
22400195,4,160,-1.0,-0.375,386,226
22400195,4,88,1.0,0.6818181818181819,226,138
22400195,4,50,0.0,0.0,138,88
22400196,1,334,-10.0,-1.7964071856287425,720,386
22400196,1,169,-1.0,-0.35502958579881655,386,217
22400196,1,39,2.0,3.0769230769230766,217,178
22400196,1,42,4.0,5.7142857142857135,159,117
22400196,1,105,-3.0,-1.7142857142857142,105,0
22400196,2,137,2.0,0.875912408759124,720,583
22400196,2,72,-4.0,-3.333333333333333,565,493
22400196,2,34,1.0,1.7647058823529411,484,450
22400196,2,114,5.0,2.631578947368421,437,323
22400196,2,57,-1.0,-1.0526315789473684,267,210
22400196,2,190,-1.0,-0.3157894736842105,197,7
22400196,3,377,-2.0,-0.3183023872679045,720,343
22400196,3,114,-4.0,-2.1052631578947367,328,214
22400196,3,63,2.0,1.9047619047619047,214,151
22400196,3,71,1.0,0.8450704225352113,151,80
22400196,3,16,0.0,0.0,80,64
22400196,3,26,4.0,9.230769230769232,50,24
22400196,3,24,-2.0,-5.0,24,0
22400196,4,129,-6.0,-2.7906976744186047,720,591
22400196,4,61,-4.0,-3.934426229508197,578,517
22400196,4,27,1.0,2.2222222222222223,494,467
22400196,4,64,-2.0,-1.875,456,392
22400196,4,49,0.0,0.0,392,343
22400196,4,4,-2.0,-30.0,337,333
22400196,4,262,4.0,0.916030534351145,317,55
22400196,4,43,0.0,0.0,43,0
22400197,1,286,5.0,1.048951048951049,720,434
22400197,1,48,3.0,3.75,418,370
22400197,1,86,-5.0,-3.488372093023256,335,249
22400197,1,67,0.0,0.0,242,175
22400197,1,134,-5.0,-2.2388059701492535,175,41
22400197,1,32,0.0,0.0,32,0
22400197,2,108,4.0,2.2222222222222223,720,612
22400197,2,62,3.0,2.903225806451613,602,540
22400197,2,51,0.0,0.0,523,472
22400197,2,119,-7.0,-3.5294117647058822,460,341
22400197,2,148,7.0,2.837837837837838,341,193
22400197,2,37,0.0,0.0,193,156
22400197,2,61,-3.0,-2.9508196721311473,156,95
22400197,2,50,-1.0,-1.2,95,45
22400197,2,45,0.0,0.0,45,0
22400197,3,207,2.0,0.5797101449275363,720,513
22400197,3,99,3.0,1.8181818181818183,506,407
22400197,3,47,1.0,1.2765957446808511,394,347
22400197,3,41,-2.0,-2.926829268292683,335,294
22400197,3,111,4.0,2.1621621621621623,285,174
22400197,3,22,0.0,0.0,174,152
22400197,3,40,0.0,0.0,152,112
22400197,3,55,-1.0,-1.0909090909090908,106,51
22400197,3,51,0.0,0.0,51,0
22400197,4,221,1.0,0.2714932126696833,720,499
22400197,4,15,0.0,0.0,430,415
22400197,4,68,1.0,0.8823529411764706,415,347
22400197,4,34,0.0,0.0,336,302
22400197,4,55,-3.0,-3.2727272727272725,293,238
22400197,4,213,0.0,0.0,224,11
22400197,4,2,-1.0,-30.0,10,8
22400197,4,3,2.0,40.0,3,0
22400198,1,355,2.0,0.3380281690140845,720,365
22400198,1,43,0.0,0.0,365,322
22400198,1,38,1.0,1.5789473684210527,304,266
22400198,1,48,-2.0,-2.5,266,218
22400198,1,47,2.0,2.5531914893617023,210,163
22400198,1,95,5.0,3.1578947368421053,163,68
22400198,2,25,-1.0,-2.4,720,695
22400198,2,43,3.0,4.186046511627907,695,652
22400198,2,97,-4.0,-2.4742268041237114,639,542
22400198,2,16,1.0,3.75,526,510
22400198,2,18,1.0,3.333333333333333,474,456
22400198,2,49,0.0,0.0,456,407
22400198,2,107,-2.0,-1.1214953271028036,407,300
22400198,2,41,-2.0,-2.926829268292683,300,259
22400198,2,195,1.0,0.3076923076923077,197,2
22400198,3,112,7.0,3.75,720,608
22400198,3,250,-3.0,-0.72,588,338
22400198,3,319,-4.0,-0.7523510971786833,579,260
22400198,3,34,0.0,0.0,245,211
22400198,3,95,1.0,0.631578947368421,206,111
22400198,4,129,-3.0,-1.3953488372093024,720,591
22400198,4,94,-3.0,-1.9148936170212765,591,497
22400198,4,35,-4.0,-6.857142857142857,490,455
22400198,4,12,0.0,0.0,434,422
22400198,4,34,0.0,0.0,422,388
22400198,4,40,-1.0,-1.5,379,339
22400198,4,103,0.0,0.0,339,236
22400198,4,232,-11.0,-2.8448275862068964,232,0
22400199,1,300,3.0,0.6,720,420
22400199,1,43,0.0,0.0,420,377
22400199,1,65,2.0,1.8461538461538463,377,312
22400199,1,43,2.0,2.7906976744186047,312,269
22400199,1,73,0.0,0.0,256,183
22400199,1,183,2.0,0.6557377049180327,183,0
22400199,2,139,1.0,0.43165467625899284,720,581
22400199,2,150,4.0,1.6,581,431
22400199,2,33,5.0,9.090909090909092,421,388
22400199,2,73,-3.0,-2.4657534246575343,376,303
22400199,2,95,-7.0,-4.421052631578947,296,201
22400199,2,168,-1.0,-0.3571428571428571,182,14
22400199,3,167,-12.0,-4.311377245508982,720,553
22400199,3,100,-3.0,-1.7999999999999998,540,440
22400199,3,142,0.0,0.0,436,294
22400199,3,2,1.0,30.0,281,279
22400199,3,192,-2.0,-0.625,279,87
22400199,3,79,-1.0,-0.7594936708860759,82,3
22400199,4,165,6.0,2.1818181818181817,720,555
22400199,4,77,2.0,1.5584415584415585,543,466
22400199,4,68,0.0,0.0,443,375
22400199,4,360,10.0,1.6666666666666665,375,15
22400199,4,15,0.0,0.0,15,0
22400200,1,257,2.0,0.4669260700389105,720,463
22400200,1,35,-2.0,-3.4285714285714284,463,428
22400200,1,116,2.0,1.0344827586206897,422,306
22400200,1,58,-2.0,-2.0689655172413794,290,232
22400200,1,70,-3.0,-2.5714285714285716,220,150
22400200,1,42,0.0,0.0,127,85
22400200,1,85,5.0,3.5294117647058822,85,0
22400200,2,130,-4.0,-1.8461538461538463,720,590
22400200,2,149,6.0,2.4161073825503356,571,422
22400200,2,3,0.0,0.0,400,397
22400200,2,103,-3.0,-1.7475728155339807,377,274
22400200,2,112,-3.0,-1.607142857142857,274,162
22400200,2,24,1.0,2.5,160,136
22400200,2,136,-2.0,-0.8823529411764706,136,0
22400200,3,282,5.0,1.0638297872340425,720,438
22400200,3,101,-6.0,-3.564356435643564,431,330
22400200,3,89,2.0,1.348314606741573,330,241
22400200,3,40,2.0,3.0,232,192
22400200,3,54,3.0,3.333333333333333,192,138
22400200,3,132,-2.0,-0.9090909090909092,138,6
22400200,3,3,1.0,20.0,6,3
22400200,3,3,0.0,0.0,3,0
22400200,4,110,-1.0,-0.5454545454545454,720,610
22400200,4,81,2.0,1.4814814814814814,599,518
22400200,4,82,-5.0,-3.6585365853658534,502,420
22400200,4,44,1.0,1.3636363636363638,398,354
22400200,4,24,-3.0,-7.5,354,330
22400200,4,273,-3.0,-0.6593406593406594,319,46
22400200,4,1,0.0,0.0,39,38
22400200,4,27,1.0,2.2222222222222223,35,8
22400200,4,6,0.0,0.0,6,0
22400201,1,451,-5.0,-0.6651884700665189,720,269
22400201,1,94,0.0,0.0,254,160
22400201,1,154,0.0,0.0,154,0
22400201,2,98,-2.0,-1.2244897959183672,720,622
22400201,2,84,7.0,5.0,622,538
22400201,2,33,0.0,0.0,526,493
22400201,2,146,0.0,0.0,479,333
22400201,2,113,2.0,1.0619469026548671,317,204
22400201,2,111,-2.0,-1.0810810810810811,189,78
22400201,2,10,0.0,0.0,78,68
22400201,2,43,2.0,2.7906976744186047,55,12
22400201,2,11,0.0,0.0,12,1
22400201,3,361,1.0,0.16620498614958448,720,359
22400201,3,25,0.0,0.0,335,310
22400201,3,34,-5.0,-8.823529411764707,292,258
22400201,3,38,1.0,1.5789473684210527,248,210
22400201,3,53,-2.0,-2.2641509433962264,210,157
22400201,3,19,-1.0,-3.1578947368421053,157,138
22400201,3,60,-2.0,-2.0,138,78
22400201,3,65,-1.0,-0.9230769230769231,67,2
22400201,4,201,-4.0,-1.1940298507462686,720,519
22400201,4,73,3.0,2.4657534246575343,499,426
22400201,4,39,-3.0,-4.615384615384616,416,377
22400201,4,51,0.0,0.0,377,326
22400201,4,119,0.0,0.0,316,197
22400201,4,109,-6.0,-3.302752293577982,197,88
22400201,4,38,3.0,4.7368421052631575,83,45
22400201,4,26,-1.0,-2.307692307692308,33,7
22400201,4,6,0.0,0.0,6,0
22400202,1,364,8.0,1.3186813186813189,720,356
22400202,1,13,0.0,0.0,340,327
22400202,1,60,-1.0,-1.0,318,258
22400202,1,120,0.0,0.0,258,138
22400202,1,69,0.0,0.0,138,69
22400202,1,55,1.0,1.0909090909090908,69,14
22400202,1,14,2.0,8.571428571428571,14,0
22400202,2,287,1.0,0.20905923344947736,720,433
22400202,2,34,2.0,3.5294117647058822,406,372
22400202,2,114,0.0,0.0,372,258
22400202,2,248,-3.0,-0.7258064516129032,248,0
22400202,3,174,-12.0,-4.137931034482759,720,546
22400202,3,288,-2.0,-0.41666666666666663,532,244
22400202,3,219,1.0,0.273972602739726,227,8
22400202,3,6,0.0,0.0,8,2
22400202,4,97,-1.0,-0.6185567010309279,720,623
22400202,4,63,1.0,0.9523809523809523,604,541
22400202,4,120,2.0,1.0,532,412
22400202,4,61,0.0,0.0,412,351
22400202,4,217,-1.0,-0.2764976958525346,217,0
22400203,1,409,7.0,1.0268948655256722,720,311
22400203,1,64,-4.0,-3.75,301,237
22400203,1,87,1.0,0.6896551724137931,223,136
22400203,1,3,-1.0,-20.0,123,120
22400203,1,54,0.0,0.0,114,60
22400203,1,27,2.0,4.444444444444445,40,13
22400203,1,7,0.0,0.0,7,0
22400203,2,141,-5.0,-2.127659574468085,720,579
22400203,2,60,-1.0,-1.0,574,514
22400203,2,44,-1.0,-1.3636363636363638,499,455
22400203,2,38,0.0,0.0,438,400
22400203,2,104,5.0,2.8846153846153846,390,286
22400203,2,16,0.0,0.0,286,270
22400203,2,193,4.0,1.2435233160621761,262,69
22400203,2,53,0.0,0.0,61,8
22400203,2,2,0.0,0.0,2,0
22400203,3,352,-2.0,-0.34090909090909094,720,368
22400203,3,21,-1.0,-2.8571428571428568,368,347
22400203,3,8,2.0,15.0,347,339
22400203,3,23,-1.0,-2.608695652173913,339,316
22400203,3,158,0.0,0.0,316,158
22400203,3,43,-1.0,-1.3953488372093024,133,90
22400203,3,73,1.0,0.821917808219178,90,17
22400203,3,15,1.0,4.0,17,2
22400203,3,1,1.0,60.0,2,1
22400203,3,1,0.0,0.0,1,0
22400203,4,108,5.0,2.7777777777777777,720,612
22400203,4,126,2.0,0.9523809523809523,594,468
22400203,4,94,-1.0,-0.6382978723404256,458,364
22400203,4,31,-2.0,-3.870967741935484,364,333
22400203,4,86,1.0,0.6976744186046512,324,238
22400203,4,238,5.0,1.2605042016806725,238,0
22400204,1,337,4.0,0.712166172106825,720,383
22400204,1,113,1.0,0.5309734513274336,368,255
22400204,1,170,3.0,1.0588235294117647,236,66
22400204,1,54,-2.0,-2.2222222222222223,54,0
22400204,2,199,-2.0,-0.6030150753768845,720,521
22400204,2,26,2.0,4.615384615384616,512,486
22400204,2,82,1.0,0.7317073170731707,486,404
22400204,2,236,0.0,0.0,388,152
22400204,2,131,-1.0,-0.4580152671755725,131,0
22400204,3,199,1.0,0.30150753768844224,720,521
22400204,3,127,5.0,2.3622047244094486,512,385
22400204,3,24,0.0,0.0,314,290
22400204,3,58,4.0,4.137931034482759,265,207
22400204,3,63,3.0,2.8571428571428568,98,35
22400204,3,20,0.0,0.0,20,0
22400204,4,144,4.0,1.6666666666666665,720,576
22400204,4,84,-3.0,-2.142857142857143,565,481
22400204,4,123,3.0,1.4634146341463414,452,329
22400204,4,63,6.0,5.7142857142857135,289,226
22400204,4,136,-5.0,-2.2058823529411766,226,90
22400205,1,327,-3.0,-0.5504587155963303,720,393
22400205,1,100,4.0,2.4,378,278
22400205,1,56,0.0,0.0,263,207
22400205,1,68,3.0,2.647058823529412,193,125
22400205,1,9,0.0,0.0,106,97
22400205,1,44,0.0,0.0,87,43
22400205,1,5,0.0,0.0,27,22
22400205,1,22,0.0,0.0,22,0
22400205,2,89,-2.0,-1.348314606741573,720,631
22400205,2,108,-2.0,-1.1111111111111112,631,523
22400205,2,32,2.0,3.75,523,491
22400205,2,98,-2.0,-1.2244897959183672,491,393
22400205,2,101,-3.0,-1.782178217821782,368,267
22400205,2,37,-1.0,-1.6216216216216217,245,208
22400205,2,134,-2.0,-0.8955223880597015,208,74
22400205,2,24,1.0,2.5,59,35
22400205,2,35,2.0,3.4285714285714284,35,0
22400205,3,82,0.0,0.0,720,638
22400205,3,185,5.0,1.6216216216216217,628,443
22400205,3,172,0.0,0.0,432,260
22400205,3,39,0.0,0.0,234,195
22400205,3,125,-2.0,-0.96,183,58
22400205,3,43,5.0,6.976744186046512,43,0
22400205,4,272,-2.0,-0.4411764705882353,720,448
22400205,4,246,-7.0,-1.7073170731707317,434,188
22400205,4,75,3.0,2.4,188,113
22400205,4,81,-1.0,-0.7407407407407407,94,13
22400205,4,2,0.0,0.0,12,10
22400205,5,96,0.0,0.0,300,204
22400205,5,182,0.0,0.0,197,15
22400205,5,7,1.0,8.571428571428571,7,0
22400206,1,262,-2.0,-0.4580152671755725,720,458
22400206,1,60,-4.0,-4.0,458,398
22400206,1,40,2.0,3.0,381,341
22400206,1,106,-1.0,-0.5660377358490566,330,224
22400206,1,46,0.0,0.0,224,178
22400206,1,83,0.0,0.0,175,92
22400206,1,92,0.0,0.0,92,0
22400206,2,111,-2.0,-1.0810810810810811,720,609
22400206,2,74,-2.0,-1.6216216216216217,602,528
22400206,2,110,-1.0,-0.5454545454545454,528,418
22400206,2,72,3.0,2.5,399,327
22400206,2,81,7.0,5.185185185185185,316,235
22400206,2,59,-1.0,-1.0169491525423728,235,176
22400206,2,63,-2.0,-1.9047619047619047,176,113
22400206,2,94,4.0,2.5531914893617023,94,0
22400206,3,323,-6.0,-1.1145510835913313,720,397
22400206,3,58,0.0,0.0,376,318
22400206,3,82,8.0,5.853658536585366,301,219
22400206,3,37,3.0,4.864864864864865,182,145
22400206,3,138,-2.0,-0.8695652173913043,138,0
22400206,4,102,-2.0,-1.1764705882352942,720,618
22400206,4,93,5.0,3.2258064516129035,607,514
22400206,4,118,0.0,0.0,496,378
22400206,4,141,0.0,0.0,378,237
22400206,4,82,-2.0,-1.4634146341463414,236,154
22400206,4,145,-1.0,-0.41379310344827586,154,9
22400206,4,3,0.0,0.0,3,0
22400207,1,283,3.0,0.6360424028268552,720,437
22400207,1,27,-2.0,-4.444444444444445,437,410
22400207,1,124,1.0,0.4838709677419355,393,269
22400207,1,110,-3.0,-1.6363636363636362,269,159
22400207,1,141,3.0,1.2765957446808511,159,18
22400207,1,18,3.0,10.0,18,0
22400207,2,247,-6.0,-1.45748987854251,720,473
22400207,2,8,0.0,0.0,464,456
22400207,2,39,0.0,0.0,448,409
22400207,2,114,-4.0,-2.1052631578947367,396,282
22400207,2,121,-7.0,-3.4710743801652892,275,154
22400207,2,29,-2.0,-4.137931034482759,131,102
22400207,2,47,1.0,1.2765957446808511,102,55
22400207,2,16,-1.0,-3.75,55,39
22400207,2,9,1.0,6.666666666666666,39,30
22400207,2,30,-2.0,-4.0,30,0
22400207,3,184,-10.0,-3.260869565217391,720,536
22400207,3,103,0.0,0.0,521,418
22400207,3,68,-2.0,-1.7647058823529411,417,349
22400207,3,45,-1.0,-1.3333333333333335,340,295
22400207,3,112,-8.0,-4.285714285714286,286,174
22400207,3,88,-2.0,-1.3636363636363638,166,78
22400207,3,67,0.0,0.0,67,0
22400207,4,172,11.0,3.8372093023255816,720,548
22400207,4,10,0.0,0.0,524,514
22400207,4,84,2.0,1.4285714285714284,514,430
22400207,4,119,6.0,3.0252100840336134,430,311
22400207,4,12,1.0,5.0,304,292
22400207,4,151,-2.0,-0.7947019867549668,288,137
22400207,4,54,0.0,0.0,126,72
22400208,1,322,1.0,0.18633540372670807,720,398
22400208,1,67,0.0,0.0,392,325
22400208,1,65,0.0,0.0,320,255
22400208,1,51,0.0,0.0,255,204
22400208,1,29,2.0,4.137931034482759,191,162
22400208,1,144,-3.0,-1.25,151,7
22400208,1,1,0.0,0.0,1,0
22400208,2,193,-4.0,-1.2435233160621761,720,527
22400208,2,170,-1.0,-0.3529411764705882,512,342
22400208,2,54,1.0,1.1111111111111112,342,288
22400208,2,46,0.0,0.0,277,231
22400208,2,189,-3.0,-0.9523809523809523,231,42
22400208,2,42,-1.0,-1.4285714285714284,42,0
22400208,3,246,2.0,0.48780487804878053,720,474
22400208,3,110,-1.0,-0.5454545454545454,463,353
22400208,3,52,2.0,2.307692307692308,353,301
22400208,3,36,0.0,0.0,301,265
22400208,3,62,4.0,3.870967741935484,265,203
22400208,3,135,-4.0,-1.777777777777778,203,68
22400208,3,68,-1.0,-0.8823529411764706,68,0
22400208,4,138,-5.0,-2.1739130434782608,720,582
22400208,4,62,-1.0,-0.967741935483871,568,506
22400208,4,71,2.0,1.6901408450704225,498,427
22400208,4,95,1.0,0.631578947368421,416,321
22400208,4,304,0.0,0.0,310,6
22400208,4,2,0.0,0.0,2,0
22400209,1,328,0.0,0.0,720,392
22400209,1,93,0.0,0.0,383,290
22400209,1,101,-6.0,-3.564356435643564,290,189
22400209,1,113,2.0,1.0619469026548671,176,63
22400209,1,41,-5.0,-7.317073170731707,63,22
22400209,1,22,3.0,8.181818181818182,22,0
22400209,2,58,3.0,3.103448275862069,720,662
22400209,2,54,2.0,2.2222222222222223,650,596
22400209,2,48,0.0,0.0,593,545
22400209,2,17,0.0,0.0,538,521
22400209,2,3,0.0,0.0,511,508
22400209,2,185,-2.0,-0.6486486486486487,498,313
22400209,2,160,-1.0,-0.375,301,141
22400209,2,128,-2.0,-0.9375,128,0
22400209,3,277,2.0,0.4332129963898917,720,443
22400209,3,55,2.0,2.1818181818181817,434,379
22400209,3,36,1.0,1.6666666666666665,379,343
22400209,3,20,0.0,0.0,343,323
22400209,3,14,0.0,0.0,310,296
22400209,3,30,4.0,8.0,285,255
22400209,3,24,1.0,2.5,255,231
22400209,3,4,-2.0,-30.0,220,216
22400209,3,32,0.0,0.0,216,184
22400209,3,167,2.0,0.718562874251497,167,0
22400209,4,92,3.0,1.9565217391304348,720,628
22400209,4,74,4.0,3.2432432432432434,628,554
22400209,4,96,-3.0,-1.875,538,442
22400209,4,32,-3.0,-5.625,442,410
22400209,4,146,1.0,0.410958904109589,393,247
22400209,4,20,-3.0,-9.0,247,227
22400209,4,138,-2.0,-0.8695652173913043,216,78
22400209,4,9,-1.0,-6.666666666666666,78,69
22400209,4,18,1.0,3.333333333333333,69,51
22400209,4,48,-4.0,-5.0,51,3
22400209,4,3,0.0,0.0,3,0
22400209,5,134,-8.0,-3.582089552238806,300,166
22400209,5,40,1.0,1.5,166,126
22400209,5,63,-4.0,-3.8095238095238093,126,63
22400209,5,47,0.0,0.0,47,0
22400210,1,258,0.0,0.0,720,462
22400210,1,31,-4.0,-7.741935483870968,423,392
22400210,1,164,-5.0,-1.8292682926829267,376,212
22400210,1,23,0.0,0.0,198,175
22400210,1,37,-3.0,-4.864864864864865,175,138
22400210,1,20,0.0,0.0,138,118
22400210,1,47,0.0,0.0,109,62
22400210,1,62,2.0,1.935483870967742,62,0
22400210,2,156,-5.0,-1.923076923076923,720,564
22400210,2,8,-1.0,-7.5,552,544
22400210,2,94,-1.0,-0.6382978723404256,544,450
22400210,2,121,-1.0,-0.49586776859504134,450,329
22400210,2,30,-2.0,-4.0,323,293
22400210,2,75,-3.0,-2.4,267,192
22400210,2,53,2.0,2.2641509433962264,181,128
22400210,2,78,1.0,0.7692307692307692,117,39
22400210,2,36,2.0,3.333333333333333,39,3
22400210,2,3,0.0,0.0,3,0
22400210,3,223,-5.0,-1.3452914798206277,720,497
22400210,3,59,-3.0,-3.050847457627119,497,438
22400210,3,46,1.0,1.3043478260869565,433,387
22400210,3,187,-1.0,-0.32085561497326204,387,200
22400210,3,174,-8.0,-2.7586206896551726,180,6
22400210,3,2,0.0,0.0,2,0
22400210,4,243,2.0,0.4938271604938272,720,477
22400210,4,57,-2.0,-2.1052631578947367,477,420
22400210,4,106,1.0,0.5660377358490566,406,300
22400210,4,15,-1.0,-4.0,287,272
22400211,1,302,-3.0,-0.5960264900662252,720,418
22400211,1,20,0.0,0.0,418,398
22400211,1,100,1.0,0.6,391,291
22400211,1,63,-3.0,-2.8571428571428568,291,228
22400211,1,70,-1.0,-0.8571428571428571,228,158
22400211,1,68,0.0,0.0,143,75
22400211,1,48,-6.0,-7.5,71,23
22400211,2,38,3.0,4.7368421052631575,720,682
22400211,2,16,1.0,3.75,677,661
22400211,2,44,-2.0,-2.7272727272727275,661,617
22400211,2,109,2.0,1.1009174311926606,613,504
22400211,2,107,0.0,0.0,504,397
22400211,2,32,-1.0,-1.875,389,357
22400211,2,31,-4.0,-7.741935483870968,340,309
22400211,2,56,5.0,5.357142857142858,298,242
22400211,2,74,0.0,0.0,242,168
22400211,2,2,0.0,0.0,154,152
22400211,2,56,-2.0,-2.142857142857143,134,78
22400211,2,78,5.0,3.846153846153846,78,0
22400211,3,288,-1.0,-0.20833333333333331,720,432
22400211,3,86,0.0,0.0,429,343
22400211,3,15,0.0,0.0,331,316
22400211,3,77,-1.0,-0.7792207792207793,300,223
22400211,3,26,0.0,0.0,223,197
22400211,3,86,5.0,3.488372093023256,181,95
22400211,3,60,1.0,1.0,95,35
22400211,3,35,2.0,3.4285714285714284,35,0
22400211,4,167,4.0,1.437125748502994,720,553
22400211,4,61,2.0,1.9672131147540985,553,492
22400211,4,80,1.0,0.75,474,394
22400211,4,29,-2.0,-4.137931034482759,386,357
22400211,4,40,0.0,0.0,351,311
22400211,4,185,4.0,1.2972972972972974,311,126
22400211,4,26,3.0,6.923076923076923,126,100
22400211,4,77,0.0,0.0,77,0
22400212,1,315,-3.0,-0.5714285714285715,720,405
22400212,1,181,3.0,0.9944751381215469,405,224
22400212,1,68,1.0,0.8823529411764706,210,142
22400212,1,71,-2.0,-1.6901408450704225,71,0
22400212,2,46,-2.0,-2.608695652173913,720,674
22400212,2,42,-1.0,-1.4285714285714284,674,632
22400212,2,68,0.0,0.0,620,552
22400212,2,64,-5.0,-4.6875,552,488
22400212,2,1,0.0,0.0,465,464
22400212,2,33,0.0,0.0,438,405
22400212,2,6,0.0,0.0,396,390
22400212,2,10,1.0,6.0,381,371
22400212,2,68,7.0,6.1764705882352935,371,303
22400212,2,65,2.0,1.8461538461538463,282,217
22400212,3,279,5.0,1.075268817204301,720,441
22400212,3,46,2.0,2.608695652173913,441,395
22400212,3,49,0.0,0.0,391,342
22400212,3,36,1.0,1.6666666666666665,318,282
22400212,3,79,-4.0,-3.0379746835443036,282,203
22400212,3,37,-1.0,-1.6216216216216217,181,144
22400212,3,61,-5.0,-4.918032786885245,144,83
22400212,3,83,1.0,0.7228915662650602,83,0
22400212,4,128,-5.0,-2.34375,720,592
22400212,4,122,5.0,2.4590163934426226,579,457
22400212,4,36,0.0,0.0,448,412
22400212,4,27,2.0,4.444444444444445,403,376
22400212,4,93,0.0,0.0,371,278
22400212,4,56,-2.0,-2.142857142857143,267,211
22400212,4,180,1.0,0.33333333333333337,203,23
22400212,4,3,0.0,0.0,20,17
22400213,1,299,0.0,0.0,720,421
22400213,1,51,-1.0,-1.1764705882352942,421,370
22400213,1,7,1.0,8.571428571428571,355,348
22400213,1,34,-1.0,-1.7647058823529411,348,314
22400213,1,102,1.0,0.5882352941176471,314,212
22400213,1,51,2.0,2.3529411764705883,198,147
22400213,1,113,-1.0,-0.5309734513274336,140,27
22400213,1,25,-2.0,-4.8,25,0
22400213,2,132,7.0,3.181818181818182,720,588
22400213,2,113,0.0,0.0,570,457
22400213,2,29,0.0,0.0,446,417
22400213,2,136,0.0,0.0,414,278
22400213,2,53,0.0,0.0,262,209
22400213,2,200,-3.0,-0.8999999999999999,200,0
22400213,3,281,5.0,1.0676156583629894,720,439
22400213,3,16,-1.0,-3.75,439,423
22400213,3,103,0.0,0.0,423,320
22400213,3,25,0.0,0.0,307,282
22400213,3,88,0.0,0.0,267,179
22400213,3,31,0.0,0.0,177,146
22400213,3,20,0.0,0.0,137,117
22400213,3,24,3.0,7.5,100,76
22400213,3,76,-3.0,-2.3684210526315788,76,0
22400213,4,105,-1.0,-0.5714285714285715,720,615
22400213,4,18,-1.0,-3.333333333333333,596,578
22400213,4,16,-2.0,-7.5,573,557
22400213,4,113,-2.0,-1.0619469026548671,557,444
22400213,4,156,3.0,1.153846153846154,424,268
22400213,4,79,2.0,1.5189873417721518,268,189
22400213,4,33,4.0,7.272727272727273,179,146
22400213,4,26,0.0,0.0,135,109
22400213,4,97,-3.0,-1.8556701030927836,97,0
22400214,1,262,2.0,0.4580152671755725,720,458
22400214,1,46,1.0,1.3043478260869565,441,395
22400214,1,56,-1.0,-1.0714285714285714,379,323
22400214,1,80,-4.0,-3.0,317,237
22400214,1,133,-2.0,-0.9022556390977443,309,176
22400214,1,166,0.0,0.0,166,0
22400214,2,199,7.0,2.1105527638190953,720,521
22400214,2,6,0.0,0.0,512,506
22400214,2,130,-5.0,-2.307692307692308,503,373
22400214,2,115,5.0,2.608695652173913,358,243
22400214,2,220,1.0,0.2727272727272727,236,16
22400214,2,12,0.0,0.0,16,4
22400214,2,1,0.0,0.0,1,0
22400214,3,247,-3.0,-0.728744939271255,720,473
22400214,3,11,2.0,10.90909090909091,465,454
22400214,3,46,0.0,0.0,411,365
22400214,3,170,4.0,1.4117647058823528,356,186
22400214,3,67,0.0,0.0,186,119
22400214,3,102,-2.0,-1.1764705882352942,102,0
22400214,4,114,0.0,0.0,720,606
22400214,4,61,-1.0,-0.9836065573770493,591,530
22400214,4,76,4.0,3.1578947368421053,530,454
22400214,4,30,-2.0,-4.0,433,403
22400214,4,76,2.0,1.5789473684210527,385,309
22400214,4,68,-1.0,-0.8823529411764706,293,225
22400214,4,22,2.0,5.454545454545455,218,196
22400214,4,163,-5.0,-1.8404907975460123,183,20
22400214,4,4,0.0,0.0,18,14
22400215,1,346,5.0,0.8670520231213873,720,374
22400215,1,101,-4.0,-2.376237623762376,374,273
22400215,1,71,-3.0,-2.535211267605634,273,202
22400215,1,152,4.0,1.5789473684210527,186,34
22400215,2,208,-3.0,-0.8653846153846154,720,512
22400215,2,46,3.0,3.9130434782608696,489,443
22400215,2,20,1.0,3.0,431,411
22400215,2,99,-1.0,-0.6060606060606061,411,312
22400215,2,4,2.0,30.0,268,264
22400215,2,80,3.0,2.25,264,184
22400215,2,7,2.0,17.142857142857142,180,173
22400215,2,99,-1.0,-0.6060606060606061,161,62
22400215,2,58,1.0,1.0344827586206897,62,4
22400215,2,4,0.0,0.0,4,0
22400215,3,184,4.0,1.3043478260869565,720,536
22400215,3,199,0.0,0.0,518,319
22400215,3,50,-1.0,-1.2,303,253
22400215,3,98,-4.0,-2.4489795918367343,253,155
22400215,3,18,-2.0,-6.666666666666666,151,133
22400215,3,22,2.0,5.454545454545455,133,111
22400215,3,81,-5.0,-3.7037037037037033,111,30
22400215,3,20,-1.0,-3.0,29,9
22400215,4,111,-1.0,-0.5405405405405406,720,609
22400215,4,29,2.0,4.137931034482759,601,572
22400215,4,34,3.0,5.294117647058824,560,526
22400215,4,29,-1.0,-2.0689655172413794,513,484
22400215,4,44,1.0,1.3636363636363638,484,440
22400215,4,139,-1.0,-0.43165467625899284,485,346
22400215,4,134,1.0,0.44776119402985076,346,212
22400215,4,120,-3.0,-1.5,212,92
22400215,4,47,0.0,0.0,92,45
22400215,4,42,3.0,4.285714285714286,42,0
22400216,1,355,2.0,0.3380281690140845,720,365
22400216,1,62,-4.0,-3.870967741935484,353,291
22400216,1,137,-2.0,-0.875912408759124,280,143
22400216,1,133,-5.0,-2.2556390977443606,133,0
22400216,2,130,-2.0,-0.9230769230769231,720,590
22400216,2,276,5.0,1.0869565217391304,585,309
22400216,2,105,3.0,1.7142857142857142,309,204
22400216,2,59,-3.0,-3.050847457627119,201,142
22400216,2,26,-1.0,-2.307692307692308,142,116
22400216,2,31,0.0,0.0,36,5
22400216,3,321,9.0,1.6822429906542056,720,399
22400216,3,62,0.0,0.0,387,325
22400216,3,83,-6.0,-4.337349397590361,315,232
22400216,3,28,0.0,0.0,226,198
22400216,3,69,2.0,1.7391304347826086,189,120
22400216,3,27,-1.0,-2.2222222222222223,97,70
22400216,4,91,1.0,0.6593406593406594,720,629
22400216,4,16,-2.0,-7.5,629,613
22400216,4,92,3.0,1.9565217391304348,591,499
22400216,4,91,-1.0,-0.6593406593406594,486,395
22400216,4,118,-2.0,-1.0169491525423728,384,266
22400216,4,115,-2.0,-1.0434782608695652,257,142
22400216,4,50,4.0,4.8,133,83
22400216,4,6,2.0,20.0,58,52
22400216,4,40,2.0,3.0,40,0
22400217,1,433,0.0,0.0,720,287
22400217,1,398,-1.0,-0.15075376884422112,581,183
22400217,1,109,-2.0,-1.1009174311926606,163,54
22400217,1,25,-2.0,-4.8,36,11
22400217,1,1,0.0,0.0,1,0
22400217,2,163,-2.0,-0.7361963190184049,720,557
22400217,2,21,0.0,0.0,557,536
22400217,2,1,0.0,0.0,534,533
22400217,2,20,3.0,9.0,525,505
22400217,2,40,0.0,0.0,489,449
22400217,2,61,2.0,1.9672131147540985,437,376
22400217,2,86,4.0,2.7906976744186047,363,277
22400217,2,89,-6.0,-4.044943820224719,251,162
22400217,2,90,2.0,1.3333333333333335,162,72
22400217,2,72,2.0,1.6666666666666665,72,0
22400217,3,269,3.0,0.6691449814126393,720,451
22400217,3,122,-1.0,-0.49180327868852464,437,315
22400217,3,54,0.0,0.0,297,243
22400217,3,63,5.0,4.761904761904762,243,180
22400217,3,16,-2.0,-7.5,167,151
22400217,3,53,-2.0,-2.2641509433962264,136,83
22400217,3,68,-2.0,-1.7647058823529411,75,7
22400217,4,145,6.0,2.4827586206896552,720,575
22400217,4,28,3.0,6.428571428571428,575,547
22400217,4,74,3.0,2.4324324324324325,530,456
22400217,4,12,0.0,0.0,446,434
22400217,4,10,0.0,0.0,425,415
22400217,4,24,1.0,2.5,410,386
22400217,4,281,-2.0,-0.4270462633451957,370,89
22400217,4,89,-2.0,-1.348314606741573,89,0
22400218,1,194,1.0,0.30927835051546393,720,526
22400218,1,21,2.0,5.7142857142857135,526,505
22400218,1,73,-2.0,-1.643835616438356,497,424
22400218,1,70,5.0,4.285714285714286,424,354
22400218,1,130,2.0,0.9230769230769231,339,209
22400218,1,35,0.0,0.0,209,174
22400218,1,78,1.0,0.7692307692307692,164,86
22400218,1,80,-5.0,-3.75,86,6
22400218,2,181,0.0,0.0,720,539
22400218,2,13,0.0,0.0,520,507
22400218,2,31,1.0,1.935483870967742,494,463
22400218,2,61,0.0,0.0,446,385
22400218,2,147,-1.0,-0.40816326530612246,385,238
22400218,2,32,0.0,0.0,233,201
22400218,2,201,-8.0,-2.388059701492537,201,0
22400218,3,302,-9.0,-1.7880794701986755,720,418
22400218,3,55,-1.0,-1.0909090909090908,418,363
22400218,3,45,-1.0,-1.3333333333333335,328,283
22400218,3,29,0.0,0.0,283,254
22400218,3,253,3.0,0.7114624505928854,254,1
22400218,4,278,-4.0,-0.8633093525179857,720,442
22400218,4,29,3.0,6.206896551724138,431,402
22400218,4,135,-8.0,-3.555555555555556,402,267
22400218,4,148,-1.0,-0.40540540540540543,252,104
22400219,1,421,-3.0,-0.4275534441805226,720,299
22400219,1,83,-2.0,-1.4457831325301205,289,206
22400219,1,78,-1.0,-0.7692307692307692,200,122
22400219,1,96,0.0,0.0,109,13
22400219,2,123,3.0,1.4634146341463414,720,597
22400219,2,42,-3.0,-4.285714285714286,597,555
22400219,2,4,0.0,0.0,544,540
22400219,2,52,3.0,3.4615384615384617,523,471
22400219,2,14,0.0,0.0,454,440
22400219,2,15,0.0,0.0,431,416
22400219,2,215,-3.0,-0.8372093023255813,416,201
22400219,2,9,0.0,0.0,196,187
22400219,2,180,-3.0,-1.0,180,0
22400219,3,215,-9.0,-2.511627906976744,720,505
22400219,3,157,-1.0,-0.3821656050955414,505,348
22400219,3,85,1.0,0.7058823529411764,348,263
22400219,3,59,-1.0,-1.0169491525423728,263,204
22400219,3,34,3.0,5.294117647058824,192,158
22400219,3,35,5.0,8.571428571428571,147,112
22400219,3,29,2.0,4.137931034482759,92,63
22400219,3,45,2.0,2.666666666666667,45,0
22400219,4,174,7.0,2.413793103448276,720,546
22400219,4,64,-1.0,-0.9375,526,462
22400219,4,106,1.0,0.5660377358490566,462,356
22400219,4,108,-3.0,-1.6666666666666665,356,248
22400219,4,244,7.0,1.7213114754098362,248,4
22400220,1,306,3.0,0.5882352941176471,720,414
22400220,1,142,0.0,0.0,356,214
22400220,1,14,0.0,0.0,198,184
22400220,1,61,-2.0,-1.9672131147540985,170,109
22400220,1,109,-2.0,-1.1009174311926606,109,0
22400220,2,138,7.0,3.0434782608695654,720,582
22400220,2,24,0.0,0.0,581,557
22400220,2,21,-1.0,-2.8571428571428568,554,533
22400220,2,52,3.0,3.4615384615384617,533,481
22400220,2,143,0.0,0.0,460,317
22400220,2,94,5.0,3.1914893617021276,306,212
22400220,2,5,0.0,0.0,200,195
22400220,2,116,-1.0,-0.5172413793103449,180,64
22400220,2,64,0.0,0.0,64,0
22400220,3,223,-7.0,-1.883408071748879,720,497
22400220,3,166,-4.0,-1.4457831325301205,475,309
22400220,3,21,1.0,2.8571428571428568,309,288
22400220,3,123,1.0,0.48780487804878053,288,165
22400220,3,98,-4.0,-2.4489795918367343,152,54
22400220,3,54,2.0,2.2222222222222223,54,0
22400220,4,230,-2.0,-0.5217391304347826,720,490
22400220,4,20,2.0,6.0,479,459
22400220,4,61,-1.0,-0.9836065573770493,442,381
22400220,4,55,1.0,1.0909090909090908,371,316
22400220,4,3,0.0,0.0,316,313
22400220,4,295,-3.0,-0.6101694915254237,295,0
22400221,1,158,-4.0,-1.5189873417721518,720,562
22400221,1,111,-5.0,-2.7027027027027026,562,451
22400221,1,55,1.0,1.0909090909090908,451,396
22400221,1,145,5.0,2.0689655172413794,375,230
22400221,1,35,3.0,5.142857142857143,222,187
22400221,1,50,-2.0,-2.4,187,137
22400221,1,116,3.0,1.5517241379310345,116,0
22400221,2,165,1.0,0.36363636363636365,720,555
22400221,2,95,1.0,0.631578947368421,552,457
22400221,2,7,0.0,0.0,441,434
22400221,2,136,0.0,0.0,434,298
22400221,2,47,-2.0,-2.5531914893617023,179,132
22400221,2,123,-1.0,-0.48780487804878053,123,0
22400221,3,295,4.0,0.8135593220338982,720,425
22400221,3,48,4.0,5.0,416,368
22400221,3,51,3.0,3.5294117647058822,368,317
22400221,3,36,0.0,0.0,307,271
22400221,3,38,-1.0,-1.5789473684210527,260,222
22400221,3,85,5.0,3.5294117647058822,214,129
22400221,3,129,-3.0,-1.3953488372093024,129,0
22400221,4,132,-2.0,-0.9090909090909092,720,588
22400221,4,46,2.0,2.608695652173913,588,542
22400221,4,116,0.0,0.0,532,416
22400221,4,82,4.0,2.926829268292683,405,323
22400221,4,37,-1.0,-1.6216216216216217,305,268
22400221,4,71,4.0,3.380281690140845,268,197
22400221,4,184,-2.0,-0.6521739130434783,184,0
22400222,1,373,-13.0,-2.091152815013405,720,347
22400222,1,41,3.0,4.390243902439024,339,298
22400222,1,30,0.0,0.0,286,256
22400222,1,62,2.0,1.935483870967742,256,194
22400222,1,2,0.0,0.0,178,176
22400222,1,154,3.0,1.1688311688311688,154,0
22400222,2,191,0.0,0.0,720,529
22400222,2,43,4.0,5.5813953488372094,529,486
22400222,2,41,-4.0,-5.853658536585366,486,445
22400222,2,87,3.0,2.0689655172413794,427,340
22400222,2,140,3.0,1.2857142857142858,329,189
22400222,2,43,-4.0,-5.5813953488372094,189,146
22400222,2,52,0.0,0.0,146,94
22400222,3,392,0.0,0.0,720,328
22400222,3,38,-2.0,-3.1578947368421053,309,271
22400222,3,7,0.0,0.0,271,264
22400222,3,113,5.0,2.6548672566371683,247,134
22400222,3,73,4.0,3.287671232876712,73,0
22400222,4,235,6.0,1.5319148936170213,720,485
22400222,4,28,-1.0,-2.142857142857143,476,448
22400222,4,129,-5.0,-2.3255813953488373,448,319
22400222,4,186,-5.0,-1.6129032258064517,297,111
22400222,4,60,2.0,2.0,102,42
22400223,1,191,1.0,0.31413612565445026,720,529
22400223,1,257,-10.0,-2.3346303501945527,529,272
22400223,1,81,4.0,2.962962962962963,272,191
22400223,1,143,4.0,1.6783216783216783,174,31
22400223,1,31,0.0,0.0,31,0
22400223,2,49,-4.0,-4.897959183673469,720,671
22400223,2,54,3.0,3.333333333333333,652,598
22400223,2,126,1.0,0.47619047619047616,589,463
22400223,2,88,-3.0,-2.0454545454545454,454,366
22400223,2,35,-5.0,-8.571428571428571,356,321
22400223,2,20,0.0,0.0,302,282
22400223,2,55,3.0,3.2727272727272725,272,217
22400223,2,91,1.0,0.6593406593406594,210,119
22400223,2,105,-3.0,-1.7142857142857142,105,0
22400223,3,239,-2.0,-0.502092050209205,720,481
22400223,3,45,1.0,1.3333333333333335,481,436
22400223,3,48,1.0,1.25,422,374
22400223,3,112,4.0,2.142857142857143,374,262
22400223,3,56,2.0,2.142857142857143,238,182
22400223,3,76,2.0,1.5789473684210527,175,99
22400223,3,31,3.0,5.806451612903226,90,59
22400223,3,45,3.0,4.0,45,0
22400223,4,131,-4.0,-1.83206106870229,720,589
22400223,4,115,5.0,2.608695652173913,589,474
22400223,4,44,1.0,1.3636363636363638,460,416
22400223,4,169,-4.0,-1.4201183431952662,406,237
22400223,4,41,1.0,1.4634146341463414,228,187
22400223,4,77,-3.0,-2.3376623376623376,168,91
22400223,4,53,1.0,1.1320754716981132,78,25
22400223,4,1,0.0,0.0,2,1
22400223,5,265,3.0,0.6792452830188679,300,35
22400223,5,18,0.0,0.0,18,0
22400224,1,289,6.0,1.245674740484429,720,431
22400224,1,51,3.0,3.5294117647058822,431,380
22400224,1,5,0.0,0.0,369,364
22400224,1,30,3.0,6.0,356,326
22400224,1,114,-6.0,-3.1578947368421053,323,209
22400224,1,59,-1.0,-1.0169491525423728,95,36
22400224,1,28,-2.0,-4.285714285714286,33,5
22400224,2,236,4.0,1.0169491525423728,720,484
22400224,2,22,0.0,0.0,461,439
22400224,2,98,1.0,0.6122448979591836,430,332
22400224,2,78,-4.0,-3.0769230769230766,319,241
22400224,2,31,-2.0,-3.870967741935484,222,191
22400224,2,32,2.0,3.75,187,155
22400224,2,132,-8.0,-3.6363636363636367,135,3
22400224,3,360,9.0,1.5,720,360
22400224,3,8,1.0,7.5,342,334
22400224,3,70,2.0,1.7142857142857142,334,264
22400224,3,11,0.0,0.0,257,246
22400224,3,58,5.0,5.172413793103448,246,188
22400224,3,8,1.0,7.5,173,165
22400224,3,126,3.0,1.4285714285714284,165,39
22400224,3,39,-2.0,-3.0769230769230766,39,0
22400224,4,104,0.0,0.0,720,616
22400224,4,54,-2.0,-2.2222222222222223,616,562
22400224,4,112,2.0,1.0714285714285714,562,450
22400224,4,136,-9.0,-3.9705882352941178,420,284
22400224,4,227,-6.0,-1.5859030837004406,258,31
22400224,4,10,1.0,6.0,10,0
22400225,1,279,11.0,2.365591397849462,720,441
22400225,1,65,-1.0,-0.9230769230769231,422,357
22400225,1,8,0.0,0.0,357,349
22400225,1,94,-1.0,-0.6382978723404256,349,255
22400225,1,7,0.0,0.0,242,235
22400225,1,70,0.0,0.0,226,156
22400225,1,28,-4.0,-8.571428571428571,148,120
22400225,2,56,-2.0,-2.142857142857143,720,664
22400225,2,18,-2.0,-6.666666666666666,664,646
22400225,2,48,0.0,0.0,629,581
22400225,2,25,1.0,2.4,581,556
22400225,2,54,0.0,0.0,556,502
22400225,2,30,2.0,4.0,489,459
22400225,2,127,-2.0,-0.9448818897637795,459,332
22400225,2,84,3.0,2.142857142857143,318,234
22400225,2,25,-2.0,-4.8,234,209
22400225,2,26,0.0,0.0,193,167
22400225,2,71,-1.0,-0.8450704225352113,167,96
22400225,2,96,-5.0,-3.125,96,0
22400225,3,266,-7.0,-1.5789473684210527,720,454
22400225,3,60,-3.0,-3.0,454,394
22400225,3,154,-1.0,-0.38961038961038963,385,231
22400225,3,75,1.0,0.8,231,156
22400225,3,97,4.0,2.4742268041237114,156,59
22400225,4,97,3.0,1.8556701030927836,720,623
22400225,4,41,5.0,7.317073170731707,617,576
22400225,4,10,-1.0,-6.0,560,550
22400225,4,78,2.0,1.5384615384615383,550,472
22400225,4,49,-2.0,-2.4489795918367343,457,408
22400225,4,35,0.0,0.0,396,361
22400225,4,77,-1.0,-0.7792207792207793,351,274
22400225,4,31,3.0,5.806451612903226,259,228
22400225,4,149,1.0,0.40268456375838924,213,64
22400225,4,23,1.0,2.608695652173913,47,24
22400225,4,2,0.0,0.0,19,17
22400225,4,7,-1.0,-8.571428571428571,17,10
22400225,4,10,0.0,0.0,10,0
22400226,1,205,-9.0,-2.6341463414634143,720,515
22400226,1,114,0.0,0.0,493,379
22400226,1,12,0.0,0.0,379,367
22400226,1,80,-1.0,-0.75,362,282
22400226,1,28,0.0,0.0,267,239
22400226,1,70,4.0,3.4285714285714284,233,163
22400226,1,15,-1.0,-4.0,147,132
22400226,1,72,-1.0,-0.8333333333333333,132,60
22400226,1,55,0.0,0.0,55,0
22400226,2,187,4.0,1.2834224598930482,720,533
22400226,2,37,-3.0,-4.864864864864865,533,496
22400226,2,185,4.0,1.2972972972972974,489,304
22400226,2,141,4.0,1.702127659574468,285,144
22400226,2,47,2.0,2.5531914893617023,144,97
22400226,3,288,1.0,0.20833333333333331,720,432
22400226,3,66,4.0,3.6363636363636367,432,366
22400226,3,118,-7.0,-3.5593220338983054,366,248
22400226,3,8,-2.0,-15.0,233,225
22400226,3,54,1.0,1.1111111111111112,201,147
22400226,4,122,7.0,3.4426229508196724,720,598
22400226,4,72,0.0,0.0,580,508
22400226,4,81,2.0,1.4814814814814814,488,407
22400226,4,24,1.0,2.5,407,383
22400226,4,104,-1.0,-0.576923076923077,383,279
22400226,4,92,-2.0,-1.3043478260869565,258,166
22400226,4,42,-1.0,-1.4285714285714284,150,108
22400226,4,57,2.0,2.1052631578947367,108,51
22400227,1,262,9.0,2.0610687022900764,720,458
22400227,1,62,3.0,2.903225806451613,446,384
22400227,1,133,-3.0,-1.3533834586466165,384,251
22400227,1,53,-2.0,-2.2641509433962264,251,198
22400227,1,58,-1.0,-1.0344827586206897,182,124
22400227,1,117,-4.0,-2.0512820512820515,124,7
22400227,1,3,0.0,0.0,3,0
22400227,2,120,0.0,0.0,720,600
22400227,2,68,3.0,2.647058823529412,592,524
22400227,2,161,-1.0,-0.37267080745341613,515,354
22400227,2,177,3.0,1.0169491525423728,335,158
22400227,2,3,0.0,0.0,150,147
22400227,2,34,-2.0,-3.5294117647058822,147,113
22400227,2,113,-7.0,-3.7168141592920354,113,0
22400227,3,212,-7.0,-1.9811320754716981,720,508
22400227,3,193,9.0,2.7979274611398965,497,304
22400227,3,53,2.0,2.2641509433962264,293,240
22400227,3,59,-1.0,-1.0169491525423728,232,173
22400227,3,8,0.0,0.0,162,154
22400227,3,88,6.0,4.090909090909091,142,54
22400227,3,54,-1.0,-1.1111111111111112,54,0
22400227,4,83,-6.0,-4.337349397590361,720,637
22400227,4,1,0.0,0.0,622,621
22400227,4,136,6.0,2.647058823529412,610,474
22400227,4,111,7.0,3.7837837837837833,458,347
22400227,4,162,2.0,0.7407407407407407,336,174
22400228,1,229,1.0,0.26200873362445415,720,491
22400228,1,38,-1.0,-1.5789473684210527,472,434
22400228,1,37,-2.0,-3.2432432432432434,412,375
22400228,1,72,-1.0,-0.8333333333333333,375,303
22400228,1,68,-2.0,-1.7647058823529411,282,214
22400228,1,26,3.0,6.923076923076923,199,173
22400228,1,67,2.0,1.791044776119403,152,85
22400228,2,47,-2.0,-2.5531914893617023,720,673
22400228,2,97,6.0,3.711340206185567,673,576
22400228,2,71,-2.0,-1.6901408450704225,576,505
22400228,2,40,2.0,3.0,484,444
22400228,2,15,0.0,0.0,421,406
22400228,2,31,0.0,0.0,397,366
22400228,2,116,-5.0,-2.586206896551724,355,239
22400228,2,44,0.0,0.0,239,195
22400228,2,93,2.0,1.2903225806451615,183,90
22400228,2,67,0.0,0.0,90,23
22400228,2,23,-2.0,-5.217391304347826,23,0
22400228,3,188,1.0,0.3191489361702128,720,532
22400228,3,63,3.0,2.8571428571428568,532,469
22400228,3,23,3.0,7.826086956521739,447,424
22400228,3,59,-5.0,-5.084745762711864,415,356
22400228,3,21,0.0,0.0,336,315
22400228,3,29,2.0,4.137931034482759,311,282
22400228,3,112,4.0,2.142857142857143,262,150
22400228,3,150,2.0,0.8,150,0
22400228,4,125,-4.0,-1.92,720,595
22400228,4,126,1.0,0.47619047619047616,595,469
22400228,4,3,0.0,0.0,460,457
22400228,4,38,2.0,3.1578947368421053,418,380
22400228,4,329,-7.0,-1.2765957446808511,365,36
22400228,4,27,-1.0,-2.2222222222222223,27,0
22400229,1,316,0.0,0.0,720,404
22400229,1,62,2.0,1.935483870967742,381,319
22400229,1,2,0.0,0.0,319,317
22400229,1,131,-6.0,-2.7480916030534353,309,178
22400229,1,86,4.0,2.7906976744186047,168,82
22400229,1,23,-2.0,-5.217391304347826,82,59
22400229,1,59,0.0,0.0,59,0
22400229,2,80,3.0,2.25,720,640
22400229,2,36,0.0,0.0,618,582
22400229,2,60,-2.0,-2.0,582,522
22400229,2,80,2.0,1.5,522,442
22400229,2,52,0.0,0.0,428,376
22400229,2,19,-2.0,-6.315789473684211,366,347
22400229,2,10,0.0,0.0,331,321
22400229,2,118,-3.0,-1.5254237288135595,316,198
22400229,2,75,0.0,0.0,193,118
22400229,2,44,0.0,0.0,108,64
22400229,2,64,2.0,1.875,64,0
22400229,3,357,7.0,1.1764705882352942,720,363
22400229,3,88,-1.0,-0.6818181818181819,348,260
22400229,3,121,-5.0,-2.479338842975207,260,139
22400229,3,31,0.0,0.0,130,99
22400229,3,92,0.0,0.0,99,7
22400229,4,41,-2.0,-2.926829268292683,720,679
22400229,4,104,1.0,0.576923076923077,675,571
22400229,4,66,2.0,1.8181818181818183,571,505
22400229,4,134,-2.0,-0.8955223880597015,482,348
22400229,4,134,0.0,0.0,333,199
22400229,4,18,0.0,0.0,184,166
22400229,4,99,5.0,3.0303030303030303,166,67
22400229,4,48,-5.0,-6.25,67,19
22400229,4,6,0.0,0.0,6,0
22400230,1,332,8.0,1.4457831325301205,720,388
22400230,1,37,-2.0,-3.2432432432432434,388,351
22400230,1,23,-3.0,-7.826086956521739,351,328
22400230,1,131,-1.0,-0.4580152671755725,313,182
22400230,1,122,4.0,1.9672131147540985,172,50
22400230,1,47,-4.0,-5.1063829787234045,47,0
22400230,2,67,1.0,0.8955223880597015,720,653
22400230,2,137,5.0,2.18978102189781,653,516
22400230,2,88,-1.0,-0.6818181818181819,516,428
22400230,2,30,-2.0,-4.0,428,398
22400230,2,34,-3.0,-5.294117647058824,382,348
22400230,2,96,2.0,1.25,337,241
22400230,2,101,3.0,1.782178217821782,241,140
22400230,2,115,-2.0,-1.0434782608695652,119,4
22400230,3,152,-8.0,-3.1578947368421053,720,568
22400230,3,165,3.0,1.0909090909090908,554,389
22400230,3,22,0.0,0.0,377,355
22400230,3,67,6.0,5.3731343283582085,342,275
22400230,3,8,2.0,15.0,270,262
22400230,3,106,5.0,2.8301886792452833,246,140
22400230,3,87,-2.0,-1.3793103448275863,139,52
22400230,4,245,0.0,0.0,720,475
22400230,4,95,-1.0,-0.631578947368421,456,361
22400230,4,155,5.0,1.935483870967742,352,197
22400230,4,188,-4.0,-1.2765957446808511,188,0
22400230,5,190,-4.0,-1.263157894736842,300,110
22400230,5,74,3.0,2.4324324324324325,94,20
22400231,1,377,8.0,1.273209549071618,720,343
22400231,1,61,0.0,0.0,326,265
22400231,1,114,0.0,0.0,265,151
22400231,1,76,-2.0,-1.5789473684210527,151,75
22400231,1,71,1.0,0.8450704225352113,75,4
22400231,2,117,1.0,0.5128205128205129,720,603
22400231,2,160,1.0,0.375,603,443
22400231,2,54,2.0,2.2222222222222223,428,374
22400231,2,93,5.0,3.2258064516129035,371,278
22400231,2,180,-5.0,-1.6666666666666665,262,82
22400231,2,31,1.0,1.935483870967742,82,51
22400231,2,49,0.0,0.0,51,2
22400231,3,334,-4.0,-0.718562874251497,720,386
22400231,3,48,-2.0,-2.5,384,336
22400231,3,35,-2.0,-3.4285714285714284,320,285
22400231,3,85,1.0,0.7058823529411764,285,200
22400231,3,77,0.0,0.0,200,123
22400231,4,71,-4.0,-3.380281690140845,720,649
22400231,4,84,1.0,0.7142857142857142,633,549
22400231,4,53,5.0,5.660377358490567,549,496
22400231,4,38,2.0,3.1578947368421053,472,434
22400231,4,66,1.0,0.9090909090909092,421,355
22400231,4,107,1.0,0.5607476635514018,355,248
22400231,4,228,0.0,0.0,232,4
22400232,1,271,2.0,0.44280442804428044,720,449
22400232,1,9,3.0,20.0,430,421
22400232,1,58,-3.0,-3.103448275862069,402,344
22400232,1,28,-3.0,-6.428571428571428,333,305
22400232,1,68,1.0,0.8823529411764706,305,237
22400232,1,25,2.0,4.8,225,200
22400232,1,54,-8.0,-8.88888888888889,177,123
22400232,1,108,0.0,0.0,108,0
22400232,2,155,1.0,0.3870967741935484,720,565
22400232,2,49,0.0,0.0,565,516
22400232,2,26,0.0,0.0,507,481
22400232,2,69,-1.0,-0.8695652173913043,481,412
22400232,2,21,-1.0,-2.8571428571428568,412,391
22400232,2,13,1.0,4.615384615384616,391,378
22400232,2,82,2.0,1.4634146341463414,378,296
22400232,2,144,3.0,1.25,296,152
22400232,2,133,2.0,0.9022556390977443,144,11
22400232,3,237,3.0,0.7594936708860759,720,483
22400232,3,29,3.0,6.206896551724138,483,454
22400232,3,119,3.0,1.5126050420168067,454,335
22400232,3,89,6.0,4.044943820224719,300,211
22400232,3,26,2.0,4.615384615384616,200,174
22400232,3,46,1.0,1.3043478260869565,167,121
22400232,3,343,1.0,0.1749271137026239,367,24
22400232,4,152,0.0,0.0,720,568
22400232,4,1,0.0,0.0,558,557
22400232,4,10,0.0,0.0,544,534
22400232,4,31,1.0,1.935483870967742,515,484
22400232,4,70,0.0,0.0,484,414
22400232,4,83,-1.0,-0.7228915662650602,414,331
22400232,4,49,-2.0,-2.4489795918367343,331,282
22400232,4,279,-1.0,-0.21505376344086022,279,0
22400233,1,354,0.0,0.0,720,366
22400233,1,53,0.0,0.0,366,313
22400233,1,16,-3.0,-11.25,313,297
22400233,1,38,0.0,0.0,227,189
22400233,1,16,0.0,0.0,180,164
22400233,1,97,0.0,0.0,138,41
22400233,1,3,0.0,0.0,33,30
22400233,2,193,3.0,0.9326424870466321,720,527
22400233,2,34,2.0,3.5294117647058822,512,478
22400233,2,58,-3.0,-3.103448275862069,468,410
22400233,2,119,4.0,2.0168067226890756,410,291
22400233,2,45,0.0,0.0,267,222
22400233,2,70,-2.0,-1.7142857142857142,215,145
22400233,2,145,-9.0,-3.7241379310344827,145,0
22400233,3,182,-7.0,-2.307692307692308,720,538
22400233,3,105,0.0,0.0,527,422
22400233,3,39,-2.0,-3.0769230769230766,422,383
22400233,3,30,-1.0,-2.0,374,344
22400233,3,58,-3.0,-3.103448275862069,344,286
22400233,3,116,1.0,0.5172413793103449,286,170
22400233,3,87,2.0,1.3793103448275863,150,63
22400233,4,108,-5.0,-2.7777777777777777,720,612
22400233,4,125,1.0,0.48,606,481
22400233,4,55,1.0,1.0909090909090908,481,426
22400233,4,83,2.0,1.4457831325301205,424,341
22400233,4,112,2.0,1.0714285714285714,341,229
22400233,4,104,-1.0,-0.576923076923077,218,114
22400233,4,111,5.0,2.7027027027027026,114,3
22400233,4,1,1.0,60.0,1,0
22400234,1,173,-5.0,-1.7341040462427746,720,547
22400234,1,132,-3.0,-1.3636363636363638,545,413
22400234,1,135,0.0,0.0,413,278
22400234,1,33,0.0,0.0,270,237
22400234,1,140,-7.0,-3.0,237,97
22400234,1,50,3.0,3.5999999999999996,83,33
22400234,1,6,0.0,0.0,33,27
22400234,1,6,0.0,0.0,6,0
22400234,2,124,-4.0,-1.935483870967742,720,596
22400234,2,20,2.0,6.0,584,564
22400234,2,60,2.0,2.0,549,489
22400234,2,58,1.0,1.0344827586206897,486,428
22400234,2,20,0.0,0.0,418,398
22400234,2,30,-1.0,-2.0,398,368
22400234,2,42,-1.0,-1.4285714285714284,359,317
22400234,2,204,-4.0,-1.1764705882352942,299,95
22400234,2,46,-1.0,-1.3043478260869565,72,26
22400234,2,26,1.0,2.307692307692308,26,0
22400234,3,225,2.0,0.5333333333333333,720,495
22400234,3,123,3.0,1.4634146341463414,489,366
22400234,3,97,4.0,2.4742268041237114,351,254
22400234,3,254,-2.0,-0.47244094488188976,254,0
22400234,4,92,-4.0,-2.608695652173913,720,628
22400234,4,52,2.0,2.307692307692308,628,576
22400234,4,103,4.0,2.3300970873786406,566,463
22400234,4,15,0.0,0.0,451,436
22400234,4,36,-2.0,-3.333333333333333,436,400
22400234,4,118,-2.0,-1.0169491525423728,392,274
22400234,4,13,2.0,9.230769230769232,252,239
22400234,4,57,-2.0,-2.1052631578947367,239,182
22400234,4,121,5.0,2.479338842975207,167,46
22400234,4,31,0.0,0.0,33,2
22400235,1,283,5.0,1.0600706713780919,720,437
22400235,1,138,-2.0,-0.8695652173913043,437,299
22400235,1,25,1.0,2.4,294,269
22400235,1,73,0.0,0.0,269,196
22400235,1,178,2.0,0.6741573033707865,178,0
22400235,2,193,-6.0,-1.8652849740932642,720,527
22400235,2,22,4.0,10.90909090909091,525,503
22400235,2,77,0.0,0.0,488,411
22400235,2,21,-1.0,-2.8571428571428568,410,389
22400235,2,84,-1.0,-0.7142857142857142,389,305
22400235,2,75,2.0,1.6,282,207
22400235,2,195,-2.0,-0.6153846153846154,197,2
22400235,3,281,8.0,1.7081850533807827,720,439
22400235,3,88,3.0,2.0454545454545454,418,330
22400235,3,24,0.0,0.0,330,306
22400235,3,67,5.0,4.477611940298507,297,230
22400235,3,109,-4.0,-2.2018348623853212,217,108
22400235,3,33,-1.0,-1.8181818181818183,97,64
22400235,3,35,2.0,3.4285714285714284,64,29
22400235,3,22,0.0,0.0,22,0
22400235,4,67,2.0,1.791044776119403,720,653
22400235,4,81,-6.0,-4.444444444444445,650,569
22400235,4,16,0.0,0.0,569,553
22400235,4,90,-2.0,-1.3333333333333335,536,446
22400235,4,163,0.0,0.0,425,262
22400235,4,212,3.0,0.8490566037735849,262,50
22400235,4,50,3.0,3.5999999999999996,50,0
22400236,1,290,9.0,1.8620689655172413,720,430
22400236,1,146,2.0,0.821917808219178,423,277
22400236,1,20,0.0,0.0,277,257
22400236,1,43,2.0,2.7906976744186047,247,204
22400236,1,8,-2.0,-15.0,156,148
22400236,1,148,-1.0,-0.40540540540540543,148,0
22400236,2,131,1.0,0.4580152671755725,720,589
22400236,2,154,1.0,0.38961038961038963,576,422
22400236,2,18,2.0,6.666666666666666,422,404
22400236,2,100,-1.0,-0.6,382,282
22400236,2,77,-3.0,-2.3376623376623376,282,205
22400236,2,105,2.0,1.142857142857143,205,100
22400236,2,74,-1.0,-0.8108108108108109,100,26
22400236,2,23,0.0,0.0,23,0
22400236,3,118,-4.0,-2.0338983050847457,720,602
22400236,3,183,-2.0,-0.6557377049180327,593,410
22400236,3,62,1.0,0.967741935483871,390,328
22400236,3,39,-2.0,-3.0769230769230766,311,272
22400236,3,27,0.0,0.0,272,245
22400236,3,13,1.0,4.615384615384616,233,220
22400236,3,64,-2.0,-1.875,209,145
22400236,3,15,0.0,0.0,145,130
22400236,3,110,-5.0,-2.7272727272727275,110,0
22400236,4,101,3.0,1.782178217821782,720,619
22400236,4,53,3.0,3.3962264150943398,610,557
22400236,4,32,-2.0,-3.75,540,508
22400236,4,112,0.0,0.0,491,379
22400236,4,51,0.0,0.0,370,319
22400236,4,89,1.0,0.6741573033707865,315,226
22400236,4,62,3.0,2.903225806451613,226,164
22400236,4,56,2.0,2.142857142857143,150,94
22400236,4,30,-2.0,-4.0,94,64
22400236,4,63,2.0,1.9047619047619047,64,1
22400237,1,209,-10.0,-2.8708133971291865,720,511
22400237,1,124,3.0,1.4516129032258065,502,378
22400237,1,42,-1.0,-1.4285714285714284,364,322
22400237,1,47,1.0,1.2765957446808511,308,261
22400237,1,99,-2.0,-1.2121212121212122,261,162
22400237,1,58,0.0,0.0,162,104
22400237,1,96,-1.0,-0.625,96,0
22400237,2,91,0.0,0.0,720,629
22400237,2,58,4.0,4.137931034482759,629,571
22400237,2,86,-4.0,-2.7906976744186047,554,468
22400237,2,65,2.0,1.8461538461538463,455,390
22400237,2,141,3.0,1.2765957446808511,390,249
22400237,2,89,-1.0,-0.6741573033707865,249,160
22400237,2,79,-2.0,-1.5189873417721518,159,80
22400237,3,308,-9.0,-1.7532467532467533,720,412
22400237,3,33,0.0,0.0,412,379
22400237,3,23,3.0,7.826086956521739,376,353
22400237,3,59,-2.0,-2.0338983050847457,353,294
22400237,3,48,-5.0,-6.25,287,239
22400237,3,97,0.0,0.0,224,127
22400237,3,119,-2.0,-1.0084033613445378,119,0
22400237,4,41,2.0,2.926829268292683,720,679
22400237,4,31,2.0,3.870967741935484,671,640
22400237,4,114,3.0,1.5789473684210527,625,511
22400237,4,65,-2.0,-1.8461538461538463,506,441
22400237,4,97,-6.0,-3.711340206185567,431,334
22400237,4,73,-2.0,-1.643835616438356,334,261
22400237,4,7,-1.0,-8.571428571428571,247,240
22400237,4,22,2.0,5.454545454545455,240,218
22400237,4,211,3.0,0.8530805687203791,211,0
22400238,1,248,-4.0,-0.967741935483871,720,472
22400238,1,28,0.0,0.0,455,427
22400238,1,69,4.0,3.4782608695652173,411,342
22400238,1,95,-2.0,-1.263157894736842,339,244
22400238,1,94,3.0,1.9148936170212765,231,137
22400238,1,15,0.0,0.0,114,99
22400238,1,89,1.0,0.6741573033707865,99,10
22400238,1,10,0.0,0.0,10,0
22400238,2,94,2.0,1.2765957446808511,720,626
22400238,2,75,6.0,4.8,626,551
22400238,2,38,2.0,3.1578947368421053,532,494
22400238,2,110,2.0,1.0909090909090908,478,368
22400238,2,53,-2.0,-2.2641509433962264,351,298
22400238,2,4,-2.0,-30.0,292,288
22400238,2,159,2.0,0.7547169811320755,280,121
22400238,2,94,0.0,0.0,94,0
22400238,3,188,10.0,3.1914893617021276,720,532
22400238,3,124,-1.0,-0.4838709677419355,509,385
22400238,3,85,0.0,0.0,373,288
22400238,3,128,2.0,0.9375,288,160
22400238,3,74,0.0,0.0,144,70
22400238,3,31,2.0,3.870967741935484,56,25
22400238,3,9,0.0,0.0,9,0
22400238,4,176,1.0,0.34090909090909094,720,544
22400238,4,171,-4.0,-1.4035087719298245,544,373
22400238,4,32,0.0,0.0,364,332
22400238,4,1,0.0,0.0,322,321
22400238,4,35,0.0,0.0,301,266
22400238,4,61,-2.0,-1.9672131147540985,266,205
22400238,4,111,4.0,2.1621621621621623,193,82
22400238,4,42,0.0,0.0,65,23
22400238,4,9,0.0,0.0,9,0
22400239,1,318,-7.0,-1.320754716981132,720,402
22400239,1,31,0.0,0.0,386,355
22400239,1,4,0.0,0.0,355,351
22400239,1,23,-4.0,-10.434782608695652,344,321
22400239,1,27,0.0,0.0,304,277
22400239,1,42,5.0,7.142857142857142,265,223
22400239,1,119,-6.0,-3.0252100840336134,205,86
22400239,1,86,2.0,1.3953488372093024,86,0
22400239,2,73,0.0,0.0,720,647
22400239,2,92,1.0,0.6521739130434783,647,555
22400239,2,41,2.0,2.926829268292683,548,507
22400239,2,21,0.0,0.0,485,464
22400239,2,110,-3.0,-1.6363636363636362,464,354
22400239,2,39,1.0,1.5384615384615383,354,315
22400239,2,46,-1.0,-1.3043478260869565,308,262
22400239,2,90,4.0,2.666666666666667,262,172
22400239,2,42,1.0,1.4285714285714284,157,115
22400239,3,287,-2.0,-0.4181184668989547,720,433
22400239,3,1,0.0,0.0,419,418
22400239,3,42,2.0,2.8571428571428568,401,359
22400239,3,5,2.0,24.0,349,344
22400239,3,130,10.0,4.615384615384616,325,195
22400239,3,43,-1.0,-1.3953488372093024,195,152
22400239,3,152,8.0,3.1578947368421053,152,0
22400239,4,20,-1.0,-3.0,720,700
22400239,4,39,3.0,4.615384615384616,700,661
22400239,4,13,-3.0,-13.846153846153847,650,637
22400239,4,27,0.0,0.0,605,578
22400239,4,45,-2.0,-2.666666666666667,574,529
22400239,4,172,-6.0,-2.0930232558139537,529,357
22400239,4,57,0.0,0.0,347,290
22400239,4,124,-5.0,-2.4193548387096775,279,155
22400239,4,245,5.0,1.2244897959183672,263,18
22400239,4,4,1.0,15.0,15,11
22400240,1,279,2.0,0.43010752688172044,720,441
22400240,1,75,-3.0,-2.4,441,366
22400240,1,13,0.0,0.0,366,353
22400240,1,43,0.0,0.0,353,310
22400240,1,23,-3.0,-7.826086956521739,310,287
22400240,1,40,3.0,4.5,279,239
22400240,1,81,-3.0,-2.2222222222222223,239,158
22400240,1,41,-1.0,-1.4634146341463414,145,104
22400240,1,61,4.0,3.934426229508197,104,43
22400240,1,32,0.0,0.0,32,0
22400240,2,152,9.0,3.552631578947368,720,568
22400240,2,14,0.0,0.0,558,544
22400240,2,43,-1.0,-1.3953488372093024,536,493
22400240,2,138,1.0,0.43478260869565216,493,355
22400240,2,147,4.0,1.6326530612244898,338,191
22400240,2,21,-6.0,-17.142857142857142,182,161
22400240,3,267,3.0,0.6741573033707865,720,453
22400240,3,113,3.0,1.592920353982301,447,334
22400240,3,72,-2.0,-1.6666666666666665,332,260
22400240,3,28,0.0,0.0,260,232
22400240,3,49,0.0,0.0,214,165
22400240,3,89,-2.0,-1.348314606741573,155,66
22400240,3,11,1.0,5.454545454545455,66,55
22400240,4,184,-6.0,-1.9565217391304348,720,536
22400240,4,75,-2.0,-1.6,515,440
22400240,4,93,1.0,0.6451612903225807,440,347
22400240,4,37,2.0,3.2432432432432434,347,310
22400240,4,35,1.0,1.7142857142857142,310,275
22400240,4,198,3.0,0.9090909090909092,275,77
22400240,4,77,-3.0,-2.3376623376623376,77,0
22400241,1,241,1.0,0.24896265560165975,720,479
22400241,1,138,2.0,0.8695652173913043,470,332
22400241,1,14,0.0,0.0,332,318
22400241,1,80,-2.0,-1.5,306,226
22400241,1,41,1.0,1.4634146341463414,218,177
22400241,1,67,0.0,0.0,165,98
22400241,1,90,-3.0,-2.0,90,0
22400241,2,182,0.0,0.0,720,538
22400241,2,11,0.0,0.0,538,527
22400241,2,4,0.0,0.0,527,523
22400241,2,31,0.0,0.0,510,479
22400241,2,113,-4.0,-2.1238938053097343,474,361
22400241,2,41,-2.0,-2.926829268292683,360,319
22400241,2,119,-5.0,-2.521008403361345,295,176
22400241,2,32,4.0,7.5,162,130
22400241,3,111,-9.0,-4.864864864864865,720,609
22400241,3,90,-3.0,-2.0,601,511
22400241,3,88,-1.0,-0.6818181818181819,511,423
22400241,3,195,-2.0,-0.6153846153846154,416,221
22400241,3,16,0.0,0.0,221,205
22400241,3,66,1.0,0.9090909090909092,200,134
22400241,3,47,2.0,2.5531914893617023,119,72
22400241,3,69,-2.0,-1.7391304347826086,69,0
22400241,4,237,4.0,1.0126582278481011,720,483
22400241,4,58,-2.0,-2.0689655172413794,483,425
22400241,4,22,1.0,2.7272727272727275,425,403
22400241,4,27,-1.0,-2.2222222222222223,403,376
22400241,4,78,-4.0,-3.0769230769230766,376,298
22400241,4,41,-2.0,-2.926829268292683,298,257
22400241,4,248,-2.0,-0.4838709677419355,248,0
22400242,1,206,-7.0,-2.0388349514563107,720,514
22400242,1,47,3.0,3.829787234042553,507,460
22400242,1,69,-1.0,-0.8695652173913043,460,391
22400242,1,37,3.0,4.864864864864865,391,354
22400242,1,126,3.0,1.4285714285714284,354,228
22400242,1,29,-2.0,-4.137931034482759,222,193
22400242,1,36,0.0,0.0,182,146
22400242,1,49,0.0,0.0,146,97
22400242,1,35,-2.0,-3.4285714285714284,97,62
22400242,1,62,-1.0,-0.967741935483871,62,0
22400242,2,146,-3.0,-1.2328767123287672,720,574
22400242,2,43,0.0,0.0,569,526
22400242,2,79,-1.0,-0.7594936708860759,519,440
22400242,2,84,1.0,0.7142857142857142,440,356
22400242,2,116,0.0,0.0,345,229
22400242,2,41,3.0,4.390243902439024,229,188
22400242,2,9,0.0,0.0,177,168
22400242,2,105,-2.0,-1.142857142857143,168,63
22400242,2,25,-1.0,-2.4,56,31
22400242,2,18,1.0,3.333333333333333,31,13
22400242,3,305,2.0,0.39344262295081966,720,415
22400242,3,86,0.0,0.0,415,329
22400242,3,16,0.0,0.0,314,298
22400242,3,140,0.0,0.0,290,150
22400242,3,97,1.0,0.6185567010309279,140,43
22400242,3,29,-2.0,-4.137931034482759,30,1
22400242,4,117,-6.0,-3.0769230769230766,720,603
22400242,4,83,0.0,0.0,595,512
22400242,4,64,-1.0,-0.9375,501,437
22400242,4,60,-3.0,-3.0,437,377
22400242,4,86,3.0,2.0930232558139537,362,276
22400242,4,19,3.0,9.473684210526315,211,192
22400242,4,133,-1.0,-0.45112781954887216,171,38
22400242,4,2,-1.0,-30.0,31,29
22400242,4,6,0.0,0.0,25,19
22400242,4,11,0.0,0.0,19,8
22400242,4,2,0.0,0.0,8,6
22400242,4,4,0.0,0.0,4,0
22400243,1,393,7.0,1.0687022900763359,720,327
22400243,1,14,1.0,4.285714285714286,309,295
22400243,1,64,-4.0,-3.75,295,231
22400243,1,36,2.0,3.333333333333333,231,195
22400243,1,178,4.0,1.348314606741573,178,0
22400243,2,180,0.0,0.0,720,540
22400243,2,56,2.0,2.142857142857143,525,469
22400243,2,12,0.0,0.0,447,435
22400243,2,56,4.0,4.285714285714286,435,379
22400243,2,167,2.0,0.718562874251497,376,209
22400243,2,15,0.0,0.0,209,194
22400243,2,178,5.0,1.6853932584269662,178,0
22400243,3,279,-3.0,-0.6451612903225807,720,441
22400243,3,246,0.0,0.0,429,183
22400243,3,163,2.0,0.7361963190184049,163,0
22400243,4,308,-6.0,-1.1688311688311688,720,412
22400243,4,135,-4.0,-1.777777777777778,412,277
22400243,4,202,0.0,0.0,258,56
22400244,1,328,-5.0,-0.9146341463414633,720,392
22400244,1,111,1.0,0.5405405405405406,371,260
22400244,1,54,-4.0,-4.444444444444445,247,193
22400244,1,60,-3.0,-3.0,193,133
22400244,1,116,-5.0,-2.586206896551724,116,0
22400244,2,72,4.0,3.333333333333333,720,648
22400244,2,71,5.0,4.225352112676057,640,569
22400244,2,73,1.0,0.821917808219178,561,488
22400244,2,55,1.0,1.0909090909090908,488,433
22400244,2,67,-3.0,-2.6865671641791042,419,352
22400244,2,13,0.0,0.0,342,329
22400244,2,31,-2.0,-3.870967741935484,324,293
22400244,2,52,0.0,0.0,277,225
22400244,2,44,1.0,1.3636363636363638,215,171
22400244,2,171,-5.0,-1.7543859649122806,171,0
22400244,3,300,4.0,0.8,720,420
22400244,3,43,0.0,0.0,412,369
22400244,3,17,2.0,7.0588235294117645,360,343
22400244,3,52,-7.0,-8.076923076923077,328,276
22400244,3,80,0.0,0.0,256,176
22400244,3,20,0.0,0.0,176,156
22400244,3,52,2.0,2.307692307692308,143,91
22400244,3,84,0.0,0.0,91,7
22400244,3,7,0.0,0.0,7,0
22400244,4,173,5.0,1.7341040462427746,720,547
22400244,4,12,2.0,10.0,538,526
22400244,4,96,-3.0,-1.875,526,430
22400244,4,84,-7.0,-5.0,418,334
22400244,4,87,2.0,1.3793103448275863,327,240
22400244,4,56,-2.0,-2.142857142857143,227,171
22400244,4,122,1.0,0.49180327868852464,157,35
22400245,1,301,5.0,0.9966777408637875,720,419
22400245,1,178,2.0,0.6741573033707865,406,228
22400245,1,55,-3.0,-3.2727272727272725,228,173
22400245,1,84,-4.0,-2.8571428571428568,166,82
22400245,1,33,-3.0,-5.454545454545455,82,49
22400245,1,45,-3.0,-4.0,49,4
22400245,1,2,0.0,0.0,2,0
22400245,2,130,-9.0,-4.153846153846154,720,590
22400245,2,24,-2.0,-5.0,581,557
22400245,2,140,3.0,1.2857142857142858,557,417
22400245,2,42,2.0,2.8571428571428568,406,364
22400245,2,47,1.0,1.2765957446808511,347,300
22400245,2,293,6.0,1.2286689419795223,300,7
22400245,2,7,0.0,0.0,7,0
22400245,3,285,6.0,1.263157894736842,720,435
22400245,3,84,2.0,1.4285714285714284,418,334
22400245,3,73,0.0,0.0,334,261
22400245,3,49,2.0,2.4489795918367343,243,194
22400245,3,29,2.0,4.137931034482759,194,165
22400245,3,64,2.0,1.875,147,83
22400245,4,195,-2.0,-0.6153846153846154,720,525
22400245,4,102,2.0,1.1764705882352942,521,419
22400245,4,58,4.0,4.137931034482759,396,338
22400245,4,119,-5.0,-2.521008403361345,338,219
22400245,4,140,1.0,0.42857142857142855,202,62
22400245,4,50,0.0,0.0,50,0
22400246,1,362,8.0,1.3259668508287292,720,358
22400246,1,80,-2.0,-1.5,354,274
22400246,1,66,4.0,3.6363636363636367,257,191
22400246,1,97,5.0,3.092783505154639,180,83
22400246,1,71,-3.0,-2.535211267605634,71,0
22400246,2,192,9.0,2.8125,720,528
22400246,2,67,0.0,0.0,528,461
22400246,2,50,-1.0,-1.2,461,411
22400246,2,26,-3.0,-6.923076923076923,401,375
22400246,2,231,-3.0,-0.7792207792207793,369,138
22400246,2,128,-3.0,-1.40625,128,0
22400246,3,329,8.0,1.458966565349544,720,391
22400246,3,107,3.0,1.6822429906542056,371,264
22400246,3,13,0.0,0.0,264,251
22400246,3,69,-2.0,-1.7391304347826086,246,177
22400246,3,163,6.0,2.208588957055215,163,0
22400246,4,58,-4.0,-4.137931034482759,720,662
22400246,4,56,-3.0,-3.214285714285714,653,597
22400246,4,81,-2.0,-1.4814814814814814,597,516
22400246,4,110,-2.0,-1.0909090909090908,501,391
22400246,4,28,2.0,4.285714285714286,377,349
22400246,4,47,-2.0,-2.5531914893617023,346,299
22400246,4,121,6.0,2.975206611570248,281,160
22400246,4,149,-2.0,-0.8053691275167785,149,0
22400247,1,359,4.0,0.6685236768802229,720,361
22400247,1,19,1.0,3.1578947368421053,343,324
22400247,1,80,-1.0,-0.75,324,244
22400247,1,35,-2.0,-3.4285714285714284,244,209
22400247,1,48,0.0,0.0,203,155
22400247,1,1,0.0,0.0,153,152
22400247,1,103,-1.0,-0.5825242718446602,140,37
22400247,1,31,5.0,9.67741935483871,31,0
22400247,2,133,-4.0,-1.8045112781954886,720,587
22400247,2,46,0.0,0.0,569,523
22400247,2,54,-4.0,-4.444444444444445,507,453
22400247,2,86,6.0,4.186046511627907,435,349
22400247,2,61,0.0,0.0,349,288
22400247,2,49,6.0,7.346938775510204,268,219
22400247,2,79,4.0,3.0379746835443036,203,124
22400247,2,7,0.0,0.0,118,111
22400247,2,10,0.0,0.0,105,95
22400247,3,283,6.0,1.2720848056537104,720,437
22400247,3,111,5.0,2.7027027027027026,437,326
22400247,3,57,-3.0,-3.1578947368421053,309,252
22400247,3,45,0.0,0.0,234,189
22400247,3,18,-1.0,-3.333333333333333,187,169
22400247,3,84,1.0,0.7142857142857142,169,85
22400247,3,36,2.0,3.333333333333333,85,49
22400247,3,49,-1.0,-1.2244897959183672,49,0
22400247,4,151,-3.0,-1.1920529801324504,720,569
22400247,4,53,1.0,1.1320754716981132,568,515
22400247,4,70,-2.0,-1.7142857142857142,509,439
22400247,4,43,-2.0,-2.7906976744186047,439,396
22400247,4,51,3.0,3.5294117647058822,383,332
22400247,4,161,0.0,0.0,320,159
22400247,4,100,-2.0,-1.2,141,41
22400247,4,39,-1.0,-1.5384615384615383,39,0
22400248,1,263,-8.0,-1.8250950570342206,720,457
22400248,1,24,2.0,5.0,457,433
22400248,1,69,-2.0,-1.7391304347826086,414,345
22400248,1,96,5.0,3.125,341,245
22400248,1,91,0.0,0.0,238,147
22400248,1,16,-2.0,-7.5,138,122
22400248,1,122,6.0,2.9508196721311473,122,0
22400248,2,135,4.0,1.777777777777778,720,585
22400248,2,35,3.0,5.142857142857143,573,538
22400248,2,82,-2.0,-1.4634146341463414,516,434
22400248,2,4,-2.0,-30.0,406,402
22400248,2,68,3.0,2.647058823529412,324,256
22400248,2,71,1.0,0.8450704225352113,242,171
22400248,2,171,2.0,0.7017543859649122,171,0
22400248,3,285,0.0,0.0,720,435
22400248,3,29,1.0,2.0689655172413794,435,406
22400248,3,143,0.0,0.0,406,263
22400248,3,80,-2.0,-1.5,252,172
22400248,3,81,-2.0,-1.4814814814814814,172,91
22400248,3,80,-1.0,-0.75,80,0
22400248,4,339,-8.0,-1.415929203539823,720,381
22400248,4,13,0.0,0.0,365,352
22400248,4,70,0.0,0.0,338,268
22400248,4,68,1.0,0.8823529411764706,268,200
22400248,4,186,5.0,1.6129032258064517,189,3
22400248,4,2,0.0,0.0,2,0
22400249,1,305,3.0,0.5901639344262296,720,415
22400249,1,75,0.0,0.0,415,340
22400249,1,73,-2.0,-1.643835616438356,335,262
22400249,1,12,-1.0,-5.0,253,241
22400249,1,12,1.0,5.0,241,229
22400249,1,87,-2.0,-1.3793103448275863,229,142
22400249,1,120,-1.0,-0.5,130,10
22400249,1,2,0.0,0.0,5,3
22400249,2,126,-1.0,-0.47619047619047616,720,594
22400249,2,16,0.0,0.0,583,567
22400249,2,30,2.0,4.0,567,537
22400249,2,139,-4.0,-1.7266187050359714,520,381
22400249,2,11,0.0,0.0,381,370
22400249,2,8,-3.0,-22.5,370,362
22400249,2,81,5.0,3.7037037037037033,347,266
22400249,2,100,-2.0,-1.2,255,155
22400249,2,134,0.0,0.0,155,21
22400249,2,4,0.0,0.0,4,0
22400249,3,150,1.0,0.4,720,570
22400249,3,5,0.0,0.0,570,565
22400249,3,142,3.0,1.267605633802817,544,402
22400249,3,215,-2.0,-0.5581395348837209,402,187
22400249,3,44,0.0,0.0,187,143
22400249,3,43,0.0,0.0,133,90
22400249,3,25,-2.0,-4.8,90,65
22400249,4,116,3.0,1.5517241379310345,720,604
22400249,4,81,-1.0,-0.7407407407407407,590,509
22400249,4,53,1.0,1.1320754716981132,509,456
22400249,4,63,1.0,0.9523809523809523,449,386
22400249,4,111,5.0,2.7027027027027026,374,263
22400249,4,180,0.0,0.0,248,68
22400249,4,65,0.0,0.0,65,0
22400250,1,346,-7.0,-1.2138728323699421,720,374
22400250,1,23,0.0,0.0,374,351
22400250,1,114,3.0,1.5789473684210527,338,224
22400250,1,40,0.0,0.0,220,180
22400250,1,171,7.0,2.4561403508771926,171,0
22400250,2,144,5.0,2.0833333333333335,720,576
22400250,2,31,2.0,3.870967741935484,576,545
22400250,2,29,1.0,2.0689655172413794,545,516
22400250,2,146,3.0,1.2328767123287672,516,370
22400250,2,117,-8.0,-4.102564102564103,362,245
22400250,2,96,-2.0,-1.25,230,134
22400250,2,78,3.0,2.307692307692308,134,56
22400250,3,208,0.0,0.0,720,512
22400250,3,207,6.0,1.7391304347826086,505,298
22400250,3,15,0.0,0.0,282,267
22400250,3,51,-4.0,-4.705882352941177,267,216
22400250,3,14,0.0,0.0,192,178
22400250,3,148,-1.0,-0.40540540540540543,168,20
22400250,3,20,0.0,0.0,20,0
22400250,4,173,-3.0,-1.0404624277456647,720,547
22400250,4,7,0.0,0.0,538,531
22400250,4,55,0.0,0.0,518,463
22400250,4,23,0.0,0.0,448,425
22400250,4,121,5.0,2.479338842975207,424,303
22400250,4,40,-2.0,-3.0,295,255
22400250,4,255,0.0,0.0,255,0
22400251,1,312,9.0,1.7307692307692308,720,408
22400251,1,116,3.0,1.5517241379310345,402,286
22400251,1,85,4.0,2.8235294117647056,275,190
22400251,1,177,-7.0,-2.3728813559322037,177,0
22400251,2,63,-1.0,-0.9523809523809523,720,657
22400251,2,70,3.0,2.5714285714285716,657,587
22400251,2,98,0.0,0.0,587,489
22400251,2,78,-2.0,-1.5384615384615383,473,395
22400251,2,176,5.0,1.7045454545454546,386,210
22400251,2,98,2.0,1.2244897959183672,210,112
22400251,2,99,-6.0,-3.6363636363636367,104,5
22400251,3,393,-4.0,-0.6106870229007634,720,327
22400251,3,113,-4.0,-2.1238938053097343,327,214
22400251,3,61,-3.0,-2.9508196721311473,200,139
22400251,3,116,-1.0,-0.5172413793103449,116,0
22400251,4,208,4.0,1.153846153846154,720,512
22400251,4,102,-2.0,-1.1764705882352942,512,410
22400251,4,16,1.0,3.75,410,394
22400251,4,127,0.0,0.0,394,267
22400251,4,113,3.0,1.592920353982301,261,148
22400251,4,104,-7.0,-4.038461538461538,139,35
22400251,4,21,0.0,0.0,21,0
22400252,1,280,2.0,0.42857142857142855,720,440
22400252,1,23,3.0,7.826086956521739,440,417
22400252,1,79,-2.0,-1.5189873417721518,417,338
22400252,1,103,5.0,2.912621359223301,338,235
22400252,1,65,-2.0,-1.8461538461538463,220,155
22400252,1,42,-2.0,-2.8571428571428568,155,113
22400252,1,97,-4.0,-2.4742268041237114,97,0
22400252,2,54,2.0,2.2222222222222223,720,666
22400252,2,180,4.0,1.3333333333333335,660,480
22400252,2,36,3.0,5.0,462,426
22400252,2,96,-1.0,-0.625,416,320
22400252,2,49,1.0,1.2244897959183672,320,271
22400252,2,70,0.0,0.0,256,186
22400252,2,80,2.0,1.5,176,96
22400252,2,96,2.0,1.25,96,0
22400252,3,226,8.0,2.1238938053097343,720,494
22400252,3,93,0.0,0.0,494,401
22400252,3,31,5.0,9.67741935483871,399,368
22400252,3,109,1.0,0.5504587155963303,359,250
22400252,3,192,0.0,0.0,239,47
22400252,3,28,1.0,2.142857142857143,47,19
22400252,3,19,0.0,0.0,19,0
22400252,4,206,1.0,0.2912621359223301,720,514
22400252,4,264,-4.0,-0.9090909090909092,498,234
22400252,4,222,-3.0,-0.8108108108108109,222,0
22400253,1,217,2.0,0.5529953917050692,720,503
22400253,1,78,3.0,2.307692307692308,475,397
22400253,1,62,0.0,0.0,391,329
22400253,1,96,0.0,0.0,318,222
22400253,1,41,-1.0,-1.4634146341463414,113,72
22400253,1,60,3.0,3.0,60,0
22400253,2,75,5.0,4.0,720,645
22400253,2,107,-1.0,-0.5607476635514018,628,521
22400253,2,9,1.0,6.666666666666666,521,512
22400253,2,61,1.0,0.9836065573770493,512,451
22400253,2,31,2.0,3.870967741935484,430,399
22400253,2,65,3.0,2.769230769230769,388,323
22400253,2,9,0.0,0.0,323,314
22400253,2,113,1.0,0.5309734513274336,307,194
22400253,2,107,-2.0,-1.1214953271028036,194,87
22400253,2,61,0.0,0.0,79,18
22400253,3,349,-5.0,-0.8595988538681949,720,371
22400253,3,27,0.0,0.0,371,344
22400253,3,56,-3.0,-3.214285714285714,338,282
22400253,3,19,0.0,0.0,282,263
22400253,3,120,6.0,3.0,253,133
22400253,3,116,0.0,0.0,119,3
22400253,3,3,0.0,0.0,3,0
22400253,4,227,-4.0,-1.0572687224669604,720,493
22400253,4,162,7.0,2.5925925925925926,425,263
22400253,4,37,-1.0,-1.6216216216216217,263,226
22400253,4,29,0.0,0.0,226,197
22400253,4,31,1.0,1.935483870967742,190,159
22400253,4,43,4.0,5.5813953488372094,139,96
22400253,4,81,0.0,0.0,81,0
22400254,1,230,-5.0,-1.3043478260869565,720,490
22400254,1,112,6.0,3.214285714285714,490,378
22400254,1,32,4.0,7.5,367,335
22400254,1,97,-1.0,-0.6185567010309279,319,222
22400254,1,26,-1.0,-2.307692307692308,222,196
22400254,1,60,2.0,2.0,186,126
22400254,1,126,3.0,1.4285714285714284,126,0
22400254,2,180,-3.0,-1.0,720,540
22400254,2,18,-2.0,-6.666666666666666,511,493
22400254,2,116,-1.0,-0.5172413793103449,477,361
22400254,2,16,0.0,0.0,361,345
22400254,2,53,-3.0,-3.3962264150943398,345,292
22400254,2,51,4.0,4.705882352941177,281,230
22400254,2,91,1.0,0.6593406593406594,212,121
22400254,2,70,6.0,5.142857142857143,121,51
22400254,2,35,2.0,3.4285714285714284,35,0
22400254,3,464,1.0,0.12931034482758622,720,256
22400254,3,12,0.0,0.0,256,244
22400254,3,44,5.0,6.818181818181818,237,193
22400254,3,68,5.0,4.411764705882353,177,109
22400254,3,99,0.0,0.0,99,0
22400254,4,97,-6.0,-3.711340206185567,720,623
22400254,4,96,0.0,0.0,606,510
22400254,4,92,3.0,1.9565217391304348,510,418
22400254,4,25,-1.0,-2.4,418,393
22400254,4,33,1.0,1.8181818181818183,393,360
22400254,4,39,-1.0,-1.5384615384615383,360,321
22400254,4,54,0.0,0.0,321,267
22400254,4,86,-1.0,-0.6976744186046512,256,170
22400254,4,152,-3.0,-1.1842105263157894,152,0
22400255,1,239,4.0,1.00418410041841,720,481
22400255,1,89,0.0,0.0,481,392
22400255,1,194,0.0,0.0,392,198
22400255,1,168,-4.0,-1.4285714285714284,175,7
22400255,1,3,0.0,0.0,3,0
22400255,2,100,4.0,2.4,720,620
22400255,2,75,0.0,0.0,614,539
22400255,2,109,1.0,0.5504587155963303,522,413
22400255,2,50,-2.0,-2.4,409,359
22400255,2,5,-2.0,-24.0,355,350
22400255,2,212,3.0,0.8490566037735849,337,125
22400255,2,113,2.0,1.0619469026548671,113,0
22400255,3,39,0.0,0.0,720,681
22400255,3,170,-4.0,-1.4117647058823528,668,498
22400255,3,26,-2.0,-4.615384615384616,490,464
22400255,3,69,-3.0,-2.608695652173913,458,389
22400255,3,53,4.0,4.528301886792453,375,322
22400255,3,25,0.0,0.0,322,297
22400255,3,46,1.0,1.3043478260869565,289,243
22400255,3,171,-1.0,-0.3508771929824561,243,72
22400255,3,16,-1.0,-3.75,72,56
22400255,3,32,1.0,1.875,56,24
22400255,3,24,0.0,0.0,24,0
22400255,4,225,7.0,1.8666666666666667,720,495
22400255,4,46,1.0,1.3043478260869565,495,449
22400255,4,98,2.0,1.2244897959183672,449,351
22400255,4,25,0.0,0.0,342,317
22400255,4,20,-3.0,-9.0,310,290
22400255,4,66,2.0,1.8181818181818183,275,209
22400255,4,108,-9.0,-5.0,195,87
22400255,4,69,0.0,0.0,69,0
22400256,1,179,-3.0,-1.005586592178771,720,541
22400256,1,154,3.0,1.1688311688311688,526,372
22400256,1,62,-6.0,-5.806451612903226,372,310
22400256,1,64,-3.0,-2.8125,310,246
22400256,1,42,2.0,2.8571428571428568,238,196
22400256,1,63,4.0,3.8095238095238093,186,123
22400256,1,44,2.0,2.7272727272727275,98,54
22400256,1,34,0.0,0.0,34,0
22400256,2,57,0.0,0.0,720,663
22400256,2,121,5.0,2.479338842975207,651,530
22400256,2,153,1.0,0.39215686274509803,511,358
22400256,2,97,0.0,0.0,307,210
22400256,2,81,0.0,0.0,210,129
22400256,2,51,1.0,1.1764705882352942,120,69
22400256,2,40,1.0,1.5,64,24
22400256,2,19,0.0,0.0,24,5
22400256,2,2,0.0,0.0,2,0
22400256,3,271,-4.0,-0.8856088560885609,720,449
22400256,3,56,3.0,3.214285714285714,431,375
22400256,3,58,-1.0,-1.0344827586206897,364,306
22400256,3,125,0.0,0.0,306,181
22400256,3,28,1.0,2.142857142857143,170,142
22400256,3,138,-2.0,-0.8695652173913043,142,4
22400256,4,74,1.0,0.8108108108108109,720,646
22400256,4,100,1.0,0.6,635,535
22400256,4,77,-1.0,-0.7792207792207793,516,439
22400256,4,15,0.0,0.0,405,390
22400256,4,185,7.0,2.27027027027027,382,197
22400256,4,50,-1.0,-1.2,189,139
22400256,4,65,-2.0,-1.8461538461538463,139,74
22400256,4,40,0.0,0.0,74,34
22400256,4,28,0.0,0.0,28,0
22400257,1,242,-9.0,-2.231404958677686,720,478
22400257,1,217,-4.0,-1.1059907834101383,470,253
22400257,1,208,1.0,0.2884615384615385,237,29
22400257,1,29,-2.0,-4.137931034482759,29,0
22400257,2,250,1.0,0.24,720,470
22400257,2,19,-1.0,-3.1578947368421053,452,433
22400257,2,15,0.0,0.0,433,418
22400257,2,140,3.0,1.2857142857142858,410,270
22400257,2,53,0.0,0.0,257,204
22400257,2,25,1.0,2.4,193,168
22400257,2,56,-2.0,-2.142857142857143,168,112
22400257,2,33,4.0,7.272727272727273,112,79
22400257,3,369,7.0,1.1382113821138211,720,351
22400257,3,118,-7.0,-3.5593220338983054,326,208
22400257,3,122,3.0,1.4754098360655736,194,72
22400257,3,72,-3.0,-2.5,72,0
22400257,4,142,-1.0,-0.4225352112676056,720,578
22400257,4,50,3.0,3.5999999999999996,569,519
22400257,4,12,0.0,0.0,502,490
22400257,4,33,2.0,3.6363636363636367,490,457
22400257,4,20,0.0,0.0,450,430
22400257,4,79,-4.0,-3.0379746835443036,430,351
22400257,4,130,-4.0,-1.8461538461538463,351,221
22400257,4,111,0.0,0.0,214,103
22400257,4,96,1.0,0.625,96,0
22400258,1,309,-1.0,-0.1941747572815534,720,411
22400258,1,87,3.0,2.0689655172413794,411,324
22400258,1,18,1.0,3.333333333333333,309,291
22400258,1,58,5.0,5.172413793103448,276,218
22400258,2,106,0.0,0.0,720,614
22400258,2,92,1.0,0.6521739130434783,609,517
22400258,2,53,0.0,0.0,495,442
22400258,2,9,-1.0,-6.666666666666666,438,429
22400258,2,26,0.0,0.0,429,403
22400258,2,52,1.0,1.153846153846154,398,346
22400258,2,102,-2.0,-1.1764705882352942,341,239
22400258,3,217,3.0,0.8294930875576038,720,503
22400258,3,101,0.0,0.0,497,396
22400258,3,33,1.0,1.8181818181818183,392,359
22400258,3,117,0.0,0.0,353,236
22400258,3,30,-2.0,-4.0,234,204
22400258,4,107,1.0,0.5607476635514018,720,613
22400258,4,47,-2.0,-2.5531914893617023,589,542
22400258,4,106,0.0,0.0,526,420
22400258,4,449,5.0,0.6681514476614699,706,257
22400258,4,100,2.0,1.2,251,151
22400258,4,27,-3.0,-6.666666666666666,131,104
22400259,1,398,-1.0,-0.15075376884422112,720,322
22400259,1,110,1.0,0.5454545454545454,322,212
22400259,1,83,0.0,0.0,212,129
22400259,1,51,1.0,1.1764705882352942,116,65
22400259,1,53,1.0,1.1320754716981132,53,0
22400259,2,145,1.0,0.41379310344827586,720,575
22400259,2,49,-3.0,-3.673469387755102,564,515
22400259,2,65,0.0,0.0,508,443
22400259,2,19,0.0,0.0,438,419
22400259,2,33,0.0,0.0,399,366
22400259,2,9,0.0,0.0,351,342
22400259,2,154,0.0,0.0,332,178
22400259,2,87,-4.0,-2.7586206896551726,178,91
22400259,3,271,2.0,0.44280442804428044,720,449
22400259,3,95,10.0,6.315789473684211,449,354
22400259,3,50,4.0,4.8,268,218
22400259,3,62,1.0,0.967741935483871,218,156
22400259,3,26,-3.0,-6.923076923076923,156,130
22400259,3,97,-1.0,-0.6185567010309279,122,25
22400259,3,8,0.0,0.0,8,0
22400259,4,58,2.0,2.0689655172413794,720,662
22400259,4,14,2.0,8.571428571428571,642,628
22400259,4,86,0.0,0.0,606,520
22400259,4,102,3.0,1.7647058823529411,520,418
22400259,4,29,0.0,0.0,406,377
22400259,4,74,-5.0,-4.054054054054054,377,303
22400259,4,93,-2.0,-1.2903225806451615,285,192
22400259,4,33,0.0,0.0,192,159
22400259,4,136,-3.0,-1.323529411764706,136,0
22400260,1,222,1.0,0.2702702702702703,720,498
22400260,1,59,0.0,0.0,485,426
22400260,1,54,2.0,2.2222222222222223,426,372
22400260,1,74,0.0,0.0,364,290
22400260,1,87,2.0,1.3793103448275863,290,203
22400260,1,15,0.0,0.0,203,188
22400260,1,137,1.0,0.437956204379562,173,36
22400260,1,36,-2.0,-3.333333333333333,36,0
22400260,2,64,-3.0,-2.8125,720,656
22400260,2,2,0.0,0.0,643,641
22400260,2,129,0.0,0.0,637,508
22400260,2,33,4.0,7.272727272727273,494,461
22400260,2,47,0.0,0.0,447,400
22400260,2,59,-2.0,-2.0338983050847457,386,327
22400260,2,162,9.0,3.333333333333333,327,165
22400260,2,90,-5.0,-3.333333333333333,165,75
22400260,3,193,9.0,2.7979274611398965,720,527
22400260,3,30,0.0,0.0,527,497
22400260,3,53,-1.0,-1.1320754716981132,485,432
22400260,3,62,5.0,4.838709677419355,413,351
22400260,3,182,-3.0,-0.989010989010989,344,162
22400260,3,31,2.0,3.870967741935484,153,122
22400260,3,106,-2.0,-1.1320754716981132,106,0
22400260,4,155,-2.0,-0.7741935483870968,720,565
22400260,4,36,3.0,5.0,565,529
22400260,4,42,1.0,1.4285714285714284,522,480
22400260,4,77,-2.0,-1.5584415584415585,473,396
22400260,4,141,-2.0,-0.851063829787234,378,237
22400260,4,157,-3.0,-1.1464968152866242,237,80
22400260,4,64,-4.0,-3.75,65,1
22400260,4,1,0.0,0.0,1,0
22400260,5,1,0.0,0.0,300,299
22400260,5,41,4.0,5.853658536585366,283,242
22400260,5,1,1.0,60.0,17,16
22400260,5,6,0.0,0.0,11,5
22400261,1,311,-4.0,-0.7717041800643086,720,409
22400261,1,35,0.0,0.0,409,374
22400261,1,104,0.0,0.0,374,270
22400261,1,39,-2.0,-3.0769230769230766,258,219
22400261,1,64,2.0,1.875,219,155
22400261,1,8,1.0,7.5,155,147
22400261,1,19,7.0,22.105263157894736,133,114
22400261,2,245,-6.0,-1.4693877551020407,720,475
22400261,2,91,1.0,0.6593406593406594,475,384
22400261,2,72,4.0,3.333333333333333,377,305
22400261,2,11,0.0,0.0,294,283
22400261,2,68,0.0,0.0,274,206
22400261,2,55,-1.0,-1.0909090909090908,189,134
22400261,2,134,-1.0,-0.44776119402985076,134,0
22400261,3,314,-5.0,-0.9554140127388535,720,406
22400261,3,42,0.0,0.0,406,364
22400261,3,132,-1.0,-0.4545454545454546,363,231
22400261,3,49,0.0,0.0,231,182
22400261,3,36,0.0,0.0,164,128
22400261,3,71,3.0,2.535211267605634,121,50
22400261,3,50,-3.0,-3.5999999999999996,50,0
22400261,4,102,1.0,0.5882352941176471,720,618
22400261,4,51,-2.0,-2.3529411764705883,618,567
22400261,4,117,-1.0,-0.5128205128205129,567,450
22400261,4,94,-1.0,-0.6382978723404256,437,343
22400261,4,34,0.0,0.0,330,296
22400261,4,59,7.0,7.118644067796611,288,229
22400261,4,187,2.0,0.6417112299465241,219,32
22400261,4,21,-2.0,-5.7142857142857135,32,11
22400261,4,11,0.0,0.0,11,0
22400262,1,280,-3.0,-0.6428571428571429,720,440
22400262,1,10,-3.0,-18.0,435,425
22400262,1,123,-3.0,-1.4634146341463414,400,277
22400262,1,8,-2.0,-15.0,267,259
22400262,1,38,0.0,0.0,259,221
22400262,1,17,0.0,0.0,214,197
22400262,1,188,-2.0,-0.6382978723404256,188,0
22400262,2,192,5.0,1.5625,720,528
22400262,2,71,-4.0,-3.380281690140845,528,457
22400262,2,8,1.0,7.5,443,435
22400262,2,33,0.0,0.0,435,402
22400262,2,157,-2.0,-0.7643312101910829,402,245
22400262,2,48,0.0,0.0,231,183
22400262,2,45,-1.0,-1.3333333333333335,163,118
22400262,2,108,0.0,0.0,108,0
22400262,3,153,4.0,1.5686274509803921,720,567
22400262,3,30,-2.0,-4.0,567,537
22400262,3,102,5.0,2.941176470588235,537,435
22400262,3,29,-1.0,-2.0689655172413794,419,390
22400262,3,9,0.0,0.0,390,381
22400262,3,131,0.0,0.0,360,229
22400262,3,49,-3.0,-3.673469387755102,226,177
22400262,3,47,5.0,6.382978723404255,177,130
22400262,3,10,-1.0,-6.0,33,23
22400262,3,20,2.0,6.0,23,3
22400262,4,82,3.0,2.195121951219512,720,638
22400262,4,34,0.0,0.0,638,604
22400262,4,102,0.0,0.0,604,502
22400262,4,126,6.0,2.8571428571428568,484,358
22400262,4,35,0.0,0.0,351,316
22400262,4,11,0.0,0.0,316,305
22400262,4,30,6.0,12.0,293,263
22400263,1,275,0.0,0.0,720,445
22400263,1,130,-4.0,-1.8461538461538463,445,315
22400263,1,31,3.0,5.806451612903226,315,284
22400263,1,13,0.0,0.0,270,257
22400263,1,134,0.0,0.0,246,112
22400263,1,112,1.0,0.5357142857142857,112,0
22400263,2,90,0.0,0.0,720,630
22400263,2,92,-3.0,-1.9565217391304348,620,528
22400263,2,59,-2.0,-2.0338983050847457,528,469
22400263,2,90,-1.0,-0.6666666666666667,458,368
22400263,2,70,-1.0,-0.8571428571428571,354,284
22400263,2,230,4.0,1.0434782608695652,284,54
22400263,2,16,1.0,3.75,47,31
22400263,3,327,-6.0,-1.1009174311926606,720,393
22400263,3,61,2.0,1.9672131147540985,393,332
22400263,3,80,-5.0,-3.75,332,252
22400263,3,118,1.0,0.5084745762711864,252,134
22400263,3,40,2.0,3.0,134,94
22400263,3,94,0.0,0.0,94,0
22400263,4,157,2.0,0.7643312101910829,720,563
22400263,4,79,2.0,1.5189873417721518,546,467
22400263,4,202,-4.0,-1.188118811881188,422,220
22400263,4,23,0.0,0.0,220,197
22400263,4,103,-2.0,-1.1650485436893203,180,77
22400263,4,25,0.0,0.0,64,39
22400263,4,19,0.0,0.0,39,20
22400263,4,16,-3.0,-11.25,18,2
22400264,1,325,12.0,2.2153846153846155,720,395
22400264,1,90,4.0,2.666666666666667,391,301
22400264,1,16,0.0,0.0,295,279
22400264,1,143,-6.0,-2.5174825174825175,268,125
22400264,1,1,0.0,0.0,117,116
22400264,1,105,-3.0,-1.7142857142857142,105,0
22400264,2,162,-2.0,-0.7407407407407407,720,558
22400264,2,35,2.0,3.4285714285714284,546,511
22400264,2,40,0.0,0.0,511,471
22400264,2,17,0.0,0.0,471,454
22400264,2,55,0.0,0.0,454,399
22400264,2,147,6.0,2.4489795918367343,384,237
22400264,2,28,-2.0,-4.285714285714286,225,197
22400264,2,183,2.0,0.6557377049180327,197,14
22400264,2,5,2.0,24.0,5,0
22400264,3,312,4.0,0.7692307692307692,720,408
22400264,3,15,-1.0,-4.0,394,379
22400264,3,127,-12.0,-5.669291338582677,379,252
22400264,3,44,1.0,1.3636363636363638,185,141
22400264,4,117,3.0,1.5384615384615383,720,603
22400264,4,34,0.0,0.0,585,551
22400264,4,103,0.0,0.0,542,439
22400264,4,125,3.0,1.44,432,307
22400264,4,90,1.0,0.6666666666666667,296,206
22400264,4,206,1.0,0.2912621359223301,206,0
22400265,1,308,3.0,0.5844155844155844,720,412
22400265,1,47,1.0,1.2765957446808511,391,344
22400265,1,55,3.0,3.2727272727272725,344,289
22400265,1,59,5.0,5.084745762711864,278,219
22400265,1,31,2.0,3.870967741935484,204,173
22400265,1,108,4.0,2.2222222222222223,167,59
22400265,2,106,-7.0,-3.9622641509433962,720,614
22400265,2,158,0.0,0.0,604,446
22400265,2,59,0.0,0.0,434,375
22400265,2,104,-4.0,-2.307692307692308,361,257
22400265,2,50,-1.0,-1.2,257,207
22400265,2,32,-1.0,-1.875,207,175
22400265,2,157,-1.0,-0.3821656050955414,157,0
22400265,3,436,8.0,1.1009174311926606,720,284
22400265,3,36,2.0,3.333333333333333,273,237
22400265,3,17,0.0,0.0,227,210
22400265,3,30,-3.0,-6.0,198,168
22400265,3,106,4.0,2.2641509433962264,168,62
22400265,3,40,1.0,1.5,62,22
22400265,3,22,-2.0,-5.454545454545455,22,0
22400265,4,144,5.0,2.0833333333333335,720,576
22400265,4,46,1.0,1.3043478260869565,576,530
22400265,4,74,3.0,2.4324324324324325,530,456
22400265,4,15,2.0,8.0,447,432
22400265,4,85,-2.0,-1.4117647058823528,421,336
22400265,4,113,-3.0,-1.592920353982301,336,223
22400265,4,48,-2.0,-2.5,206,158
22400265,4,146,-2.0,-0.821917808219178,146,0
22400266,1,341,-2.0,-0.3519061583577713,720,379
22400266,1,51,-2.0,-2.3529411764705883,375,324
22400266,1,113,1.0,0.5309734513274336,299,186
22400266,1,139,-3.0,-1.2949640287769786,142,3
22400266,2,67,4.0,3.582089552238806,720,653
22400266,2,55,-3.0,-3.2727272727272725,653,598
22400266,2,87,-1.0,-0.6896551724137931,598,511
22400266,2,2,0.0,0.0,502,500
22400266,2,8,0.0,0.0,494,486
22400266,2,98,2.0,1.2244897959183672,486,388
22400266,2,52,1.0,1.153846153846154,388,336
22400266,2,9,2.0,13.333333333333332,336,327
22400266,2,105,-9.0,-5.142857142857143,327,222
22400266,2,49,2.0,2.4489795918367343,211,162
22400266,2,51,8.0,9.411764705882353,155,104
22400266,2,81,2.0,1.4814814814814814,88,7
22400266,2,7,0.0,0.0,7,0
22400266,3,254,-3.0,-0.7086614173228346,720,466
22400266,3,5,3.0,36.0,451,446
22400266,3,43,1.0,1.3953488372093024,432,389
22400266,3,21,0.0,0.0,374,353
22400266,3,52,-8.0,-9.230769230769232,342,290
22400266,3,54,1.0,1.1111111111111112,278,224
22400266,3,65,-1.0,-0.9230769230769231,224,159
22400266,3,97,0.0,0.0,159,62
22400266,4,89,-5.0,-3.3707865168539324,720,631
22400266,4,12,2.0,10.0,631,619
22400266,4,76,-2.0,-1.5789473684210527,619,543
22400266,4,23,-2.0,-5.217391304347826,528,505
22400266,4,31,-2.0,-3.870967741935484,496,465
22400266,4,84,-7.0,-5.0,456,372
22400266,4,96,1.0,0.625,372,276
22400266,4,61,6.0,5.9016393442622945,268,207
22400266,4,65,3.0,2.769230769230769,191,126
22400267,1,297,-6.0,-1.2121212121212122,720,423
22400267,1,132,1.0,0.4545454545454546,414,282
22400267,1,102,-1.0,-0.5882352941176471,282,180
22400267,1,2,0.0,0.0,161,159
22400267,1,41,1.0,1.4634146341463414,139,98
22400267,1,2,0.0,0.0,49,47
22400267,1,14,0.0,0.0,47,33
22400267,2,86,2.0,1.3953488372093024,703,617
22400267,2,58,0.0,0.0,607,549
22400267,2,89,-2.0,-1.348314606741573,535,446
22400267,2,31,0.0,0.0,446,415
22400267,2,99,0.0,0.0,415,316
22400267,2,80,1.0,0.75,316,236
22400267,2,56,1.0,1.0714285714285714,232,176
22400267,2,73,-1.0,-0.821917808219178,176,103
22400267,2,9,1.0,6.666666666666666,103,94
22400267,2,94,4.0,2.5531914893617023,94,0
22400267,3,274,3.0,0.6569343065693432,720,446
22400267,3,79,0.0,0.0,441,362
22400267,3,49,0.0,0.0,343,294
22400267,3,59,2.0,2.0338983050847457,286,227
22400267,3,96,-8.0,-5.0,207,111
22400267,3,101,3.0,1.782178217821782,101,0
22400267,4,132,-3.0,-1.3636363636363638,720,588
22400267,4,63,-3.0,-2.8571428571428568,567,504
22400267,4,51,4.0,4.705882352941177,482,431
22400267,4,182,-2.0,-0.6593406593406594,422,240
22400267,4,222,-2.0,-0.5405405405405406,226,4
22400268,1,325,1.0,0.18461538461538463,720,395
22400268,1,9,0.0,0.0,378,369
22400268,1,45,-3.0,-4.0,365,320
22400268,1,179,0.0,0.0,320,141
22400268,1,121,1.0,0.49586776859504134,121,0
22400268,2,123,3.0,1.4634146341463414,720,597
22400268,2,59,0.0,0.0,587,528
22400268,2,161,0.0,0.0,519,358
22400268,2,9,0.0,0.0,347,338
22400268,2,122,0.0,0.0,338,216
22400268,2,109,-2.0,-1.1009174311926606,216,107
22400268,2,36,3.0,5.0,95,59
22400268,2,2,-1.0,-30.0,57,55
22400268,2,44,1.0,1.3636363636363638,55,11
22400268,2,32,2.0,3.75,32,0
22400268,3,262,-4.0,-0.916030534351145,720,458
22400268,3,68,2.0,1.7647058823529411,458,390
22400268,3,66,0.0,0.0,379,313
22400268,3,55,6.0,6.545454545454545,299,244
22400268,3,181,7.0,2.320441988950276,210,29
22400268,3,29,0.0,0.0,29,0
22400268,4,137,6.0,2.6277372262773726,720,583
22400268,4,85,3.0,2.1176470588235294,562,477
22400268,4,238,-7.0,-1.7647058823529411,470,232
22400268,4,49,0.0,0.0,220,171
22400268,4,157,-12.0,-4.585987261146497,171,14
22400268,4,10,2.0,12.0,10,0
22400269,1,283,-5.0,-1.0600706713780919,720,437
22400269,1,22,-3.0,-8.181818181818182,420,398
22400269,1,40,-3.0,-4.5,398,358
22400269,1,9,0.0,0.0,352,343
22400269,1,65,-3.0,-2.769230769230769,331,266
22400269,1,24,2.0,5.0,257,233
22400269,1,62,0.0,0.0,222,160
22400269,1,8,0.0,0.0,139,131
22400269,1,111,-5.0,-2.7027027027027026,115,4
22400269,2,214,1.0,0.2803738317757009,720,506
22400269,2,57,2.0,2.1052631578947367,494,437
22400269,2,108,-2.0,-1.1111111111111112,417,309
22400269,2,55,0.0,0.0,309,254
22400269,2,66,0.0,0.0,254,188
22400269,2,127,1.0,0.47244094488188976,178,51
22400269,2,28,-3.0,-6.428571428571428,35,7
22400269,3,294,0.0,0.0,720,426
22400269,3,68,0.0,0.0,414,346
22400269,3,20,2.0,6.0,328,308
22400269,3,67,-2.0,-1.791044776119403,297,230
22400269,3,46,-2.0,-2.608695652173913,230,184
22400269,3,130,2.0,0.9230769230769231,170,40
22400269,3,36,5.0,8.333333333333334,36,0
22400269,4,137,3.0,1.3138686131386863,720,583
22400269,4,82,5.0,3.6585365853658534,568,486
22400269,4,53,0.0,0.0,475,422
22400269,4,44,-3.0,-4.090909090909091,413,369
22400269,4,4,0.0,0.0,278,274
22400269,4,117,9.0,4.615384615384616,265,148
22400269,4,60,1.0,1.0,148,88
22400269,4,25,-1.0,-2.4,85,60
22400269,4,15,0.0,0.0,60,45
22400269,4,10,0.0,0.0,36,26
22400269,4,2,0.0,0.0,2,0
22400270,1,328,-1.0,-0.18292682926829268,720,392
22400270,1,76,5.0,3.9473684210526314,383,307
22400270,1,81,4.0,2.962962962962963,298,217
22400270,1,48,0.0,0.0,206,158
22400270,1,29,0.0,0.0,148,119
22400270,1,106,-5.0,-2.8301886792452833,106,0
22400270,2,119,2.0,1.0084033613445378,720,601
22400270,2,108,7.0,3.888888888888889,590,482
22400270,2,42,2.0,2.8571428571428568,456,414
22400270,2,169,0.0,0.0,404,235
22400270,2,54,-1.0,-1.1111111111111112,228,174
22400270,2,40,0.0,0.0,174,134
22400270,2,127,-2.0,-0.9448818897637795,134,7
22400270,2,4,0.0,0.0,4,0
22400270,3,281,-11.0,-2.3487544483985765,720,439
22400270,3,171,-8.0,-2.807017543859649,432,261
22400270,3,123,-4.0,-1.9512195121951221,132,9
22400270,4,136,-7.0,-3.0882352941176467,720,584
22400270,4,128,5.0,2.34375,565,437
22400270,4,105,-4.0,-2.285714285714286,412,307
22400270,4,34,-3.0,-5.294117647058824,297,263
22400270,4,86,-3.0,-2.0930232558139537,250,164
22400270,4,2,0.0,0.0,164,162
22400270,4,148,0.0,0.0,148,0
22400271,1,472,-4.0,-0.5084745762711864,720,248
22400271,1,78,0.0,0.0,248,170
22400271,1,189,-1.0,-0.31746031746031744,189,0
22400271,2,82,8.0,5.853658536585366,720,638
22400271,2,98,-2.0,-1.2244897959183672,638,540
22400271,2,68,1.0,0.8823529411764706,531,463
22400271,2,72,3.0,2.5,454,382
22400271,2,57,3.0,3.1578947368421053,367,310
22400271,2,91,5.0,3.2967032967032965,310,219
22400271,2,72,0.0,0.0,219,147
22400271,2,131,-5.0,-2.290076335877863,131,0
22400271,3,281,12.0,2.5622775800711746,720,439
22400271,3,17,-2.0,-7.0588235294117645,426,409
22400271,3,17,0.0,0.0,373,356
22400271,3,33,2.0,3.6363636363636367,350,317
22400271,3,36,2.0,3.333333333333333,317,281
22400271,3,266,-8.0,-1.8045112781954886,266,0
22400271,4,116,-4.0,-2.0689655172413794,720,604
22400271,4,141,3.0,1.2765957446808511,595,454
22400271,4,40,-3.0,-4.5,433,393
22400271,4,134,3.0,1.3432835820895521,379,245
22400271,4,238,-4.0,-1.0084033613445378,245,7
22400272,1,161,-2.0,-0.7453416149068323,720,559
22400272,1,147,6.0,2.4489795918367343,559,412
22400272,1,88,1.0,0.6818181818181819,412,324
22400272,1,75,-4.0,-3.2,324,249
22400272,1,89,-2.0,-1.348314606741573,249,160
22400272,1,66,-2.0,-1.8181818181818183,139,73
22400272,1,53,4.0,4.528301886792453,73,20
22400272,1,20,2.0,6.0,20,0
22400272,2,130,-6.0,-2.769230769230769,720,590
22400272,2,58,4.0,4.137931034482759,570,512
22400272,2,47,-2.0,-2.5531914893617023,506,459
22400272,2,155,4.0,1.5483870967741935,446,291
22400272,2,61,1.0,0.9836065573770493,281,220
22400272,2,46,0.0,0.0,215,169
22400272,2,42,1.0,1.4285714285714284,146,104
22400272,2,104,-5.0,-2.8846153846153846,104,0
22400272,3,267,1.0,0.2247191011235955,720,453
22400272,3,50,4.0,4.8,453,403
22400272,3,108,6.0,3.333333333333333,386,278
22400272,3,56,-1.0,-1.0714285714285714,278,222
22400272,3,27,1.0,2.2222222222222223,222,195
22400272,3,143,-3.0,-1.2587412587412588,195,52
22400272,3,52,0.0,0.0,52,0
22400272,4,235,2.0,0.5106382978723404,720,485
22400272,4,93,0.0,0.0,464,371
22400272,4,104,0.0,0.0,355,251
22400272,4,62,3.0,2.903225806451613,245,183
22400272,4,95,-1.0,-0.631578947368421,183,88
22400272,4,52,5.0,5.769230769230769,73,21
22400273,1,334,-1.0,-0.17964071856287425,720,386
22400273,1,56,-1.0,-1.0714285714285714,378,322
22400273,1,58,2.0,2.0689655172413794,322,264
22400273,1,21,0.0,0.0,264,243
22400273,1,45,-3.0,-4.0,243,198
22400273,1,195,8.0,2.4615384615384617,198,3
22400273,2,73,2.0,1.643835616438356,720,647
22400273,2,55,3.0,3.2727272727272725,631,576
22400273,2,17,-2.0,-7.0588235294117645,565,548
22400273,2,15,-1.0,-4.0,536,521
22400273,2,26,-2.0,-4.615384615384616,521,495
22400273,2,49,0.0,0.0,495,446
22400273,2,52,1.0,1.153846153846154,440,388
22400273,2,28,0.0,0.0,374,346
22400273,2,17,0.0,0.0,346,329
22400273,2,76,0.0,0.0,314,238
22400273,2,104,3.0,1.7307692307692308,221,117
22400273,2,38,-2.0,-3.1578947368421053,117,79
22400273,3,196,-4.0,-1.2244897959183672,720,524
22400273,3,151,1.0,0.3973509933774834,524,373
22400273,3,88,6.0,4.090909090909091,373,285
22400273,3,32,1.0,1.875,265,233
22400273,3,80,1.0,0.75,233,153
22400273,3,146,-4.0,-1.643835616438356,146,0
22400273,4,85,-4.0,-2.8235294117647056,720,635
22400273,4,125,0.0,0.0,635,510
22400273,4,53,-2.0,-2.2641509433962264,503,450
22400273,4,46,0.0,0.0,432,386
22400273,4,98,-5.0,-3.0612244897959187,372,274
22400273,4,197,2.0,0.6091370558375634,260,63
22400273,4,46,0.0,0.0,55,9
22400273,4,5,0.0,0.0,5,0
22400273,5,202,6.0,1.782178217821782,300,98
22400273,5,70,0.0,0.0,88,18
22400273,5,8,0.0,0.0,8,0
22400274,1,341,-12.0,-2.111436950146628,720,379
22400274,1,114,-5.0,-2.631578947368421,379,265
22400274,1,73,-2.0,-1.643835616438356,265,192
22400274,1,57,1.0,1.0526315789473684,249,192
22400274,1,12,-1.0,-5.0,171,159
22400274,1,68,4.0,3.5294117647058822,159,91
22400274,1,78,2.0,1.5384615384615383,78,0
22400274,2,102,-1.0,-0.5882352941176471,720,618
22400274,2,104,0.0,0.0,611,507
22400274,2,102,-1.0,-0.5882352941176471,507,405
22400274,2,43,0.0,0.0,405,362
22400274,2,49,2.0,2.4489795918367343,350,301
22400274,2,17,0.0,0.0,281,264
22400274,2,90,2.0,1.3333333333333335,264,174
22400274,2,90,-2.0,-1.3333333333333335,157,67
22400274,2,67,4.0,3.582089552238806,67,0
22400274,3,76,-7.0,-5.526315789473684,720,644
22400274,3,118,0.0,0.0,627,509
22400274,3,50,-3.0,-3.5999999999999996,494,444
22400274,3,180,-4.0,-1.3333333333333335,444,264
22400274,3,16,-2.0,-7.5,252,236
22400274,3,53,-2.0,-2.2641509433962264,213,160
22400274,3,18,0.0,0.0,146,128
22400274,3,37,1.0,1.6216216216216217,108,71
22400274,3,71,3.0,2.535211267605634,71,0
22400274,4,207,3.0,0.8695652173913043,720,513
22400274,4,182,-8.0,-2.6373626373626378,513,331
22400274,4,131,2.0,0.916030534351145,316,185
22400274,4,185,1.0,0.32432432432432434,185,0
22400275,1,329,10.0,1.8237082066869301,720,391
22400275,1,38,0.0,0.0,371,333
22400275,1,121,0.0,0.0,317,196
22400275,1,110,-2.0,-1.0909090909090908,196,86
22400275,1,41,3.0,4.390243902439024,77,36
22400275,2,126,-3.0,-1.4285714285714284,720,594
22400275,2,133,-3.0,-1.3533834586466165,588,455
22400275,2,24,0.0,0.0,426,402
22400275,2,92,-2.0,-1.3043478260869565,399,307
22400275,2,67,0.0,0.0,294,227
22400275,2,70,-1.0,-0.8571428571428571,227,157
22400275,2,56,4.0,4.285714285714286,157,101
22400275,3,279,4.0,0.8602150537634409,720,441
22400275,3,40,2.0,3.0,431,391
22400275,3,86,0.0,0.0,391,305
22400275,3,8,0.0,0.0,305,297
22400275,3,68,-3.0,-2.647058823529412,286,218
22400275,3,78,0.0,0.0,218,140
22400275,3,120,-7.0,-3.5,128,8
22400275,4,118,4.0,2.0338983050847457,720,602
22400275,4,39,6.0,9.230769230769232,602,563
22400275,4,83,2.0,1.4457831325301205,547,464
22400275,4,166,-1.0,-0.3614457831325301,456,290
22400275,4,82,1.0,0.7317073170731707,278,196
22400275,4,124,-3.0,-1.4516129032258065,187,63
22400275,4,7,0.0,0.0,51,44
22400276,1,344,-1.0,-0.1744186046511628,720,376
22400276,1,120,0.0,0.0,354,234
22400276,1,33,-2.0,-3.6363636363636367,219,186
22400276,1,25,0.0,0.0,170,145
22400276,1,76,2.0,1.5789473684210527,145,69
22400276,1,69,-3.0,-2.608695652173913,69,0
22400276,2,166,-7.0,-2.5301204819277108,720,554
22400276,2,63,-1.0,-0.9523809523809523,554,491
22400276,2,42,-3.0,-4.285714285714286,475,433
22400276,2,2,0.0,0.0,413,411
22400276,2,38,-1.0,-1.5789473684210527,405,367
22400276,2,130,4.0,1.8461538461538463,367,237
22400276,2,120,0.0,0.0,237,117
22400276,2,41,2.0,2.926829268292683,41,0
22400276,3,368,2.0,0.32608695652173914,720,352
22400276,3,81,1.0,0.7407407407407407,352,271
22400276,3,22,0.0,0.0,214,192
22400276,3,51,0.0,0.0,178,127
22400276,3,104,3.0,1.7307692307692308,127,23
22400276,3,23,0.0,0.0,23,0
22400276,4,166,2.0,0.7228915662650602,720,554
22400276,4,8,0.0,0.0,535,527
22400276,4,39,-3.0,-4.615384615384616,514,475
22400276,4,81,-3.0,-2.2222222222222223,475,394
22400276,4,9,2.0,13.333333333333332,374,365
22400276,4,114,-4.0,-2.1052631578947367,350,236
22400276,4,41,0.0,0.0,218,177
22400276,4,18,0.0,0.0,164,146
22400276,4,133,2.0,0.9022556390977443,142,9
22400276,4,7,0.0,0.0,7,0
22400277,1,308,-4.0,-0.7792207792207793,720,412
22400277,1,85,2.0,1.4117647058823528,412,327
22400277,1,10,0.0,0.0,319,309
22400277,1,2,0.0,0.0,306,304
22400277,1,70,1.0,0.8571428571428571,291,221
22400277,1,18,2.0,6.666666666666666,200,182
22400277,1,178,3.0,1.0112359550561798,182,4
22400277,2,111,-6.0,-3.2432432432432434,720,609
22400277,2,127,2.0,0.9448818897637795,586,459
22400277,2,106,3.0,1.6981132075471699,459,353
22400277,2,73,-1.0,-0.821917808219178,328,255
22400277,2,62,-3.0,-2.903225806451613,244,182
22400277,2,7,-1.0,-8.571428571428571,172,165
22400277,2,49,0.0,0.0,132,83
22400277,2,34,-1.0,-1.7647058823529411,68,34
22400277,2,34,3.0,5.294117647058824,34,0
22400277,3,203,0.0,0.0,720,517
22400277,3,100,1.0,0.6,517,417
22400277,3,94,0.0,0.0,417,323
22400277,3,9,0.0,0.0,303,294
22400277,3,9,0.0,0.0,275,266
22400277,3,81,2.0,1.4814814814814814,251,170
22400277,3,118,-3.0,-1.5254237288135595,148,30
22400277,4,148,-6.0,-2.4324324324324325,720,572
22400277,4,7,-3.0,-25.71428571428571,570,563
22400277,4,185,-3.0,-0.972972972972973,552,367
22400277,4,170,2.0,0.7058823529411764,359,189
22400277,4,108,-5.0,-2.7777777777777777,165,57
22400277,4,22,0.0,0.0,57,35
22400277,4,233,-3.0,-0.7725321888412017,233,0
22400278,1,349,8.0,1.3753581661891117,720,371
22400278,1,29,3.0,6.206896551724138,371,342
22400278,1,34,-2.0,-3.5294117647058822,331,297
22400278,1,40,1.0,1.5,283,243
22400278,1,90,-4.0,-2.666666666666667,243,153
22400278,1,56,-1.0,-1.0714285714285714,150,94
22400278,1,88,-3.0,-2.0454545454545454,88,0
22400278,2,106,-5.0,-2.8301886792452833,720,614
22400278,2,55,-1.0,-1.0909090909090908,567,512
22400278,2,80,-3.0,-2.25,504,424
22400278,2,119,-5.0,-2.521008403361345,410,291
22400278,2,65,1.0,0.9230769230769231,285,220
22400278,2,87,2.0,1.3793103448275863,220,133
22400278,2,79,-2.0,-1.5189873417721518,121,42
22400278,2,40,0.0,0.0,42,2
22400278,3,160,-1.0,-0.375,720,560
22400278,3,153,3.0,1.1764705882352942,560,407
22400278,3,97,1.0,0.6185567010309279,391,294
22400278,3,94,-4.0,-2.5531914893617023,282,188
22400278,3,116,-4.0,-2.0689655172413794,188,72
22400278,3,27,0.0,0.0,50,23
22400278,3,23,-3.0,-7.826086956521739,23,0
22400278,4,87,3.0,2.0689655172413794,720,633
22400278,4,21,0.0,0.0,633,612
22400278,4,21,0.0,0.0,597,576
22400278,4,54,-1.0,-1.1111111111111112,576,522
22400278,4,117,2.0,1.0256410256410258,514,397
22400278,4,103,-3.0,-1.7475728155339807,397,294
22400278,4,17,0.0,0.0,262,245
22400278,4,84,1.0,0.7142857142857142,235,151
22400278,4,129,3.0,1.3953488372093024,151,22
22400279,1,287,9.0,1.881533101045296,720,433
22400279,1,58,2.0,2.0689655172413794,433,375
22400279,1,116,7.0,3.620689655172414,363,247
22400279,1,50,-6.0,-7.199999999999999,239,189
22400279,1,30,-2.0,-4.0,168,138
22400279,1,57,2.0,2.1052631578947367,129,72
22400279,1,55,-2.0,-2.1818181818181817,55,0
22400279,2,139,1.0,0.43165467625899284,720,581
22400279,2,20,0.0,0.0,574,554
22400279,2,39,2.0,3.0769230769230766,554,515
22400279,2,44,3.0,4.090909090909091,497,453
22400279,2,79,2.0,1.5189873417721518,453,374
22400279,2,45,5.0,6.666666666666666,367,322
22400279,2,44,1.0,1.3636363636363638,308,264
22400279,2,54,-2.0,-2.2222222222222223,264,210
22400279,3,365,0.0,0.0,720,355
22400279,3,27,2.0,4.444444444444445,339,312
22400279,3,66,-3.0,-2.7272727272727275,305,239
22400279,3,65,-1.0,-0.9230769230769231,239,174
22400279,3,90,2.0,1.3333333333333335,174,84
22400279,3,27,0.0,0.0,70,43
22400279,3,22,0.0,0.0,31,9
22400279,4,171,-5.0,-1.7543859649122806,720,549
22400279,4,26,0.0,0.0,531,505
22400279,4,81,0.0,0.0,505,424
22400279,4,58,0.0,0.0,424,366
22400279,4,27,3.0,6.666666666666666,354,327
22400279,4,115,-4.0,-2.0869565217391304,315,200
22400279,4,185,2.0,0.6486486486486487,200,15
22400279,4,11,2.0,10.90909090909091,13,2
22400279,4,1,0.0,0.0,1,0
22400280,1,297,5.0,1.0101010101010102,720,423
22400280,1,36,1.0,1.6666666666666665,409,373
22400280,1,65,4.0,3.6923076923076925,362,297
22400280,1,22,-1.0,-2.7272727272727275,281,259
22400280,1,68,1.0,0.8823529411764706,259,191
22400280,1,96,2.0,1.25,191,95
22400280,1,46,-8.0,-10.434782608695652,82,36
22400280,2,164,-2.0,-0.7317073170731707,720,556
22400280,2,8,0.0,0.0,538,530
22400280,2,50,0.0,0.0,530,480
22400280,2,43,2.0,2.7906976744186047,469,426
22400280,2,9,-1.0,-6.666666666666666,426,417
22400280,2,54,-4.0,-4.444444444444445,417,363
22400280,2,55,-1.0,-1.0909090909090908,348,293
22400280,2,47,-3.0,-3.829787234042553,293,246
22400280,2,230,12.0,3.1304347826086953,230,0
22400280,3,255,-1.0,-0.23529411764705882,720,465
22400280,3,140,-1.0,-0.42857142857142855,454,314
22400280,3,119,-8.0,-4.033613445378151,304,185
22400280,3,46,0.0,0.0,171,125
22400280,3,125,0.0,0.0,125,0
22400280,4,216,-1.0,-0.2777777777777778,720,504
22400280,4,47,1.0,1.2765957446808511,490,443
22400280,4,79,-6.0,-4.556962025316456,443,364
22400280,4,129,-2.0,-0.9302325581395349,345,216
22400280,4,81,0.0,0.0,199,118
22400280,4,112,-4.0,-2.142857142857143,112,0
22400281,1,317,4.0,0.7570977917981072,720,403
22400281,1,54,0.0,0.0,387,333
22400281,1,21,0.0,0.0,333,312
22400281,1,108,5.0,2.7777777777777777,309,201
22400281,1,12,0.0,0.0,12,0
22400281,2,280,6.0,1.2857142857142858,720,440
22400281,2,38,-2.0,-3.1578947368421053,424,386
22400281,2,31,-2.0,-3.870967741935484,382,351
22400281,2,195,8.0,2.4615384615384617,335,140
22400281,2,28,4.0,8.571428571428571,131,103
22400281,2,101,4.0,2.376237623762376,103,2
22400281,3,461,-14.0,-1.8221258134490237,720,259
22400281,3,126,2.0,0.9523809523809523,239,113
22400281,3,45,0.0,0.0,98,53
22400281,3,29,1.0,2.0689655172413794,34,5
22400281,4,104,0.0,0.0,720,616
22400281,4,71,5.0,4.225352112676057,616,545
22400281,4,87,0.0,0.0,530,443
22400281,4,142,4.0,1.6901408450704225,443,301
22400281,4,11,0.0,0.0,284,273
22400281,4,260,4.0,0.9230769230769231,260,0
22400282,1,295,6.0,1.2203389830508473,720,425
22400282,1,75,-4.0,-3.2,400,325
22400282,1,144,5.0,2.0833333333333335,325,181
22400282,1,39,1.0,1.5384615384615383,181,142
22400282,1,22,-1.0,-2.7272727272727275,130,108
22400282,1,108,2.0,1.1111111111111112,108,0
22400282,2,107,-1.0,-0.5607476635514018,720,613
22400282,2,9,1.0,6.666666666666666,613,604
22400282,2,52,0.0,0.0,604,552
22400282,2,6,0.0,0.0,537,531
22400282,2,102,0.0,0.0,519,417
22400282,2,18,0.0,0.0,400,382
22400282,2,12,-1.0,-5.0,366,354
22400282,2,3,1.0,20.0,354,351
22400282,2,24,0.0,0.0,351,327
22400282,2,168,-3.0,-1.0714285714285714,319,151
22400282,2,14,-2.0,-8.571428571428571,133,119
22400282,2,119,4.0,2.0168067226890756,119,0
22400282,3,122,-2.0,-0.9836065573770493,720,598
22400282,3,128,2.0,0.9375,598,470
22400282,3,84,2.0,1.4285714285714284,452,368
22400282,3,44,0.0,0.0,357,313
22400282,3,205,3.0,0.8780487804878049,313,108
22400282,3,66,-1.0,-0.9090909090909092,108,42
22400282,3,42,0.0,0.0,42,0
22400282,4,108,5.0,2.7777777777777777,720,612
22400282,4,117,3.0,1.5384615384615383,606,489
22400282,4,41,-1.0,-1.4634146341463414,489,448
22400282,4,72,-2.0,-1.6666666666666665,445,373
22400282,4,10,0.0,0.0,373,363
22400282,4,140,3.0,1.2857142857142858,363,223
22400282,4,38,-3.0,-4.7368421052631575,217,179
22400282,4,171,2.0,0.7017543859649122,171,0
22400283,1,482,-4.0,-0.4979253112033195,720,238
22400283,1,61,-2.0,-1.9672131147540985,212,151
22400283,1,89,-7.0,-4.719101123595506,151,62
22400283,1,54,-2.0,-2.2222222222222223,54,0
22400283,2,153,-6.0,-2.3529411764705883,720,567
22400283,2,80,0.0,0.0,554,474
22400283,2,51,1.0,1.1764705882352942,457,406
22400283,2,114,-1.0,-0.5263157894736842,406,292
22400283,2,93,2.0,1.2903225806451615,286,193
22400283,2,158,-6.0,-2.278481012658228,193,35
22400283,2,35,0.0,0.0,35,0
22400283,3,197,-2.0,-0.6091370558375634,720,523
22400283,3,78,-1.0,-0.7692307692307692,523,445
22400283,3,69,0.0,0.0,445,376
22400283,3,116,0.0,0.0,376,260
22400283,3,77,-2.0,-1.5584415584415585,247,170
22400283,3,2,2.0,60.0,156,154
22400283,3,58,-2.0,-2.0689655172413794,154,96
22400283,3,83,-5.0,-3.6144578313253013,83,0
22400283,4,66,-2.0,-1.8181818181818183,720,654
22400283,4,115,0.0,0.0,644,529
22400283,4,31,4.0,7.741935483870968,528,497
22400283,4,241,7.0,1.7427385892116183,477,236
22400283,4,34,-2.0,-3.5294117647058822,220,186
22400283,4,47,-2.0,-2.5531914893617023,186,139
22400283,4,139,-2.0,-0.8633093525179857,139,0
22400284,1,302,2.0,0.3973509933774834,720,418
22400284,1,56,1.0,1.0714285714285714,382,326
22400284,1,220,5.0,1.3636363636363638,310,90
22400284,2,178,5.0,1.6853932584269662,720,542
22400284,2,86,7.0,4.883720930232559,528,442
22400284,2,181,-1.0,-0.3314917127071823,423,242
22400284,2,41,0.0,0.0,236,195
22400284,2,55,2.0,2.1818181818181817,195,140
22400284,2,139,2.0,0.8633093525179857,140,1
22400284,3,301,6.0,1.1960132890365447,704,403
22400284,3,84,-2.0,-1.4285714285714284,390,306
22400284,3,18,-2.0,-6.666666666666666,291,273
22400284,3,76,-2.0,-1.5789473684210527,249,173
22400284,3,42,-1.0,-1.4285714285714284,163,121
22400284,3,70,-1.0,-0.8571428571428571,70,0
22400284,4,62,-2.0,-1.935483870967742,720,658
22400284,4,34,0.0,0.0,652,618
22400284,4,101,-5.0,-2.9702970297029703,608,507
22400284,4,58,-2.0,-2.0689655172413794,507,449
22400284,4,109,2.0,1.1009174311926606,449,340
22400284,4,30,-3.0,-6.0,340,310
22400284,4,114,-1.0,-0.5263157894736842,178,64
22400285,1,489,-5.0,-0.6134969325153374,720,231
22400285,1,27,2.0,4.444444444444445,231,204
22400285,1,15,2.0,8.0,180,165
22400285,1,89,-3.0,-2.0224719101123596,165,76
22400285,1,69,3.0,2.608695652173913,69,0
22400285,2,103,2.0,1.1650485436893203,720,617
22400285,2,73,0.0,0.0,617,544
22400285,2,161,-3.0,-1.1180124223602486,533,372
22400285,2,112,-1.0,-0.5357142857142857,372,260
22400285,2,146,0.0,0.0,238,92
22400285,2,66,2.0,1.8181818181818183,92,26
22400285,2,26,0.0,0.0,26,0
22400285,3,217,3.0,0.8294930875576038,720,503
22400285,3,60,-5.0,-5.0,482,422
22400285,3,64,2.0,1.875,417,353
22400285,3,28,0.0,0.0,325,297
22400285,3,17,0.0,0.0,265,248
22400285,3,38,-3.0,-4.7368421052631575,237,199
22400285,3,60,-2.0,-2.0,199,139
22400285,3,30,-5.0,-10.0,127,97
22400285,3,4,2.0,30.0,89,85
22400285,3,85,-3.0,-2.1176470588235294,85,0
22400285,4,114,-4.0,-2.1052631578947367,720,606
22400285,4,33,1.0,1.8181818181818183,606,573
22400285,4,103,1.0,0.5825242718446602,573,470
22400285,4,286,-7.0,-1.4685314685314685,470,184
22400285,4,20,2.0,6.0,184,164
22400285,4,145,-2.0,-0.8275862068965517,145,0
22400286,1,189,-6.0,-1.9047619047619047,720,531
22400286,1,214,6.0,1.6822429906542056,520,306
22400286,1,32,2.0,3.75,297,265
22400286,1,46,0.0,0.0,241,195
22400286,1,18,-1.0,-3.333333333333333,179,161
22400286,1,40,0.0,0.0,161,121
22400286,1,48,0.0,0.0,121,73
22400286,1,73,3.0,2.4657534246575343,73,0
22400286,2,80,0.0,0.0,720,640
22400286,2,96,-1.0,-0.625,640,544
22400286,2,111,2.0,1.0810810810810811,544,433
22400286,2,105,3.0,1.7142857142857142,424,319
22400286,2,30,0.0,0.0,303,273
22400286,2,54,-3.0,-3.333333333333333,272,218
22400286,2,122,2.0,0.9836065573770493,215,93
22400286,2,89,-5.0,-3.3707865168539324,89,0
22400286,3,123,-4.0,-1.9512195121951221,720,597
22400286,3,243,-3.0,-0.7407407407407407,587,344
22400286,3,129,4.0,1.8604651162790697,306,177
22400286,3,48,-1.0,-1.25,159,111
22400286,4,50,2.0,2.4,720,670
22400286,4,84,0.0,0.0,650,566
22400286,4,117,4.0,2.0512820512820515,556,439
22400286,4,114,3.0,1.5789473684210527,413,299
22400286,4,79,-4.0,-3.0379746835443036,284,205
22400286,4,177,7.0,2.3728813559322037,191,14
22400286,4,2,0.0,0.0,8,6
22400286,4,4,-2.0,-30.0,4,0
22400287,1,259,11.0,2.548262548262548,720,461
22400287,1,23,-1.0,-2.608695652173913,449,426
22400287,1,100,8.0,4.8,426,326
22400287,1,61,-3.0,-2.9508196721311473,306,245
22400287,1,22,-1.0,-2.7272727272727275,238,216
22400287,1,198,-9.0,-2.7272727272727275,216,18
22400287,1,11,0.0,0.0,11,0
22400287,2,90,3.0,2.0,720,630
22400287,2,33,2.0,3.6363636363636367,613,580
22400287,2,27,-3.0,-6.666666666666666,574,547
22400287,2,86,1.0,0.6976744186046512,535,449
22400287,2,153,-2.0,-0.7843137254901961,445,292
22400287,2,52,-2.0,-2.307692307692308,283,231
22400287,2,109,1.0,0.5504587155963303,223,114
22400287,3,309,-4.0,-0.7766990291262136,720,411
22400287,3,101,2.0,1.188118811881188,394,293
22400287,3,65,-4.0,-3.6923076923076925,293,228
22400287,3,44,3.0,4.090909090909091,212,168
22400287,3,168,-4.0,-1.4285714285714284,168,0
22400287,4,106,6.0,3.3962264150943398,720,614
22400287,4,43,3.0,4.186046511627907,614,571
22400287,4,62,-2.0,-1.935483870967742,571,509
22400287,4,69,-3.0,-2.608695652173913,494,425
22400287,4,35,-4.0,-6.857142857142857,425,390
22400287,4,25,0.0,0.0,390,365
22400287,4,32,-2.0,-3.75,365,333
22400287,4,289,-3.0,-0.6228373702422145,333,44
22400288,1,326,5.0,0.9202453987730062,720,394
22400288,1,57,-2.0,-2.1052631578947367,377,320
22400288,1,27,-1.0,-2.2222222222222223,320,293
22400288,1,39,0.0,0.0,287,248
22400288,1,75,-1.0,-0.8,248,173
22400288,1,29,0.0,0.0,160,131
22400288,1,131,1.0,0.4580152671755725,131,0
22400288,2,55,-5.0,-5.454545454545455,720,665
22400288,2,57,2.0,2.1052631578947367,657,600
22400288,2,89,-2.0,-1.348314606741573,600,511
22400288,2,22,0.0,0.0,496,474
22400288,2,50,1.0,1.2,468,418
22400288,2,114,1.0,0.5263157894736842,418,304
22400288,2,74,1.0,0.8108108108108109,304,230
22400288,2,58,0.0,0.0,230,172
22400288,2,172,7.0,2.4418604651162794,172,0
22400288,3,218,-2.0,-0.5504587155963303,720,502
22400288,3,232,5.0,1.293103448275862,482,250
22400288,3,101,5.0,2.9702970297029703,233,132
22400288,3,50,2.0,2.4,118,68
22400288,3,12,1.0,5.0,68,56
22400288,3,56,-2.0,-2.142857142857143,56,0
22400288,4,141,-7.0,-2.9787234042553195,720,579
22400288,4,181,-1.0,-0.3314917127071823,562,381
22400288,4,68,5.0,4.411764705882353,373,305
22400288,4,194,1.0,0.30927835051546393,288,94
22400288,4,26,0.0,0.0,91,65
22400288,4,52,1.0,1.153846153846154,65,13
22400288,4,11,0.0,0.0,11,0
22400289,1,260,5.0,1.153846153846154,720,460
22400289,1,170,-2.0,-0.7058823529411764,460,290
22400289,1,124,-1.0,-0.4838709677419355,275,151
22400289,1,93,5.0,3.2258064516129035,133,40
22400289,2,62,3.0,2.903225806451613,720,658
22400289,2,34,-1.0,-1.7647058823529411,637,603
22400289,2,76,1.0,0.7894736842105263,603,527
22400289,2,35,0.0,0.0,517,482
22400289,2,33,-3.0,-5.454545454545455,470,437
22400289,2,66,-1.0,-0.9090909090909092,429,363
22400289,2,65,2.0,1.8461538461538463,363,298
22400289,2,21,1.0,2.8571428571428568,298,277
22400289,2,154,0.0,0.0,277,123
22400289,2,113,4.0,2.1238938053097343,123,10
22400289,2,10,0.0,0.0,10,0
22400289,3,209,6.0,1.722488038277512,720,511
22400289,3,131,1.0,0.4580152671755725,511,380
22400289,3,64,0.0,0.0,380,316
22400289,3,14,0.0,0.0,316,302
22400289,3,119,-2.0,-1.0084033613445378,296,177
22400289,3,168,-4.0,-1.4285714285714284,168,0
22400289,4,106,0.0,0.0,720,614
22400289,4,157,1.0,0.3821656050955414,603,446
22400289,4,39,0.0,0.0,434,395
22400289,4,73,-2.0,-1.643835616438356,379,306
22400289,4,41,3.0,4.390243902439024,306,265
22400289,4,96,3.0,1.875,249,153
22400289,4,153,-10.0,-3.9215686274509807,153,0
22400290,1,375,-3.0,-0.48,720,345
22400290,1,69,-4.0,-3.4782608695652173,345,276
22400290,1,47,-1.0,-1.2765957446808511,267,220
22400290,1,54,2.0,2.2222222222222223,220,166
22400290,1,118,-2.0,-1.0169491525423728,166,48
22400290,1,46,-3.0,-3.9130434782608696,46,0
22400290,2,91,1.0,0.6593406593406594,720,629
22400290,2,109,0.0,0.0,629,520
22400290,2,43,2.0,2.7906976744186047,508,465
22400290,2,50,2.0,2.4,465,415
22400290,2,188,6.0,1.9148936170212765,391,203
22400290,2,17,0.0,0.0,203,186
22400290,2,45,-3.0,-4.0,171,126
22400290,2,45,-2.0,-2.666666666666667,126,81
22400290,3,355,-3.0,-0.5070422535211268,720,365
22400290,3,14,0.0,0.0,365,351
22400290,3,42,2.0,2.8571428571428568,331,289
22400290,3,104,4.0,2.307692307692308,282,178
22400290,3,18,4.0,13.333333333333332,163,145
22400290,3,42,-3.0,-4.285714285714286,145,103
22400290,3,103,-3.0,-1.7475728155339807,103,0
22400290,4,206,0.0,0.0,720,514
22400290,4,129,-3.0,-1.3953488372093024,496,367
22400290,4,111,0.0,0.0,367,256
22400290,4,39,3.0,4.615384615384616,238,199
22400290,4,166,1.0,0.3614457831325301,187,21
22400290,4,4,2.0,30.0,15,11
22400290,5,133,-5.0,-2.2556390977443606,300,167
22400290,5,66,-4.0,-3.6363636363636367,146,80
22400290,5,4,2.0,30.0,71,67
22400290,5,15,0.0,0.0,66,51
22400290,5,29,0.0,0.0,51,22
22400290,5,22,-1.0,-2.7272727272727275,22,0
22400291,1,405,-9.0,-1.3333333333333335,720,315
22400291,1,35,-1.0,-1.7142857142857142,315,280
22400291,1,9,0.0,0.0,280,271
22400291,1,13,0.0,0.0,263,250
22400291,1,31,-3.0,-5.806451612903226,250,219
22400291,1,120,-2.0,-1.0,213,93
22400291,1,76,0.0,0.0,76,0
22400291,2,155,4.0,1.5483870967741935,720,565
22400291,2,119,4.0,2.0168067226890756,547,428
22400291,2,11,0.0,0.0,412,401
22400291,2,54,0.0,0.0,393,339
22400291,2,161,-6.0,-2.236024844720497,326,165
22400291,2,64,-2.0,-1.875,165,101
22400291,2,38,-2.0,-3.1578947368421053,93,55
22400291,3,130,2.0,0.9230769230769231,720,590
22400291,3,36,-2.0,-3.333333333333333,581,545
22400291,3,77,-5.0,-3.8961038961038956,525,448
22400291,3,67,0.0,0.0,448,381
22400291,3,65,1.0,0.9230769230769231,381,316
22400291,3,91,-6.0,-3.956043956043956,316,225
22400291,3,20,-2.0,-6.0,211,191
22400291,3,191,2.0,0.6282722513089005,191,0
22400291,4,160,-10.0,-3.75,720,560
22400291,4,34,1.0,1.7647058823529411,527,493
22400291,4,34,-4.0,-7.0588235294117645,489,455
22400291,4,455,8.0,1.054945054945055,455,0
22400292,1,255,4.0,0.9411764705882353,720,465
22400292,1,154,5.0,1.9480519480519478,465,311
22400292,1,48,2.0,2.5,301,253
22400292,1,101,3.0,1.782178217821782,246,145
22400292,1,22,0.0,0.0,145,123
22400292,1,116,-1.0,-0.5172413793103449,116,0
22400292,2,123,0.0,0.0,720,597
22400292,2,81,0.0,0.0,587,506
22400292,2,44,2.0,2.7272727272727275,490,446
22400292,2,34,3.0,5.294117647058824,433,399
22400292,2,65,-7.0,-6.461538461538462,385,320
22400292,2,31,0.0,0.0,299,268
22400292,2,60,-2.0,-2.0,265,205
22400292,2,205,5.0,1.4634146341463414,205,0
22400292,3,254,-5.0,-1.1811023622047243,720,466
22400292,3,58,4.0,4.137931034482759,466,408
22400292,3,102,-3.0,-1.7647058823529411,399,297
22400292,3,61,2.0,1.9672131147540985,282,221
22400292,3,45,-3.0,-4.0,210,165
22400292,3,149,4.0,1.610738255033557,149,0
22400292,4,169,2.0,0.7100591715976331,720,551
22400292,4,53,0.0,0.0,551,498
22400292,4,71,-2.0,-1.6901408450704225,490,419
22400292,4,117,0.0,0.0,419,302
22400292,4,219,-1.0,-0.273972602739726,295,76
22400292,4,6,1.0,10.0,74,68
22400292,4,68,-1.0,-0.8823529411764706,68,0
22400293,1,203,4.0,1.1822660098522169,720,517
22400293,1,17,0.0,0.0,499,482
22400293,1,103,-6.0,-3.4951456310679614,482,379
22400293,1,46,0.0,0.0,365,319
22400293,1,134,-1.0,-0.44776119402985076,319,185
22400293,1,107,8.0,4.485981308411215,174,67
22400293,1,54,4.0,4.444444444444445,54,0
22400293,2,194,5.0,1.5463917525773194,720,526
22400293,2,97,7.0,4.329896907216495,526,429
22400293,2,24,2.0,5.0,398,374
22400293,2,44,2.0,2.7272727272727275,363,319
22400293,2,35,0.0,0.0,319,284
22400293,2,105,2.0,1.142857142857143,262,157
22400293,2,144,4.0,1.6666666666666665,144,0
22400293,3,239,0.0,0.0,720,481
22400293,3,82,4.0,2.926829268292683,473,391
22400293,3,2,0.0,0.0,383,381
22400293,3,82,2.0,1.4634146341463414,367,285
22400293,3,61,0.0,0.0,262,201
22400293,3,55,3.0,3.2727272727272725,190,135
22400293,3,115,-1.0,-0.5217391304347826,115,0
22400293,4,158,-3.0,-1.139240506329114,720,562
22400293,4,21,0.0,0.0,555,534
22400293,4,50,3.0,3.5999999999999996,534,484
22400293,4,82,0.0,0.0,479,397
22400293,4,70,-2.0,-1.7142857142857142,397,327
22400293,4,71,0.0,0.0,327,256
22400293,4,30,0.0,0.0,256,226
22400293,4,31,-1.0,-1.935483870967742,225,194
22400293,4,170,0.0,0.0,170,0
22400294,1,198,1.0,0.30303030303030304,720,522
22400294,1,98,0.0,0.0,514,416
22400294,1,53,1.0,1.1320754716981132,404,351
22400294,1,125,0.0,0.0,351,226
22400294,1,33,3.0,5.454545454545455,215,182
22400294,1,125,-3.0,-1.44,171,46
22400294,1,46,0.0,0.0,46,0
22400294,2,103,0.0,0.0,720,617
22400294,2,113,-3.0,-1.592920353982301,617,504
22400294,2,16,0.0,0.0,504,488
22400294,2,35,-2.0,-3.4285714285714284,483,448
22400294,2,33,-2.0,-3.6363636363636367,448,415
22400294,2,35,-2.0,-3.4285714285714284,404,369
22400294,2,64,0.0,0.0,366,302
22400294,2,25,-2.0,-4.8,290,265
22400294,2,133,4.0,1.8045112781954886,252,119
22400294,2,25,-1.0,-2.4,111,86
22400294,2,86,-2.0,-1.3953488372093024,86,0
22400294,3,164,5.0,1.8292682926829267,720,556
22400294,3,166,0.0,0.0,537,371
22400294,3,22,2.0,5.454545454545455,358,336
22400294,3,83,0.0,0.0,336,253
22400294,3,29,2.0,4.137931034482759,248,219
22400294,3,49,2.0,2.4489795918367343,202,153
22400294,3,61,0.0,0.0,142,81
22400294,3,62,3.0,2.903225806451613,72,10
22400294,3,2,-2.0,-60.0,2,0
22400294,4,114,3.0,1.5789473684210527,720,606
22400294,4,14,-2.0,-8.571428571428571,598,584
22400294,4,30,-2.0,-4.0,584,554
22400294,4,67,2.0,1.791044776119403,542,475
22400294,4,137,-4.0,-1.751824817518248,448,311
22400294,4,90,-4.0,-2.666666666666667,311,221
22400294,4,122,-11.0,-5.409836065573771,208,86
22400294,4,81,-3.0,-2.2222222222222223,81,0
22400295,1,179,-3.0,-1.005586592178771,720,541
22400295,1,134,3.0,1.3432835820895521,541,407
22400295,1,131,-3.0,-1.3740458015267176,395,264
22400295,1,155,2.0,0.7741935483870968,246,91
22400295,1,64,1.0,0.9375,73,9
22400295,1,1,0.0,0.0,1,0
22400295,2,208,0.0,0.0,720,512
22400295,2,73,2.0,1.643835616438356,496,423
22400295,2,18,0.0,0.0,409,391
22400295,2,7,2.0,17.142857142857142,383,376
22400295,2,41,-4.0,-5.853658536585366,376,335
22400295,2,41,-3.0,-4.390243902439024,284,243
22400295,2,41,-2.0,-2.926829268292683,231,190
22400295,2,10,-2.0,-12.0,175,165
22400295,2,165,-2.0,-0.7272727272727273,165,0
22400295,3,156,-3.0,-1.153846153846154,720,564
22400295,3,138,-4.0,-1.7391304347826086,564,426
22400295,3,47,-1.0,-1.2765957446808511,416,369
22400295,3,45,-3.0,-4.0,369,324
22400295,3,36,-2.0,-3.333333333333333,318,282
22400295,3,37,4.0,6.486486486486487,282,245
22400295,3,39,0.0,0.0,224,185
22400295,3,120,-2.0,-1.0,173,53
22400295,4,32,0.0,0.0,720,688
22400295,4,126,-6.0,-2.8571428571428568,682,556
22400295,4,71,0.0,0.0,550,479
22400295,4,20,-2.0,-6.0,466,446
22400295,4,69,-1.0,-0.8695652173913043,446,377
22400295,4,138,-3.0,-1.3043478260869565,361,223
22400295,4,10,0.0,0.0,223,213
22400295,4,207,6.0,1.7391304347826086,207,0
22400296,1,334,-2.0,-0.3592814371257485,720,386
22400296,1,59,-2.0,-2.0338983050847457,375,316
22400296,1,96,-2.0,-1.25,314,218
22400296,1,86,-4.0,-2.7906976744186047,206,120
22400296,1,120,1.0,0.5,120,0
22400296,2,127,-2.0,-0.9448818897637795,720,593
22400296,2,35,1.0,1.7142857142857142,585,550
22400296,2,109,-5.0,-2.7522935779816518,550,441
22400296,2,4,0.0,0.0,421,417
22400296,2,37,0.0,0.0,403,366
22400296,2,6,2.0,20.0,354,348
22400296,2,28,-1.0,-2.142857142857143,331,303
22400296,2,109,5.0,2.7522935779816518,303,194
22400296,2,20,0.0,0.0,185,165
22400296,2,85,-1.0,-0.7058823529411764,150,65
22400296,2,65,1.0,0.9230769230769231,65,0
22400296,3,311,7.0,1.3504823151125402,720,409
22400296,3,39,1.0,1.5384615384615383,401,362
22400296,3,12,0.0,0.0,362,350
22400296,3,15,-2.0,-8.0,335,320
22400296,3,107,1.0,0.5607476635514018,301,194
22400296,3,57,1.0,1.0526315789473684,186,129
22400296,3,41,-3.0,-4.390243902439024,115,74
22400296,3,71,-1.0,-0.8450704225352113,71,0
22400296,4,113,1.0,0.5309734513274336,720,607
22400296,4,174,1.0,0.3448275862068966,593,419
22400296,4,21,-2.0,-5.7142857142857135,403,382
22400296,4,158,-2.0,-0.7594936708860759,371,213
22400296,4,44,0.0,0.0,213,169
22400296,4,153,1.0,0.39215686274509803,153,0
22400297,1,299,-2.0,-0.4013377926421405,720,421
22400297,1,87,4.0,2.7586206896551726,414,327
22400297,1,34,-1.0,-1.7647058823529411,312,278
22400297,1,83,-1.0,-0.7228915662650602,278,195
22400297,1,122,-1.0,-0.49180327868852464,195,73
22400297,1,73,-3.0,-2.4657534246575343,73,0
22400297,2,165,0.0,0.0,720,555
22400297,2,46,3.0,3.9130434782608696,548,502
22400297,2,17,0.0,0.0,490,473
22400297,2,23,-1.0,-2.608695652173913,454,431
22400297,2,37,0.0,0.0,431,394
22400297,2,77,1.0,0.7792207792207793,384,307
22400297,2,29,2.0,4.137931034482759,298,269
22400297,2,48,-5.0,-6.25,256,208
22400297,2,43,0.0,0.0,208,165
22400297,2,94,2.0,1.2765957446808511,154,60
22400297,3,279,-6.0,-1.2903225806451615,720,441
22400297,3,16,0.0,0.0,431,415
22400297,3,61,1.0,0.9836065573770493,406,345
22400297,3,43,0.0,0.0,342,299
22400297,3,56,-1.0,-1.0714285714285714,285,229
22400297,3,31,2.0,3.870967741935484,229,198
22400297,3,121,-3.0,-1.487603305785124,182,61
22400297,3,48,1.0,1.25,49,1
22400297,3,1,-2.0,-120.0,1,0
22400297,4,274,-2.0,-0.437956204379562,720,446
22400297,4,23,-3.0,-7.826086956521739,421,398
22400297,4,61,1.0,0.9836065573770493,395,334
22400297,4,98,4.0,2.4489795918367343,328,230
22400297,4,135,2.0,0.888888888888889,211,76
22400297,4,38,0.0,0.0,76,38
22400297,4,38,2.0,3.1578947368421053,38,0
22400298,1,323,6.0,1.1145510835913313,720,397
22400298,1,116,1.0,0.5172413793103449,379,263
22400298,1,24,-1.0,-2.5,257,233
22400298,1,60,1.0,1.0,233,173
22400298,1,167,-7.0,-2.5149700598802394,167,0
22400298,2,154,2.0,0.7792207792207793,720,566
22400298,2,22,0.0,0.0,543,521
22400298,2,75,-3.0,-2.4,521,446
22400298,2,58,-4.0,-4.137931034482759,432,374
22400298,2,155,-1.0,-0.3870967741935484,354,199
22400298,2,185,-6.0,-1.945945945945946,185,0
22400298,3,393,-9.0,-1.3740458015267176,720,327
22400298,3,12,-2.0,-10.0,327,315
22400298,3,172,-3.0,-1.0465116279069768,315,143
22400298,3,24,0.0,0.0,132,108
22400298,3,68,-2.0,-1.7647058823529411,101,33
22400298,3,33,2.0,3.6363636363636367,33,0
22400298,4,262,7.0,1.6030534351145038,720,458
22400298,4,39,0.0,0.0,458,419
22400298,4,119,-2.0,-1.0084033613445378,419,300
22400298,4,66,2.0,1.8181818181818183,300,234
22400298,4,133,1.0,0.45112781954887216,230,97
22400298,4,82,0.0,0.0,82,0
22400299,1,333,-6.0,-1.0810810810810811,720,387
22400299,1,151,-1.0,-0.3973509933774834,387,236
22400299,1,71,0.0,0.0,236,165
22400299,1,149,-6.0,-2.4161073825503356,149,0
22400299,2,126,3.0,1.4285714285714284,720,594
22400299,2,137,4.0,1.751824817518248,581,444
22400299,2,69,-5.0,-4.3478260869565215,432,363
22400299,2,2,-1.0,-30.0,342,340
22400299,2,163,3.0,1.1042944785276074,324,161
22400299,2,39,3.0,4.615384615384616,161,122
22400299,2,76,1.0,0.7894736842105263,112,36
22400299,3,214,4.0,1.1214953271028036,720,506
22400299,3,218,0.0,0.0,506,288
22400299,3,39,0.0,0.0,280,241
22400299,3,114,0.0,0.0,234,120
22400299,3,36,3.0,5.0,107,71
22400299,3,55,2.0,2.1818181818181817,56,1
22400299,3,1,0.0,0.0,1,0
22400299,4,134,0.0,0.0,720,586
22400299,4,28,2.0,4.285714285714286,575,547
22400299,4,43,-4.0,-5.5813953488372094,547,504
22400299,4,55,0.0,0.0,494,439
22400299,4,83,2.0,1.4457831325301205,428,345
22400299,4,66,0.0,0.0,345,279
22400299,4,33,-4.0,-7.272727272727273,264,231
22400299,4,182,-3.0,-0.989010989010989,231,49
22400299,4,7,2.0,17.142857142857142,26,19
22400299,4,10,3.0,18.0,17,7
22400300,1,339,-2.0,-0.35398230088495575,720,381
22400300,1,41,-1.0,-1.4634146341463414,372,331
22400300,1,88,5.0,3.409090909090909,331,243
22400300,1,49,3.0,3.673469387755102,221,172
22400300,1,64,-4.0,-3.75,155,91
22400300,1,91,-1.0,-0.6593406593406594,91,0
22400300,2,126,3.0,1.4285714285714284,720,594
22400300,2,19,-2.0,-6.315789473684211,594,575
22400300,2,16,0.0,0.0,563,547
22400300,2,39,2.0,3.0769230769230766,538,499
22400300,2,103,0.0,0.0,480,377
22400300,2,86,-2.0,-1.3953488372093024,359,273
22400300,2,2,-1.0,-30.0,263,261
22400300,2,157,-7.0,-2.6751592356687897,261,104
22400300,2,18,1.0,3.333333333333333,93,75
22400300,3,325,-1.0,-0.18461538461538463,720,395
22400300,3,102,7.0,4.11764705882353,385,283
22400300,3,62,1.0,0.967741935483871,273,211
22400300,3,53,2.0,2.2641509433962264,211,158
22400300,3,78,-4.0,-3.0769230769230766,152,74
22400300,3,59,0.0,0.0,59,0
22400300,4,76,-3.0,-2.3684210526315788,720,644
22400300,4,37,-2.0,-3.2432432432432434,625,588
22400300,4,145,0.0,0.0,580,435
22400300,4,149,3.0,1.2080536912751678,422,273
22400300,4,196,4.0,1.2244897959183672,262,66
22400300,4,47,-2.0,-2.5531914893617023,66,19
22400300,4,1,0.0,0.0,14,13
22400301,1,213,-1.0,-0.28169014084507044,720,507
22400301,1,120,-9.0,-4.5,495,375
22400301,1,50,1.0,1.2,362,312
22400301,1,48,-2.0,-2.5,297,249
22400301,1,44,-1.0,-1.3636363636363638,231,187
22400301,1,20,-1.0,-3.0,184,164
22400301,1,64,-2.0,-1.875,161,97
22400301,2,152,5.0,1.9736842105263157,720,568
22400301,2,51,-2.0,-2.3529411764705883,548,497
22400301,2,83,4.0,2.891566265060241,483,400
22400301,2,14,-2.0,-8.571428571428571,400,386
22400301,2,26,2.0,4.615384615384616,349,323
22400301,2,33,-2.0,-3.6363636363636367,308,275
22400301,2,268,8.0,1.791044776119403,275,7
22400301,2,5,0.0,0.0,5,0
22400301,3,340,-10.0,-1.7647058823529411,720,380
22400301,3,63,2.0,1.9047619047619047,363,300
22400301,3,80,-5.0,-3.75,300,220
22400301,3,95,0.0,0.0,215,120
22400301,3,44,0.0,0.0,100,56
22400301,3,18,1.0,3.333333333333333,56,38
22400301,3,9,0.0,0.0,38,29
22400301,3,24,0.0,0.0,29,5
22400301,3,1,0.0,0.0,1,0
22400301,4,147,0.0,0.0,720,573
22400301,4,33,-2.0,-3.6363636363636367,563,530
22400301,4,18,3.0,10.0,521,503
22400301,4,103,0.0,0.0,489,386
22400301,4,135,-3.0,-1.3333333333333335,379,244
22400301,4,36,3.0,5.0,244,208
22400301,4,25,0.0,0.0,208,183
22400301,4,167,6.0,2.155688622754491,167,0
22400302,1,424,-5.0,-0.7075471698113208,720,296
22400302,1,42,-1.0,-1.4285714285714284,292,250
22400302,1,87,2.0,1.3793103448275863,250,163
22400302,1,145,2.0,0.8275862068965517,145,0
22400302,2,260,-1.0,-0.23076923076923078,720,460
22400302,2,22,2.0,5.454545454545455,460,438
22400302,2,12,0.0,0.0,417,405
22400302,2,81,7.0,5.185185185185185,396,315
22400302,2,27,3.0,6.666666666666666,303,276
22400302,2,23,3.0,7.826086956521739,276,253
22400302,2,81,-5.0,-3.7037037037037033,231,150
22400302,2,150,3.0,1.2,150,0
22400302,3,310,1.0,0.1935483870967742,720,410
22400302,3,67,0.0,0.0,405,338
22400302,3,66,3.0,2.7272727272727275,338,272
22400302,3,56,-2.0,-2.142857142857143,254,198
22400302,3,144,-4.0,-1.6666666666666665,177,33
22400302,3,1,0.0,0.0,22,21
22400302,3,15,0.0,0.0,20,5
22400302,4,221,1.0,0.2714932126696833,720,499
22400302,4,39,0.0,0.0,491,452
22400302,4,19,0.0,0.0,437,418
22400302,4,90,-3.0,-2.0,409,319
22400302,4,14,-2.0,-8.571428571428571,311,297
22400302,4,98,4.0,2.4489795918367343,297,199
22400302,4,128,3.0,1.40625,193,65
22400302,4,16,2.0,7.5,65,49
22400302,4,3,0.0,0.0,49,46
22400302,4,46,0.0,0.0,46,0
22400303,1,281,-1.0,-0.21352313167259784,720,439
22400303,1,76,1.0,0.7894736842105263,426,350
22400303,1,28,0.0,0.0,334,306
22400303,1,10,1.0,6.0,298,288
22400303,1,46,-1.0,-1.3043478260869565,288,242
22400303,1,76,4.0,3.1578947368421053,242,166
22400303,1,77,3.0,2.3376623376623376,166,89
22400303,1,89,3.0,2.0224719101123596,89,0
22400303,2,132,6.0,2.7272727272727275,720,588
22400303,2,107,-6.0,-3.364485981308411,577,470
22400303,2,19,3.0,9.473684210526315,461,442
22400303,2,51,0.0,0.0,417,366
22400303,2,52,2.0,2.307692307692308,362,310
22400303,2,149,6.0,2.4161073825503356,302,153
22400303,2,99,1.0,0.6060606060606061,149,50
22400303,2,50,0.0,0.0,50,0
22400303,3,351,-5.0,-0.8547008547008548,720,369
22400303,3,21,-2.0,-5.7142857142857135,347,326
22400303,3,48,2.0,2.5,326,278
22400303,3,126,0.0,0.0,278,152
22400303,3,32,1.0,1.875,143,111
22400303,3,47,-2.0,-2.5531914893617023,111,64
22400303,3,64,0.0,0.0,64,0
22400303,4,233,0.0,0.0,720,487
22400303,4,31,2.0,3.870967741935484,487,456
22400303,4,144,7.0,2.9166666666666665,441,297
22400303,4,61,-4.0,-3.934426229508197,291,230
22400303,4,139,-8.0,-3.4532374100719427,215,76
22400303,4,34,4.0,7.0588235294117645,71,37
22400303,4,32,1.0,1.875,32,0
22400304,1,360,-6.0,-1.0,720,360
22400304,1,27,-3.0,-6.666666666666666,356,329
22400304,1,73,2.0,1.643835616438356,321,248
22400304,1,78,-3.0,-2.307692307692308,233,155
22400304,1,140,-6.0,-2.5714285714285716,140,0
22400304,2,89,5.0,3.3707865168539324,720,631
22400304,2,61,3.0,2.9508196721311473,605,544
22400304,2,84,-2.0,-1.4285714285714284,536,452
22400304,2,13,0.0,0.0,448,435
22400304,2,72,-1.0,-0.8333333333333333,435,363
22400304,2,131,3.0,1.3740458015267176,351,220
22400304,2,30,1.0,2.0,220,190
22400304,2,165,3.0,1.0909090909090908,190,25
22400304,2,25,-3.0,-7.199999999999999,25,0
22400304,3,281,0.0,0.0,720,439
22400304,3,55,-2.0,-2.1818181818181817,361,306
22400304,3,88,-2.0,-1.3636363636363638,295,207
22400304,3,36,2.0,3.333333333333333,194,158
22400304,3,127,1.0,0.47244094488188976,151,24
22400304,3,24,0.0,0.0,24,0
22400304,4,275,5.0,1.0909090909090908,720,445
22400304,4,51,-5.0,-5.88235294117647,430,379
22400304,4,274,-4.0,-0.875912408759124,354,80
22400304,4,24,0.0,0.0,71,47
22400304,4,44,2.0,2.7272727272727275,44,0
22400305,1,212,0.0,0.0,720,508
22400305,1,68,1.0,0.8823529411764706,508,440
22400305,1,73,0.0,0.0,423,350
22400305,1,31,1.0,1.935483870967742,332,301
22400305,1,105,2.0,1.142857142857143,301,196
22400305,1,21,0.0,0.0,196,175
22400305,1,98,4.0,2.4489795918367343,175,77
22400305,1,13,0.0,0.0,67,54
22400305,2,206,-4.0,-1.1650485436893203,720,514
22400305,2,132,2.0,0.9090909090909092,503,371
22400305,2,35,-3.0,-5.142857142857143,321,286
22400305,2,19,1.0,3.1578947368421053,286,267
22400305,2,23,1.0,2.608695652173913,267,244
22400305,2,213,0.0,0.0,244,31
22400305,2,31,0.0,0.0,31,0
22400305,3,79,0.0,0.0,720,641
22400305,3,59,0.0,0.0,641,582
22400305,3,144,-6.0,-2.5,582,438
22400305,3,112,2.0,1.0714285714285714,423,311
22400305,3,38,-3.0,-4.7368421052631575,291,253
22400305,3,123,2.0,0.9756097560975611,251,128
22400305,3,114,0.0,0.0,114,0
22400305,4,94,5.0,3.1914893617021276,720,626
22400305,4,82,3.0,2.195121951219512,626,544
22400305,4,6,0.0,0.0,535,529
22400305,4,104,1.0,0.576923076923077,525,421
22400305,4,38,-2.0,-3.1578947368421053,396,358
22400305,4,50,0.0,0.0,345,295
22400305,4,100,-5.0,-3.0,280,180
22400305,4,41,-2.0,-2.926829268292683,180,139
22400305,4,75,2.0,1.6,127,52
22400305,4,34,1.0,1.7647058823529411,52,18
22400305,4,18,-1.0,-3.333333333333333,18,0
22400306,1,326,-12.0,-2.208588957055215,720,394
22400306,1,59,0.0,0.0,385,326
22400306,1,51,3.0,3.5294117647058822,315,264
22400306,1,34,-2.0,-3.5294117647058822,256,222
22400306,1,48,-4.0,-5.0,205,157
22400306,1,27,0.0,0.0,145,118
22400306,1,66,-1.0,-0.9090909090909092,118,52
22400306,1,51,3.0,3.5294117647058822,52,1
22400306,2,125,0.0,0.0,720,595
22400306,2,1,0.0,0.0,585,584
22400306,2,77,-1.0,-0.7792207792207793,567,490
22400306,2,45,-1.0,-1.3333333333333335,490,445
22400306,2,38,4.0,6.315789473684211,433,395
22400306,2,10,1.0,6.0,382,372
22400306,2,45,2.0,2.666666666666667,372,327
22400306,2,161,4.0,1.4906832298136645,316,155
22400306,2,79,1.0,0.7594936708860759,136,57
22400306,2,44,1.0,1.3636363636363638,57,13
22400306,2,13,-2.0,-9.230769230769232,13,0
22400306,3,61,4.0,3.934426229508197,720,659
22400306,3,189,5.0,1.5873015873015872,638,449
22400306,3,71,-4.0,-3.380281690140845,442,371
22400306,3,17,0.0,0.0,355,338
22400306,3,74,5.0,4.054054054054054,332,258
22400306,3,53,0.0,0.0,246,193
22400306,3,76,3.0,2.3684210526315788,193,117
22400306,3,107,2.0,1.1214953271028036,107,0
22400306,4,96,-1.0,-0.625,720,624
22400306,4,72,1.0,0.8333333333333333,617,545
22400306,4,47,0.0,0.0,545,498
22400306,4,48,0.0,0.0,498,450
22400306,4,52,1.0,1.153846153846154,450,398
22400306,4,83,1.0,0.7228915662650602,398,315
22400306,4,70,4.0,3.4285714285714284,315,245
22400306,4,65,4.0,3.6923076923076925,229,164
22400306,4,31,2.0,3.870967741935484,164,133
22400306,4,10,0.0,0.0,119,109
22400306,4,25,-2.0,-4.8,104,79
22400306,4,79,3.0,2.278481012658228,79,0
22400307,1,384,0.0,0.0,720,336
22400307,1,144,-3.0,-1.25,324,180
22400307,1,14,2.0,8.571428571428571,166,152
22400307,1,144,0.0,0.0,144,0
22400307,2,121,2.0,0.9917355371900827,720,599
22400307,2,114,3.0,1.5789473684210527,592,478
22400307,2,33,-3.0,-5.454545454545455,462,429
22400307,2,20,1.0,3.0,412,392
22400307,2,30,-3.0,-6.0,392,362
22400307,2,145,-4.0,-1.6551724137931034,353,208
22400307,2,191,4.0,1.256544502617801,196,5
22400307,2,5,0.0,0.0,5,0
22400307,3,329,-9.0,-1.6413373860182372,720,391
22400307,3,85,0.0,0.0,377,292
22400307,3,93,-2.0,-1.2903225806451615,278,185
22400307,3,174,-3.0,-1.0344827586206897,174,0
22400307,4,284,3.0,0.6338028169014085,720,436
22400307,4,78,3.0,2.307692307692308,407,329
22400307,4,80,3.0,2.25,321,241
22400307,4,51,1.0,1.1764705882352942,241,190
22400307,4,135,6.0,2.666666666666667,169,34
22400307,4,3,1.0,20.0,24,21
22400307,4,7,-3.0,-25.71428571428571,21,14
22400307,4,3,0.0,0.0,14,11
22400307,4,4,0.0,0.0,11,7
22400308,1,226,1.0,0.2654867256637168,720,494
22400308,1,88,7.0,4.7727272727272725,494,406
22400308,1,127,1.0,0.47244094488188976,393,266
22400308,1,106,6.0,3.3962264150943398,256,150
22400308,1,109,2.0,1.1009174311926606,136,27
22400308,2,196,3.0,0.9183673469387755,720,524
22400308,2,33,-2.0,-3.6363636363636367,517,484
22400308,2,32,0.0,0.0,484,452
22400308,2,24,2.0,5.0,445,421
22400308,2,39,4.0,6.153846153846153,413,374
22400308,2,37,0.0,0.0,353,316
22400308,2,38,1.0,1.5789473684210527,313,275
22400308,2,100,2.0,1.2,275,175
22400308,2,161,1.0,0.37267080745341613,161,0
22400308,3,427,1.0,0.1405152224824356,720,293
22400308,3,41,2.0,2.926829268292683,293,252
22400308,3,95,2.0,1.263157894736842,249,154
22400308,3,102,2.0,1.1764705882352942,154,52
22400308,3,52,2.0,2.307692307692308,52,0
22400308,4,178,3.0,1.0112359550561798,720,542
22400308,4,48,-2.0,-2.5,542,494
22400308,4,87,-3.0,-2.0689655172413794,494,407
22400308,4,22,0.0,0.0,405,383
22400308,4,80,2.0,1.5,383,303
22400308,4,273,-8.0,-1.7582417582417582,288,15
22400309,1,328,-3.0,-0.548780487804878,720,392
22400309,1,104,4.0,2.307692307692308,380,276
22400309,1,19,0.0,0.0,276,257
22400309,1,147,8.0,3.2653061224489797,257,110
22400309,1,90,0.0,0.0,90,0
22400309,2,145,-4.0,-1.6551724137931034,720,575
22400309,2,79,-7.0,-5.3164556962025316,567,488
22400309,2,41,2.0,2.926829268292683,474,433
22400309,2,29,-2.0,-4.137931034482759,423,394
22400309,2,16,0.0,0.0,394,378
22400309,2,39,0.0,0.0,378,339
22400309,2,19,-3.0,-9.473684210526315,321,302
22400309,2,3,-1.0,-20.0,279,276
22400309,2,53,7.0,7.9245283018867925,276,223
22400309,2,124,4.0,1.935483870967742,201,77
22400309,2,50,0.0,0.0,77,27
22400309,2,27,0.0,0.0,27,0
22400309,3,305,-7.0,-1.3770491803278688,720,415
22400309,3,61,1.0,0.9836065573770493,415,354
22400309,3,46,3.0,3.9130434782608696,354,308
22400309,3,54,3.0,3.333333333333333,305,251
22400309,3,167,3.0,1.0778443113772456,232,65
22400309,3,65,1.0,0.9230769230769231,65,0
22400309,4,196,-2.0,-0.6122448979591836,720,524
22400309,4,80,5.0,3.75,510,430
22400309,4,24,-2.0,-5.0,417,393
22400309,4,369,-5.0,-0.8130081300813009,393,24
22400309,4,12,-1.0,-5.0,12,0
22400310,1,371,1.0,0.16172506738544476,720,349
22400310,1,58,2.0,2.0689655172413794,341,283
22400310,1,65,3.0,2.769230769230769,283,218
22400310,1,66,3.0,2.7272727272727275,205,139
22400310,1,139,1.0,0.43165467625899284,139,0
22400310,2,181,1.0,0.3314917127071823,720,539
22400310,2,25,2.0,4.8,538,513
22400310,2,95,0.0,0.0,493,398
22400310,2,34,-3.0,-5.294117647058824,388,354
22400310,2,44,6.0,8.181818181818182,345,301
22400310,2,9,0.0,0.0,301,292
22400310,2,107,-5.0,-2.803738317757009,292,185
22400310,2,26,0.0,0.0,185,159
22400310,2,121,0.0,0.0,155,34
22400310,2,32,-2.0,-3.75,32,0
22400310,3,292,1.0,0.2054794520547945,720,428
22400310,3,58,-1.0,-1.0344827586206897,428,370
22400310,3,42,-2.0,-2.8571428571428568,370,328
22400310,3,73,-4.0,-3.287671232876712,328,255
22400310,3,3,-1.0,-20.0,243,240
22400310,3,124,-3.0,-1.4516129032258065,240,116
22400310,3,107,3.0,1.6822429906542056,107,0
22400310,4,112,2.0,1.0714285714285714,720,608
22400310,4,20,0.0,0.0,603,583
22400310,4,56,0.0,0.0,575,519
22400310,4,79,1.0,0.7594936708860759,505,426
22400310,4,16,0.0,0.0,407,391
22400310,4,14,0.0,0.0,378,364
22400310,4,9,1.0,6.666666666666666,347,338
22400310,4,60,0.0,0.0,325,265
22400310,4,48,0.0,0.0,261,213
22400310,4,24,-2.0,-5.0,213,189
22400310,4,63,1.0,0.9523809523809523,178,115
22400310,4,69,4.0,3.4782608695652173,102,33
22400310,4,22,1.0,2.7272727272727275,26,4
22400310,4,1,0.0,0.0,1,0
22400311,1,318,0.0,0.0,720,402
22400311,1,59,0.0,0.0,383,324
22400311,1,37,1.0,1.6216216216216217,320,283
22400311,1,49,2.0,2.4489795918367343,277,228
22400311,1,52,1.0,1.153846153846154,218,166
22400311,1,16,0.0,0.0,166,150
22400311,1,32,-3.0,-5.625,140,108
22400311,1,47,-3.0,-3.829787234042553,58,11
22400311,1,11,0.0,0.0,11,0
22400311,2,277,5.0,1.0830324909747293,720,443
22400311,2,56,-4.0,-4.285714285714286,443,387
22400311,2,137,3.0,1.3138686131386863,375,238
22400311,2,167,-6.0,-2.155688622754491,235,68
22400311,2,64,1.0,0.9375,64,0
22400311,3,288,4.0,0.8333333333333333,720,432
22400311,3,78,0.0,0.0,432,354
22400311,3,112,-3.0,-1.607142857142857,351,239
22400311,3,17,0.0,0.0,229,212
22400311,3,46,0.0,0.0,202,156
22400311,3,156,3.0,1.153846153846154,156,0
22400311,4,56,3.0,3.214285714285714,720,664
22400311,4,126,-4.0,-1.9047619047619047,649,523
22400311,4,96,-1.0,-0.625,511,415
22400311,4,18,-2.0,-6.666666666666666,391,373
22400311,4,29,0.0,0.0,216,187
22400311,4,174,3.0,1.0344827586206897,176,2
22400312,1,239,9.0,2.2594142259414225,720,481
22400312,1,132,2.0,0.9090909090909092,475,343
22400312,1,11,-2.0,-10.90909090909091,343,332
22400312,1,66,1.0,0.9090909090909092,332,266
22400312,1,55,-5.0,-5.454545454545455,266,211
22400312,1,82,3.0,2.195121951219512,211,129
22400312,1,62,-3.0,-2.903225806451613,117,55
22400312,2,196,0.0,0.0,720,524
22400312,2,13,0.0,0.0,518,505
22400312,2,3,0.0,0.0,493,490
22400312,2,24,1.0,2.5,477,453
22400312,2,18,-1.0,-3.333333333333333,453,435
22400312,2,16,0.0,0.0,435,419
22400312,2,74,3.0,2.4324324324324325,419,345
22400312,2,64,2.0,1.875,331,267
22400312,2,40,-4.0,-6.0,253,213
22400312,2,57,-4.0,-4.2105263157894735,213,156
22400312,2,143,-2.0,-0.8391608391608392,143,0
22400312,3,326,-1.0,-0.18404907975460122,720,394
22400312,3,143,1.0,0.4195804195804196,394,251
22400312,3,71,3.0,2.535211267605634,232,161
22400312,3,97,-3.0,-1.8556701030927836,161,64
22400312,3,40,1.0,1.5,52,12
22400312,4,216,-6.0,-1.6666666666666665,720,504
22400312,4,1,-1.0,-60.0,495,494
22400312,4,2,0.0,0.0,494,492
22400312,4,38,3.0,4.7368421052631575,480,442
22400312,4,16,0.0,0.0,431,415
22400312,4,327,4.0,0.7339449541284404,415,88
22400312,4,51,-4.0,-4.705882352941177,80,29
22400312,4,11,-1.0,-5.454545454545455,28,17
22400312,4,17,-1.0,-3.5294117647058822,17,0
22400313,1,359,0.0,0.0,720,361
22400313,1,92,2.0,1.3043478260869565,357,265
22400313,1,109,6.0,3.302752293577982,254,145
22400313,1,66,-1.0,-0.9090909090909092,66,0
22400313,2,146,0.0,0.0,720,574
22400313,2,27,0.0,0.0,574,547
22400313,2,89,-6.0,-4.044943820224719,535,446
22400313,2,79,0.0,0.0,438,359
22400313,2,14,1.0,4.285714285714286,359,345
22400313,2,164,-3.0,-1.097560975609756,345,181
22400313,2,115,3.0,1.5652173913043477,170,55
22400313,2,52,-2.0,-2.307692307692308,55,3
22400313,3,377,-5.0,-0.7957559681697614,720,343
22400313,3,141,0.0,0.0,332,191
22400313,3,97,-3.0,-1.8556701030927836,181,84
22400313,3,73,0.0,0.0,73,0
22400313,4,104,-1.0,-0.576923076923077,720,616
22400313,4,41,1.0,1.4634146341463414,596,555
22400313,4,42,0.0,0.0,545,503
22400313,4,60,-2.0,-2.0,491,431
22400313,4,126,0.0,0.0,413,287
22400313,4,125,-3.0,-1.44,277,152
22400313,4,126,0.0,0.0,146,20
22400313,4,5,3.0,36.0,16,11
22400313,4,9,1.0,6.666666666666666,9,0
22400314,1,354,2.0,0.3389830508474576,720,366
22400314,1,92,-3.0,-1.9565217391304348,366,274
22400314,1,27,-1.0,-2.2222222222222223,260,233
22400314,1,84,5.0,3.571428571428571,233,149
22400314,1,87,3.0,2.0689655172413794,149,62
22400314,1,62,-1.0,-0.967741935483871,62,0
22400314,2,222,-2.0,-0.5405405405405406,720,498
22400314,2,47,-3.0,-3.829787234042553,481,434
22400314,2,207,-4.0,-1.1594202898550725,414,207
22400314,2,44,-1.0,-1.3636363636363638,207,163
22400314,3,353,-1.0,-0.16997167138810199,720,367
22400314,3,137,-1.0,-0.437956204379562,353,216
22400314,3,55,1.0,1.0909090909090908,203,148
22400314,3,75,2.0,1.6,134,59
22400314,3,43,3.0,4.186046511627907,47,4
22400314,4,168,5.0,1.7857142857142856,720,552
22400314,4,69,1.0,0.8695652173913043,539,470
22400314,4,55,1.0,1.0909090909090908,470,415
22400314,4,67,-3.0,-2.6865671641791042,403,336
22400314,4,122,0.0,0.0,319,197
22400314,4,61,2.0,1.9672131147540985,197,136
22400314,4,69,3.0,2.608695652173913,136,67
22400314,4,27,-1.0,-2.2222222222222223,39,12
22400314,4,1,1.0,60.0,9,8
22400314,4,8,0.0,0.0,8,0
22400315,1,347,5.0,0.8645533141210374,720,373
22400315,1,65,2.0,1.8461538461538463,362,297
22400315,1,54,3.0,3.333333333333333,278,224
22400315,1,93,-5.0,-3.2258064516129035,218,125
22400315,1,107,1.0,0.5607476635514018,115,8
22400315,2,56,-3.0,-3.214285714285714,720,664
22400315,2,100,3.0,1.7999999999999998,644,544
22400315,2,126,-4.0,-1.9047619047619047,539,413
22400315,2,57,0.0,0.0,413,356
22400315,2,95,-2.0,-1.263157894736842,350,255
22400315,2,18,0.0,0.0,249,231
22400315,2,225,5.0,1.3333333333333335,225,0
22400315,3,267,-1.0,-0.2247191011235955,720,453
22400315,3,47,0.0,0.0,449,402
22400315,3,20,0.0,0.0,399,379
22400315,3,62,1.0,0.967741935483871,372,310
22400315,3,132,8.0,3.6363636363636367,298,166
22400315,3,124,2.0,0.967741935483871,154,30
22400315,4,91,-3.0,-1.978021978021978,720,629
22400315,4,57,0.0,0.0,613,556
22400315,4,64,3.0,2.8125,550,486
22400315,4,117,4.0,2.0512820512820515,486,369
22400315,4,45,-2.0,-2.666666666666667,362,317
22400315,4,72,3.0,2.5,304,232
22400315,4,220,0.0,0.0,220,0
22400316,1,351,7.0,1.1965811965811965,720,369
22400316,1,24,3.0,7.5,356,332
22400316,1,110,-5.0,-2.7272727272727275,319,209
22400316,1,105,1.0,0.5714285714285715,184,79
22400316,1,5,0.0,0.0,69,64
22400316,1,64,-2.0,-1.875,64,0
22400316,2,103,5.0,2.912621359223301,720,617
22400316,2,159,1.0,0.37735849056603776,617,458
22400316,2,19,3.0,9.473684210526315,458,439
22400316,2,31,0.0,0.0,431,400
22400316,2,15,0.0,0.0,400,385
22400316,2,179,3.0,1.005586592178771,383,204
22400316,2,31,-1.0,-1.935483870967742,185,154
22400316,2,127,2.0,0.9448818897637795,154,27
22400316,2,26,0.0,0.0,27,1
22400316,3,399,3.0,0.45112781954887216,720,321
22400316,3,45,0.0,0.0,304,259
22400316,3,4,0.0,0.0,243,239
22400316,3,206,4.0,1.1650485436893203,232,26
22400316,3,23,2.0,5.217391304347826,23,0
22400316,4,220,4.0,1.0909090909090908,720,500
22400316,4,177,-5.0,-1.694915254237288,500,323
22400316,4,168,3.0,1.0714285714285714,323,155
22400316,4,20,0.0,0.0,155,135
22400316,4,125,-5.0,-2.4,125,0
22400317,1,266,0.0,0.0,720,454
22400317,1,52,0.0,0.0,447,395
22400317,1,47,-1.0,-1.2765957446808511,391,344
22400317,1,48,4.0,5.0,336,288
22400317,1,64,2.0,1.875,288,224
22400317,1,41,-2.0,-2.926829268292683,220,179
22400317,1,163,-1.0,-0.36809815950920244,163,0
22400317,2,64,0.0,0.0,720,656
22400317,2,58,0.0,0.0,652,594
22400317,2,45,-4.0,-5.333333333333334,584,539
22400317,2,1,0.0,0.0,528,527
22400317,2,77,0.0,0.0,506,429
22400317,2,21,0.0,0.0,418,397
22400317,2,100,7.0,4.2,384,284
22400317,2,33,1.0,1.8181818181818183,276,243
22400317,2,79,3.0,2.278481012658228,215,136
22400317,2,74,1.0,0.8108108108108109,119,45
22400317,3,241,8.0,1.991701244813278,720,479
22400317,3,109,-2.0,-1.1009174311926606,479,370
22400317,3,24,2.0,5.0,364,340
22400317,3,42,0.0,0.0,329,287
22400317,3,77,3.0,2.3376623376623376,273,196
22400317,3,146,2.0,0.821917808219178,181,35
22400317,4,78,-3.0,-2.307692307692308,720,642
22400317,4,62,5.0,4.838709677419355,635,573
22400317,4,67,-1.0,-0.8955223880597015,573,506
22400317,4,128,4.0,1.875,489,361
22400317,4,22,2.0,5.454545454545455,361,339
22400317,4,54,-5.0,-5.555555555555555,320,266
22400317,4,24,-2.0,-5.0,255,231
22400317,4,55,-3.0,-3.2727272727272725,231,176
22400317,4,63,1.0,0.9523809523809523,162,99
22400317,4,99,-1.0,-0.6060606060606061,99,0
22400318,1,366,1.0,0.16393442622950818,720,354
22400318,1,90,-2.0,-1.3333333333333335,346,256
22400318,1,63,2.0,1.9047619047619047,236,173
22400318,1,42,-1.0,-1.4285714285714284,166,124
22400318,1,16,0.0,0.0,124,108
22400318,1,95,3.0,1.8947368421052633,95,0
22400318,2,209,6.0,1.722488038277512,720,511
22400318,2,72,0.0,0.0,482,410
22400318,2,8,0.0,0.0,404,396
22400318,2,32,3.0,5.625,380,348
22400318,2,60,1.0,1.0,348,288
22400318,2,96,2.0,1.25,285,189
22400318,2,106,3.0,1.6981132075471699,173,67
22400318,2,57,-3.0,-3.1578947368421053,59,2
22400318,3,320,2.0,0.375,720,400
22400318,3,129,-1.0,-0.46511627906976744,392,263
22400318,3,44,0.0,0.0,243,199
22400318,3,53,3.0,3.3962264150943398,178,125
22400318,3,101,1.0,0.594059405940594,101,0
22400318,4,95,3.0,1.8947368421052633,720,625
22400318,4,21,2.0,5.7142857142857135,616,595
22400318,4,111,5.0,2.7027027027027026,572,461
22400318,4,76,0.0,0.0,446,370
22400318,4,24,0.0,0.0,358,334
22400318,4,48,-2.0,-2.5,320,272
22400318,4,252,6.0,1.4285714285714284,252,0
22400319,1,294,12.0,2.4489795918367343,720,426
22400319,1,10,2.0,12.0,409,399
22400319,1,116,-2.0,-1.0344827586206897,399,283
22400319,1,33,0.0,0.0,264,231
22400319,1,143,-3.0,-1.2587412587412588,224,81
22400319,1,66,4.0,3.6363636363636367,66,0
22400319,2,141,0.0,0.0,720,579
22400319,2,58,2.0,2.0689655172413794,573,515
22400319,2,37,-5.0,-8.108108108108109,506,469
22400319,2,16,-1.0,-3.75,454,438
22400319,2,49,0.0,0.0,438,389
22400319,2,83,2.0,1.4457831325301205,371,288
22400319,2,104,0.0,0.0,288,184
22400319,2,140,4.0,1.7142857142857142,171,31
22400319,2,16,-1.0,-3.75,31,15
22400319,2,15,0.0,0.0,15,0
22400319,3,381,-3.0,-0.47244094488188976,720,339
22400319,3,69,-1.0,-0.8695652173913043,331,262
22400319,3,29,0.0,0.0,262,233
22400319,3,115,0.0,0.0,226,111
22400319,3,97,-1.0,-0.6185567010309279,101,4
22400319,4,113,5.0,2.6548672566371683,720,607
22400319,4,123,-7.0,-3.4146341463414633,605,482
22400319,4,55,-3.0,-3.2727272727272725,482,427
22400319,4,63,1.0,0.9523809523809523,424,361
22400319,4,42,2.0,2.8571428571428568,361,319
22400319,4,42,2.0,2.8571428571428568,305,263
22400319,4,106,-1.0,-0.5660377358490566,250,144
22400319,4,69,-2.0,-1.7391304347826086,144,75
22400319,4,25,4.0,9.6,59,34
22400319,4,34,0.0,0.0,34,0
22400320,1,314,-1.0,-0.1910828025477707,720,406
22400320,1,236,5.0,1.271186440677966,406,170
22400320,1,156,4.0,1.5384615384615383,156,0
22400320,2,107,6.0,3.364485981308411,720,613
22400320,2,53,2.0,2.2641509433962264,592,539
22400320,2,14,0.0,0.0,539,525
22400320,2,149,4.0,1.610738255033557,515,366
22400320,2,114,-6.0,-3.1578947368421053,351,237
22400320,2,66,0.0,0.0,237,171
22400320,2,47,1.0,1.2765957446808511,171,124
22400320,2,124,-1.0,-0.4838709677419355,124,0
22400320,3,273,-1.0,-0.21978021978021978,720,447
22400320,3,30,-1.0,-2.0,430,400
22400320,3,101,-1.0,-0.594059405940594,387,286
22400320,3,32,-3.0,-5.625,271,239
22400320,3,74,4.0,3.2432432432432434,225,151
22400320,3,137,-8.0,-3.503649635036496,138,1
22400320,3,1,0.0,0.0,1,0
22400320,4,234,-4.0,-1.0256410256410258,720,486
22400320,4,51,2.0,2.3529411764705883,486,435
22400320,4,64,3.0,2.8125,435,371
22400320,4,24,2.0,5.0,371,347
22400320,4,98,4.0,2.4489795918367343,333,235
22400320,4,20,0.0,0.0,222,202
22400320,4,32,2.0,3.75,200,168
22400320,4,143,-2.0,-0.8391608391608392,168,25
22400320,4,1,0.0,0.0,1,0
22400321,1,399,15.0,2.2556390977443606,720,321
22400321,1,33,0.0,0.0,321,288
22400321,1,57,-2.0,-2.1052631578947367,276,219
22400321,1,69,-3.0,-2.608695652173913,209,140
22400321,2,137,4.0,1.751824817518248,720,583
22400321,2,139,0.0,0.0,583,444
22400321,2,25,0.0,0.0,444,419
22400321,2,29,2.0,4.137931034482759,410,381
22400321,2,27,-2.0,-4.444444444444445,375,348
22400321,2,171,5.0,1.7543859649122806,326,155
22400321,2,46,3.0,3.9130434782608696,147,101
22400321,2,42,-4.0,-5.7142857142857135,44,2
22400321,2,1,0.0,0.0,1,0
22400321,3,170,4.0,1.4117647058823528,720,550
22400321,3,219,10.0,2.73972602739726,535,316
22400321,3,62,-1.0,-0.967741935483871,301,239
22400321,3,179,6.0,2.011173184357542,239,60
22400321,3,43,3.0,4.186046511627907,43,0
22400321,4,196,0.0,0.0,720,524
22400321,4,168,2.0,0.7142857142857142,501,333
22400321,4,73,6.0,4.931506849315069,333,260
22400322,1,288,0.0,0.0,720,432
22400322,1,61,1.0,0.9836065573770493,417,356
22400322,1,89,-3.0,-2.0224719101123596,356,267
22400322,1,97,-5.0,-3.092783505154639,263,166
22400322,1,134,-6.0,-2.6865671641791042,166,32
22400322,1,24,-2.0,-5.0,27,3
22400322,1,1,0.0,0.0,1,0
22400322,2,231,3.0,0.7792207792207793,720,489
22400322,2,27,0.0,0.0,470,443
22400322,2,56,2.0,2.142857142857143,435,379
22400322,2,97,-5.0,-3.092783505154639,346,249
22400322,2,162,1.0,0.37037037037037035,241,79
22400322,2,79,2.0,1.5189873417721518,79,0
22400322,3,360,-3.0,-0.5,720,360
22400322,3,147,-2.0,-0.8163265306122449,349,202
22400322,3,89,-2.0,-1.348314606741573,189,100
22400322,3,43,-2.0,-2.7906976744186047,86,43
22400322,3,31,0.0,0.0,31,0
22400322,4,82,-4.0,-2.926829268292683,720,638
22400322,4,65,-4.0,-3.6923076923076925,627,562
22400322,4,193,0.0,0.0,549,356
22400322,4,128,1.0,0.46875,342,214
22400322,4,133,3.0,1.3533834586466165,214,81
22400322,4,73,0.0,0.0,81,8
22400322,4,2,-2.0,-60.0,5,3
22400322,4,2,-1.0,-30.0,2,0
22400323,1,356,7.0,1.1797752808988764,720,364
22400323,1,38,0.0,0.0,364,326
22400323,1,60,-2.0,-2.0,326,266
22400323,1,56,-5.0,-5.357142857142858,257,201
22400323,1,114,0.0,0.0,201,87
22400323,1,84,-5.0,-3.571428571428571,84,0
22400323,2,166,-1.0,-0.3614457831325301,720,554
22400323,2,62,-3.0,-2.903225806451613,541,479
22400323,2,71,0.0,0.0,472,401
22400323,2,117,-4.0,-2.0512820512820515,396,279
22400323,2,18,-1.0,-3.333333333333333,279,261
22400323,2,256,3.0,0.703125,261,5
22400323,2,5,0.0,0.0,5,0
22400323,3,108,-5.0,-2.7777777777777777,720,612
22400323,3,42,-1.0,-1.4285714285714284,602,560
22400323,3,140,5.0,2.142857142857143,560,420
22400323,3,129,-4.0,-1.8604651162790697,406,277
22400323,3,62,6.0,5.806451612903226,274,212
22400323,3,132,-5.0,-2.272727272727273,200,68
22400323,3,63,1.0,0.9523809523809523,63,0
22400323,4,138,3.0,1.3043478260869565,720,582
22400323,4,24,1.0,2.5,582,558
22400323,4,21,0.0,0.0,555,534
22400323,4,72,-1.0,-0.8333333333333333,521,449
22400323,4,95,-2.0,-1.263157894736842,446,351
22400323,4,29,0.0,0.0,347,318
22400323,4,145,-1.0,-0.41379310344827586,309,164
22400323,4,61,-3.0,-2.9508196721311473,164,103
22400323,4,4,0.0,0.0,103,99
22400323,4,59,-1.0,-1.0169491525423728,99,40
22400323,4,40,0.0,0.0,40,0
22400324,1,397,-4.0,-0.6045340050377833,720,323
22400324,1,103,-2.0,-1.1650485436893203,307,204
22400324,1,114,-2.0,-1.0526315789473684,185,71
22400324,1,63,-6.0,-5.7142857142857135,63,0
22400324,2,27,-1.0,-2.2222222222222223,720,693
22400324,2,71,-3.0,-2.535211267605634,693,622
22400324,2,86,0.0,0.0,611,525
22400324,2,37,-1.0,-1.6216216216216217,516,479
22400324,2,55,-2.0,-2.1818181818181817,479,424
22400324,2,51,2.0,2.3529411764705883,412,361
22400324,2,142,-1.0,-0.4225352112676056,348,206
22400324,2,15,0.0,0.0,186,171
22400324,2,116,-3.0,-1.5517241379310345,161,45
22400324,3,323,-12.0,-2.2291021671826625,720,397
22400324,3,26,-3.0,-6.923076923076923,379,353
22400324,3,20,0.0,0.0,343,323
22400324,3,88,-2.0,-1.3636363636363638,309,221
22400324,3,74,0.0,0.0,215,141
22400324,3,127,3.0,1.4173228346456692,127,0
22400324,4,158,5.0,1.89873417721519,720,562
22400324,4,91,3.0,1.978021978021978,560,469
22400324,4,72,4.0,3.333333333333333,462,390
22400324,4,390,-5.0,-0.7692307692307692,390,0
22400325,1,325,7.0,1.2923076923076922,720,395
22400325,1,126,4.0,1.9047619047619047,385,259
22400325,1,5,0.0,0.0,212,207
22400325,1,50,-4.0,-4.8,194,144
22400325,1,117,2.0,1.0256410256410258,117,0
22400325,2,275,1.0,0.21818181818181817,720,445
22400325,2,121,-6.0,-2.975206611570248,439,318
22400325,2,145,0.0,0.0,318,173
22400325,3,287,3.0,0.6271777003484321,720,433
22400325,3,16,2.0,7.5,411,395
22400325,3,106,0.0,0.0,380,274
22400325,3,67,-1.0,-0.8955223880597015,267,200
22400325,3,19,1.0,3.1578947368421053,200,181
22400325,3,64,5.0,4.6875,181,117
22400325,3,105,-1.0,-0.5714285714285715,105,0
22400325,4,285,3.0,0.631578947368421,720,435
22400325,4,33,-2.0,-3.6363636363636367,414,381
22400325,4,66,-2.0,-1.8181818181818183,372,306
22400325,4,288,-2.0,-0.41666666666666663,288,0
22400326,1,314,-7.0,-1.3375796178343948,720,406
22400326,1,177,0.0,0.0,389,212
22400326,1,30,5.0,10.0,196,166
22400326,1,154,-4.0,-1.5584415584415585,154,0
22400326,2,260,-7.0,-1.6153846153846154,720,460
22400326,2,11,-1.0,-5.454545454545455,449,438
22400326,2,46,-3.0,-3.9130434782608696,438,392
22400326,2,18,0.0,0.0,392,374
22400326,2,72,5.0,4.166666666666667,363,291
22400326,2,12,1.0,5.0,285,273
22400326,2,96,1.0,0.625,273,177
22400326,2,150,-4.0,-1.6,177,27
22400326,2,27,0.0,0.0,27,0
22400326,3,349,-1.0,-0.17191977077363896,720,371
22400326,3,128,2.0,0.9375,371,243
22400326,3,105,-6.0,-3.4285714285714284,243,138
22400326,3,125,2.0,0.96,132,7
22400326,4,92,-7.0,-4.565217391304348,720,628
22400326,4,113,-3.0,-1.592920353982301,619,506
22400326,4,14,-2.0,-8.571428571428571,488,474
22400326,4,142,-5.0,-2.1126760563380285,462,320
22400327,1,134,-6.0,-2.6865671641791042,720,586
22400327,1,198,-9.0,-2.7272727272727275,573,375
22400327,1,52,3.0,3.4615384615384617,375,323
22400327,1,188,-4.0,-1.2765957446808511,309,121
22400327,1,111,8.0,4.324324324324325,111,0
22400327,2,143,-5.0,-2.097902097902098,720,577
22400327,2,98,0.0,0.0,566,468
22400327,2,130,4.0,1.8461538461538463,467,337
22400327,2,111,4.0,2.1621621621621623,328,217
22400327,2,59,-3.0,-3.050847457627119,206,147
22400327,2,144,4.0,1.6666666666666665,147,3
22400327,2,3,0.0,0.0,3,0
22400327,3,294,10.0,2.0408163265306123,720,426
22400327,3,83,3.0,2.1686746987951806,426,343
22400327,3,20,2.0,6.0,343,323
22400327,3,98,1.0,0.6122448979591836,323,225
22400327,3,59,-1.0,-1.0169491525423728,218,159
22400327,3,81,2.0,1.4814814814814814,138,57
22400327,3,57,0.0,0.0,57,0
22400327,4,180,3.0,1.0,720,540
22400327,4,151,-3.0,-1.1920529801324504,540,389
22400327,4,286,1.0,0.2097902097902098,376,90
22400327,4,2,1.0,30.0,90,88
22400327,4,73,0.0,0.0,73,0
22400328,1,360,-11.0,-1.8333333333333333,720,360
22400328,1,43,-2.0,-2.7906976744186047,360,317
22400328,1,52,-1.0,-1.153846153846154,317,265
22400328,1,55,-3.0,-3.2727272727272725,256,201
22400328,1,193,-5.0,-1.5544041450777202,193,0
22400328,2,45,-2.0,-2.666666666666667,720,675
22400328,2,87,-3.0,-2.0689655172413794,675,588
22400328,2,118,-3.0,-1.5254237288135595,576,458
22400328,2,103,3.0,1.7475728155339807,441,338
22400328,2,22,1.0,2.7272727272727275,329,307
22400328,2,74,2.0,1.6216216216216217,307,233
22400328,2,20,0.0,0.0,217,197
22400328,2,93,0.0,0.0,187,94
22400328,2,84,-2.0,-1.4285714285714284,84,0
22400328,3,207,-1.0,-0.2898550724637681,720,513
22400328,3,166,-3.0,-1.0843373493975903,510,344
22400328,3,47,-3.0,-3.829787234042553,329,282
22400328,3,23,2.0,5.217391304347826,267,244
22400328,3,77,0.0,0.0,244,167
22400328,3,163,-6.0,-2.208588957055215,163,0
22400328,4,265,10.0,2.2641509433962264,720,455
22400328,4,66,0.0,0.0,443,377
22400328,4,21,1.0,2.8571428571428568,368,347
22400328,4,175,-8.0,-2.742857142857143,347,172
22400329,1,308,-4.0,-0.7792207792207793,720,412
22400329,1,27,2.0,4.444444444444445,412,385
22400329,1,31,0.0,0.0,385,354
22400329,1,58,-2.0,-2.0689655172413794,339,281
22400329,1,87,0.0,0.0,259,172
22400329,1,93,3.0,1.935483870967742,165,72
22400329,1,68,2.0,1.7647058823529411,68,0
22400329,2,154,1.0,0.38961038961038963,720,566
22400329,2,34,-6.0,-10.588235294117649,558,524
22400329,2,18,0.0,0.0,524,506
22400329,2,191,-9.0,-2.8272251308900525,474,283
22400329,2,278,13.0,2.805755395683453,278,0
22400329,3,247,-6.0,-1.45748987854251,720,473
22400329,3,44,1.0,1.3636363636363638,463,419
22400329,3,51,-2.0,-2.3529411764705883,419,368
22400329,3,88,5.0,3.409090909090909,360,272
22400329,3,76,5.0,3.9473684210526314,272,196
22400329,3,27,1.0,2.2222222222222223,196,169
22400329,3,43,2.0,2.7906976744186047,169,126
22400329,3,98,-6.0,-3.673469387755102,126,28
22400329,3,19,-1.0,-3.1578947368421053,19,0
22400329,4,109,-5.0,-2.7522935779816518,720,611
22400329,4,79,2.0,1.5189873417721518,598,519
22400329,4,32,0.0,0.0,519,487
22400329,4,82,2.0,1.4634146341463414,487,405
22400329,4,14,0.0,0.0,405,391
22400329,4,185,4.0,1.2972972972972974,284,99
22400329,4,79,-1.0,-0.7594936708860759,93,14
22400329,4,6,2.0,20.0,6,0
22400330,1,323,5.0,0.9287925696594427,720,397
22400330,1,3,-2.0,-40.0,380,377
22400330,1,83,-1.0,-0.7228915662650602,377,294
22400330,1,85,-3.0,-2.1176470588235294,272,187
22400330,1,173,2.0,0.6936416184971098,173,0
22400330,2,221,-3.0,-0.8144796380090498,720,499
22400330,2,58,-6.0,-6.206896551724138,499,441
22400330,2,32,-4.0,-7.5,327,295
22400330,2,19,2.0,6.315789473684211,295,276
22400330,2,30,0.0,0.0,222,192
22400330,2,8,0.0,0.0,179,171
22400330,2,152,0.0,0.0,159,7
22400330,2,7,0.0,0.0,7,0
22400330,3,329,8.0,1.458966565349544,720,391
22400330,3,5,-1.0,-12.0,391,386
22400330,3,62,0.0,0.0,386,324
22400330,3,170,11.0,3.882352941176471,324,154
22400330,4,127,-2.0,-0.9448818897637795,720,593
22400330,4,149,3.0,1.2080536912751678,586,437
22400330,4,117,-6.0,-3.0769230769230766,430,313
22400330,4,38,3.0,4.7368421052631575,300,262
22400330,4,109,-3.0,-1.651376146788991,262,153
22400330,4,96,2.0,1.25,153,57
22400330,4,43,3.0,4.186046511627907,57,14
22400330,4,8,-3.0,-22.5,11,3
22400330,4,1,0.0,0.0,3,2
22400331,1,378,-3.0,-0.47619047619047616,720,342
22400331,1,88,-3.0,-2.0454545454545454,302,214
22400331,1,46,-3.0,-3.9130434782608696,208,162
22400331,1,28,4.0,8.571428571428571,162,134
22400331,2,79,0.0,0.0,720,641
22400331,2,24,-2.0,-5.0,641,617
22400331,2,60,-3.0,-3.0,613,553
22400331,2,91,0.0,0.0,553,462
22400331,2,18,0.0,0.0,462,444
22400331,2,20,0.0,0.0,412,392
22400331,2,48,-2.0,-2.5,381,333
22400331,2,78,-1.0,-0.7692307692307692,323,245
22400331,2,44,0.0,0.0,238,194
22400331,2,49,-1.0,-1.2244897959183672,194,145
22400331,2,145,3.0,1.2413793103448276,145,0
22400331,3,130,-2.0,-0.9230769230769231,720,590
22400331,3,67,-4.0,-3.582089552238806,572,505
22400331,3,34,2.0,3.5294117647058822,505,471
22400331,3,221,2.0,0.5429864253393666,455,234
22400331,3,110,2.0,1.0909090909090908,234,124
22400331,3,72,-2.0,-1.6666666666666665,124,52
22400331,3,33,-4.0,-7.272727272727273,35,2
22400331,4,78,2.0,1.5384615384615383,720,642
22400331,4,8,1.0,7.5,626,618
22400331,4,95,-6.0,-3.7894736842105265,618,523
22400331,4,19,-1.0,-3.1578947368421053,523,504
22400331,4,118,-2.0,-1.0169491525423728,482,364
22400331,4,47,3.0,3.829787234042553,364,317
22400331,4,108,6.0,3.333333333333333,292,184
22400331,4,20,0.0,0.0,184,164
22400331,4,195,-3.0,-0.9230769230769231,317,122
22400331,4,59,-2.0,-2.0338983050847457,118,59
22400332,1,350,4.0,0.6857142857142857,720,370
22400332,1,81,3.0,2.2222222222222223,361,280
22400332,1,56,-3.0,-3.214285714285714,280,224
22400332,1,83,-1.0,-0.7228915662650602,222,139
22400332,1,87,-4.0,-2.7586206896551726,139,52
22400332,1,34,-2.0,-3.5294117647058822,41,7
22400332,1,2,0.0,0.0,2,0
22400332,2,243,3.0,0.7407407407407407,720,477
22400332,2,52,-2.0,-2.307692307692308,477,425
22400332,2,48,-2.0,-2.5,408,360
22400332,2,151,4.0,1.5894039735099337,360,209
22400332,2,32,0.0,0.0,209,177
22400332,2,100,4.0,2.4,158,58
22400332,2,30,0.0,0.0,58,28
22400332,3,298,7.0,1.4093959731543624,720,422
22400332,3,38,-2.0,-3.1578947368421053,415,377
22400332,3,50,2.0,2.4,377,327
22400332,3,63,-5.0,-4.761904761904762,319,256
22400332,3,34,0.0,0.0,239,205
22400332,3,93,3.0,1.935483870967742,199,106
22400332,3,55,0.0,0.0,106,51
22400332,3,4,1.0,15.0,51,47
22400332,3,47,-2.0,-2.5531914893617023,47,0
22400332,4,252,-4.0,-0.9523809523809523,720,468
22400332,4,30,2.0,4.0,459,429
22400332,4,129,-3.0,-1.3953488372093024,407,278
22400332,4,64,4.0,3.75,268,204
22400332,4,120,-2.0,-1.0,204,84
22400332,4,38,0.0,0.0,84,46
22400333,1,305,-1.0,-0.19672131147540983,720,415
22400333,1,162,-2.0,-0.7407407407407407,408,246
22400333,1,63,0.0,0.0,246,183
22400333,1,22,0.0,0.0,174,152
22400333,1,27,-1.0,-2.2222222222222223,152,125
22400333,1,86,-1.0,-0.6976744186046512,111,25
22400333,1,3,0.0,0.0,3,0
22400333,2,74,3.0,2.4324324324324325,720,646
22400333,2,56,2.0,2.142857142857143,632,576
22400333,2,39,3.0,4.615384615384616,558,519
22400333,2,54,2.0,2.2222222222222223,453,399
22400333,2,16,0.0,0.0,385,369
22400333,2,37,-2.0,-3.2432432432432434,369,332
22400333,2,36,2.0,3.333333333333333,332,296
22400333,2,107,-1.0,-0.5607476635514018,296,189
22400333,2,41,0.0,0.0,189,148
22400333,2,44,1.0,1.3636363636363638,123,79
22400333,3,414,-5.0,-0.7246376811594203,720,306
22400333,3,20,0.0,0.0,306,286
22400333,3,133,3.0,1.3533834586466165,258,125
22400333,3,110,3.0,1.6363636363636362,110,0
22400333,4,220,-5.0,-1.3636363636363638,720,500
22400333,4,51,2.0,2.3529411764705883,483,432
22400333,4,21,1.0,2.8571428571428568,420,399
22400333,4,367,-9.0,-1.4713896457765667,399,32
22400333,4,5,1.0,12.0,32,27
22400333,4,24,2.0,5.0,24,0
22400334,1,300,-2.0,-0.4,720,420
22400334,1,43,-3.0,-4.186046511627907,411,368
22400334,1,9,0.0,0.0,230,221
22400334,1,49,0.0,0.0,212,163
22400334,1,11,0.0,0.0,149,138
22400334,1,120,-4.0,-2.0,122,2
22400334,1,2,0.0,0.0,2,0
22400334,2,48,4.0,5.0,720,672
22400334,2,184,5.0,1.6304347826086956,663,479
22400334,2,110,2.0,1.0909090909090908,461,351
22400334,2,60,0.0,0.0,351,291
22400334,2,33,-2.0,-3.6363636363636367,285,252
22400334,2,52,2.0,2.307692307692308,249,197
22400334,2,53,-1.0,-1.1320754716981132,197,144
22400334,2,28,-4.0,-8.571428571428571,143,115
22400334,2,115,-4.0,-2.0869565217391304,115,0
22400334,3,46,-3.0,-3.9130434782608696,720,674
22400334,3,79,-10.0,-7.59493670886076,663,584
22400334,3,241,5.0,1.2448132780082988,572,331
22400334,3,27,0.0,0.0,321,294
22400334,3,81,-3.0,-2.2222222222222223,284,203
22400334,3,57,2.0,2.1052631578947367,194,137
22400334,3,12,0.0,0.0,137,125
22400334,3,24,0.0,0.0,103,79
22400334,3,56,-1.0,-1.0714285714285714,64,8
22400334,3,8,0.0,0.0,8,0
22400334,4,195,4.0,1.2307692307692308,720,525
22400334,4,18,0.0,0.0,510,492
22400334,4,14,2.0,8.571428571428571,492,478
22400334,4,110,1.0,0.5454545454545454,464,354
22400334,4,80,-2.0,-1.5,349,269
22400334,4,1,0.0,0.0,252,251
22400334,4,223,3.0,0.8071748878923767,235,12
22400334,5,84,-1.0,-0.7142857142857142,300,216
22400334,5,34,0.0,0.0,210,176
22400334,5,136,-4.0,-1.7647058823529411,176,40
22400334,5,11,0.0,0.0,36,25
22400334,5,8,0.0,0.0,8,0
22400335,1,331,1.0,0.18126888217522658,720,389
22400335,1,35,2.0,3.4285714285714284,381,346
22400335,1,33,-3.0,-5.454545454545455,326,293
22400335,1,60,-3.0,-3.0,293,233
22400335,1,233,1.0,0.2575107296137339,233,0
22400335,2,214,-1.0,-0.2803738317757009,720,506
22400335,2,202,0.0,0.0,489,287
22400335,2,116,-5.0,-2.586206896551724,277,161
22400335,2,159,-2.0,-0.7547169811320755,161,2
22400335,2,2,0.0,0.0,2,0
22400335,3,306,2.0,0.39215686274509803,720,414
22400335,3,23,0.0,0.0,402,379
22400335,3,59,4.0,4.067796610169491,370,311
22400335,3,95,-1.0,-0.631578947368421,306,211
22400335,3,74,-3.0,-2.4324324324324325,211,137
22400335,3,137,-1.0,-0.437956204379562,137,0
22400335,4,41,3.0,4.390243902439024,720,679
22400335,4,207,-5.0,-1.4492753623188406,665,458
22400335,4,99,-1.0,-0.6060606060606061,440,341
22400335,4,64,5.0,4.6875,321,257
22400335,4,218,4.0,1.1009174311926606,243,25
22400335,4,9,1.0,6.666666666666666,23,14
22400335,4,14,2.0,8.571428571428571,14,0
22400336,1,258,0.0,0.0,720,462
22400336,1,88,3.0,2.0454545454545454,450,362
22400336,1,93,-5.0,-3.2258064516129035,357,264
22400336,1,71,1.0,0.8450704225352113,260,189
22400336,1,104,4.0,2.307692307692308,175,71
22400336,2,268,-9.0,-2.014925373134328,720,452
22400336,2,173,-5.0,-1.7341040462427746,430,257
22400336,2,21,2.0,5.7142857142857135,245,224
22400336,2,130,-5.0,-2.307692307692308,204,74
22400336,2,34,-1.0,-1.7647058823529411,51,17
22400336,3,215,2.0,0.5581395348837209,720,505
22400336,3,162,1.0,0.37037037037037035,493,331
22400336,3,18,-1.0,-3.333333333333333,322,304
22400336,3,92,3.0,1.9565217391304348,304,212
22400336,3,81,0.0,0.0,212,131
22400336,3,122,-1.0,-0.49180327868852464,122,0
22400336,4,133,4.0,1.8045112781954886,720,587
22400336,4,52,1.0,1.153846153846154,587,535
22400336,4,111,2.0,1.0810810810810811,535,424
22400336,4,38,-3.0,-4.7368421052631575,413,375
22400336,4,85,-5.0,-3.5294117647058822,364,279
22400336,4,67,0.0,0.0,272,205
22400336,4,205,2.0,0.5853658536585366,205,0
22400337,1,158,6.0,2.278481012658228,720,562
22400337,1,160,2.0,0.75,548,388
22400337,1,49,2.0,2.4489795918367343,376,327
22400337,1,142,6.0,2.535211267605634,327,185
22400337,1,62,-3.0,-2.903225806451613,185,123
22400337,1,114,-6.0,-3.1578947368421053,114,0
22400337,2,160,4.0,1.5,720,560
22400337,2,13,0.0,0.0,560,547
22400337,2,155,-10.0,-3.870967741935484,547,392
22400337,2,56,-2.0,-2.142857142857143,392,336
22400337,2,54,2.0,2.2222222222222223,324,270
22400337,2,256,-3.0,-0.703125,256,0
22400337,3,296,1.0,0.20270270270270271,720,424
22400337,3,49,0.0,0.0,412,363
22400337,3,30,-2.0,-4.0,354,324
22400337,3,41,-2.0,-2.926829268292683,310,269
22400337,3,77,-2.0,-1.5584415584415585,262,185
22400337,3,37,2.0,3.2432432432432434,185,148
22400337,3,148,1.0,0.40540540540540543,148,0
22400337,4,157,-6.0,-2.2929936305732483,720,563
22400337,4,31,2.0,3.870967741935484,563,532
22400337,4,74,5.0,4.054054054054054,513,439
22400337,4,46,-1.0,-1.3043478260869565,425,379
22400337,4,127,-5.0,-2.3622047244094486,379,252
22400337,4,41,2.0,2.926829268292683,232,191
22400337,4,38,0.0,0.0,191,153
22400337,4,144,-8.0,-3.333333333333333,144,0
22400338,1,298,1.0,0.20134228187919462,720,422
22400338,1,31,0.0,0.0,422,391
22400338,1,27,0.0,0.0,383,356
22400338,1,18,-1.0,-3.333333333333333,356,338
22400338,1,157,0.0,0.0,324,167
22400338,1,132,6.0,2.7272727272727275,150,18
22400338,1,16,0.0,0.0,18,2
22400338,2,179,-6.0,-2.011173184357542,720,541
22400338,2,41,-3.0,-4.390243902439024,539,498
22400338,2,50,0.0,0.0,498,448
22400338,2,12,-2.0,-10.0,434,422
22400338,2,29,0.0,0.0,377,348
22400338,2,56,-5.0,-5.357142857142858,338,282
22400338,2,123,-2.0,-0.9756097560975611,261,138
22400338,2,101,4.0,2.376237623762376,126,25
22400338,2,24,0.0,0.0,25,1
22400338,3,113,3.0,1.592920353982301,720,607
22400338,3,210,2.0,0.5714285714285715,601,391
22400338,3,12,0.0,0.0,374,362
22400338,3,38,-3.0,-4.7368421052631575,354,316
22400338,3,151,-1.0,-0.3973509933774834,314,163
22400338,3,54,2.0,2.2222222222222223,163,109
22400338,3,87,0.0,0.0,98,11
22400338,3,6,0.0,0.0,11,5
22400338,3,2,0.0,0.0,2,0
22400338,4,99,3.0,1.8181818181818183,720,621
22400338,4,133,-7.0,-3.1578947368421053,616,483
22400338,4,57,0.0,0.0,474,417
22400338,4,99,-5.0,-3.0303030303030303,384,285
22400338,4,417,-4.0,-0.5755395683453237,591,174
22400338,4,30,-2.0,-4.0,162,132
22400338,4,121,4.0,1.9834710743801653,121,0
22400339,1,277,-9.0,-1.9494584837545124,720,443
22400339,1,204,0.0,0.0,438,234
22400339,1,171,-5.0,-1.7543859649122806,217,46
22400339,1,37,0.0,0.0,37,0
22400339,2,85,0.0,0.0,720,635
22400339,2,95,0.0,0.0,635,540
22400339,2,50,2.0,2.4,531,481
22400339,2,24,-2.0,-5.0,465,441
22400339,2,35,0.0,0.0,429,394
22400339,2,164,-4.0,-1.4634146341463414,383,219
22400339,2,205,-8.0,-2.341463414634146,205,0
22400339,3,120,-7.0,-3.5,720,600
22400339,3,238,3.0,0.7563025210084033,600,362
22400339,3,47,1.0,1.2765957446808511,358,311
22400339,3,63,-4.0,-3.8095238095238093,311,248
22400339,3,84,2.0,1.4285714285714284,242,158
22400339,3,158,0.0,0.0,158,0
22400339,4,117,-3.0,-1.5384615384615383,720,603
22400339,4,595,-7.0,-0.7058823529411764,595,0
22400340,1,325,-5.0,-0.9230769230769231,720,395
22400340,1,70,-3.0,-2.5714285714285716,379,309
22400340,1,100,1.0,0.6,309,209
22400340,1,158,-9.0,-3.4177215189873418,209,51
22400340,1,50,-2.0,-2.4,50,0
22400340,2,165,5.0,1.8181818181818183,720,555
22400340,2,52,4.0,4.615384615384616,534,482
22400340,2,167,2.0,0.718562874251497,463,296
22400340,2,66,3.0,2.7272727272727275,329,263
22400340,2,121,3.0,1.487603305785124,251,130
22400340,2,82,0.0,0.0,120,38
22400340,2,38,-1.0,-1.5789473684210527,38,0
22400340,3,287,-3.0,-0.6271777003484321,720,433
22400340,3,83,2.0,1.4457831325301205,429,346
22400340,3,67,2.0,1.791044776119403,331,264
22400340,3,30,3.0,6.0,258,228
22400340,3,21,-2.0,-5.7142857142857135,226,205
22400340,3,205,3.0,0.8780487804878049,205,0
22400340,4,154,2.0,0.7792207792207793,720,566
22400340,4,33,-1.0,-1.8181818181818183,559,526
22400340,4,50,0.0,0.0,521,471
22400340,4,116,4.0,2.0689655172413794,464,348
22400340,4,7,0.0,0.0,333,326
22400340,4,21,2.0,5.7142857142857135,326,305
22400340,4,92,-4.0,-2.608695652173913,305,213
22400340,4,195,-6.0,-1.8461538461538463,195,0
22400341,1,376,10.0,1.5957446808510638,720,344
22400341,1,56,-4.0,-4.285714285714286,337,281
22400341,1,42,2.0,2.8571428571428568,267,225
22400341,1,199,-4.0,-1.206030150753769,206,7
22400341,1,6,0.0,0.0,6,0
22400341,2,162,-2.0,-0.7407407407407407,720,558
22400341,2,86,-3.0,-2.0930232558139537,558,472
22400341,2,32,1.0,1.875,459,427
22400341,2,64,0.0,0.0,427,363
22400341,2,31,-2.0,-3.870967741935484,353,322
22400341,2,42,4.0,5.7142857142857135,322,280
22400341,2,86,1.0,0.6976744186046512,280,194
22400341,2,182,2.0,0.6593406593406594,182,0
22400341,3,241,1.0,0.24896265560165975,720,479
22400341,3,157,-9.0,-3.4394904458598727,479,322
22400341,3,41,2.0,2.926829268292683,322,281
22400341,3,89,4.0,2.696629213483146,274,185
22400341,3,153,0.0,0.0,168,15
22400341,3,15,2.0,8.0,15,0
22400341,4,212,5.0,1.4150943396226416,720,508
22400341,4,41,2.0,2.926829268292683,496,455
22400341,4,109,-2.0,-1.1009174311926606,450,341
22400341,4,146,-2.0,-0.821917808219178,341,195
22400341,4,164,-1.0,-0.36585365853658536,187,23
22400341,4,17,2.0,7.0588235294117645,17,0
22400342,1,398,-8.0,-1.206030150753769,720,322
22400342,1,65,-3.0,-2.769230769230769,303,238
22400342,1,51,-1.0,-1.1764705882352942,227,176
22400342,1,15,2.0,8.0,176,161
22400342,1,155,0.0,0.0,161,6
22400342,1,2,0.0,0.0,2,0
22400342,2,217,-4.0,-1.1059907834101383,720,503
22400342,2,67,-1.0,-0.8955223880597015,499,432
22400342,2,71,-3.0,-2.535211267605634,432,361
22400342,2,86,-1.0,-0.6976744186046512,371,285
22400342,2,17,-1.0,-3.5294117647058822,285,268
22400342,2,71,-1.0,-0.8450704225352113,268,197
22400342,2,166,4.0,1.4457831325301205,197,31
22400342,2,18,0.0,0.0,31,13
22400342,2,13,0.0,0.0,13,0
22400342,3,17,0.0,0.0,720,703
22400342,3,224,7.0,1.875,689,465
22400342,3,91,1.0,0.6593406593406594,465,374
22400342,3,86,-4.0,-2.7906976744186047,374,288
22400342,3,22,1.0,2.7272727272727275,288,266
22400342,3,62,-2.0,-1.935483870967742,266,204
22400342,3,54,3.0,3.333333333333333,195,141
22400342,3,49,3.0,3.673469387755102,135,86
22400342,3,85,-2.0,-1.4117647058823528,86,1
22400342,4,199,1.0,0.30150753768844224,720,521
22400342,4,145,5.0,2.0689655172413794,505,360
22400342,4,54,4.0,4.444444444444445,339,285
22400342,4,285,3.0,0.631578947368421,285,0
22400343,1,373,-7.0,-1.1260053619302948,720,347
22400343,1,82,4.0,2.926829268292683,347,265
22400343,1,25,0.0,0.0,251,226
22400343,1,36,-2.0,-3.333333333333333,220,184
22400343,1,47,-4.0,-5.1063829787234045,184,137
22400343,1,71,-2.0,-1.6901408450704225,123,52
22400343,1,28,3.0,6.428571428571428,33,5
22400343,1,4,0.0,0.0,4,0
22400343,2,178,7.0,2.359550561797753,720,542
22400343,2,46,0.0,0.0,520,474
22400343,2,232,1.0,0.25862068965517243,461,229
22400343,2,147,-4.0,-1.6326530612244898,215,68
22400343,2,67,2.0,1.791044776119403,68,1
22400343,2,1,0.0,0.0,1,0
22400343,3,285,2.0,0.4210526315789474,720,435
22400343,3,12,0.0,0.0,391,379
22400343,3,151,-1.0,-0.3973509933774834,379,228
22400343,3,65,0.0,0.0,228,163
22400343,3,50,2.0,2.4,153,103
22400343,3,93,4.0,2.580645161290323,93,0
22400343,4,96,-2.0,-1.25,720,624
22400343,4,194,-8.0,-2.4742268041237114,613,419
22400343,4,56,2.0,2.142857142857143,398,342
22400343,4,88,-3.0,-2.0454545454545454,342,254
22400343,4,100,6.0,3.5999999999999996,239,139
22400343,4,54,4.0,4.444444444444445,124,70
22400343,4,48,-1.0,-1.25,48,0
22400344,1,342,1.0,0.17543859649122806,720,378
22400344,1,147,0.0,0.0,377,230
22400344,1,22,0.0,0.0,230,208
22400344,1,119,-4.0,-2.0168067226890756,195,76
22400344,1,59,-3.0,-3.050847457627119,67,8
22400344,1,8,2.0,15.0,8,0
22400344,2,215,-2.0,-0.5581395348837209,720,505
22400344,2,19,-1.0,-3.1578947368421053,492,473
22400344,2,25,-1.0,-2.4,473,448
22400344,2,24,-3.0,-7.5,448,424
22400344,2,42,4.0,5.7142857142857135,408,366
22400344,2,40,0.0,0.0,366,326
22400344,2,61,-4.0,-3.934426229508197,323,262
22400344,2,96,3.0,1.875,262,166
22400344,2,27,2.0,4.444444444444445,166,139
22400344,2,137,-2.0,-0.875912408759124,139,2
22400344,2,2,-3.0,-90.0,2,0
22400344,3,144,-5.0,-2.0833333333333335,720,576
22400344,3,211,4.0,1.137440758293839,569,358
22400344,3,91,-9.0,-5.934065934065933,351,260
22400344,3,45,0.0,0.0,242,197
22400344,4,135,1.0,0.4444444444444445,720,585
22400344,4,48,2.0,2.5,585,537
22400344,4,36,-2.0,-3.333333333333333,537,501
22400344,4,49,0.0,0.0,501,452
22400344,4,19,-1.0,-3.1578947368421053,441,422
22400344,4,108,-1.0,-0.5555555555555556,512,404
22400344,4,127,5.0,2.3622047244094486,404,277
22400344,4,213,3.0,0.8450704225352113,261,48
22400344,4,48,-1.0,-1.25,48,0
22400345,1,190,-2.0,-0.631578947368421,720,530
22400345,1,153,-7.0,-2.7450980392156863,518,365
22400345,1,12,0.0,0.0,365,353
22400345,1,87,0.0,0.0,343,256
22400345,1,13,-1.0,-4.615384615384616,253,240
22400345,1,108,3.0,1.6666666666666665,240,132
22400345,1,110,0.0,0.0,116,6
22400345,2,181,-1.0,-0.3314917127071823,720,539
22400345,2,44,-1.0,-1.3636363636363638,529,485
22400345,2,78,-2.0,-1.5384615384615383,483,405
22400345,2,92,-3.0,-1.9565217391304348,405,313
22400345,2,210,2.0,0.5714285714285715,305,95
22400345,2,95,-4.0,-2.526315789473684,95,0
22400345,3,321,0.0,0.0,720,399
22400345,3,42,0.0,0.0,388,346
22400345,3,103,2.0,1.1650485436893203,332,229
22400345,3,65,-2.0,-1.8461538461538463,229,164
22400345,3,68,6.0,5.294117647058824,164,96
22400345,3,61,0.0,0.0,90,29
22400345,4,89,8.0,5.393258426966292,720,631
22400345,4,59,2.0,2.0338983050847457,619,560
22400345,4,141,-10.0,-4.25531914893617,560,419
22400345,4,15,2.0,8.0,417,402
22400345,4,28,-2.0,-4.285714285714286,402,374
22400345,4,31,0.0,0.0,362,331
22400345,4,13,3.0,13.846153846153847,328,315
22400345,4,209,-1.0,-0.28708133971291866,230,21
22400345,4,2,0.0,0.0,19,17
22400345,4,14,-2.0,-8.571428571428571,14,0
22400346,1,358,1.0,0.1675977653631285,720,362
22400346,1,99,0.0,0.0,348,249
22400346,1,14,-1.0,-4.285714285714286,226,212
22400346,1,142,-5.0,-2.1126760563380285,212,70
22400346,1,54,-5.0,-5.555555555555555,54,0
22400346,2,156,0.0,0.0,720,564
22400346,2,103,1.0,0.5825242718446602,557,454
22400346,2,38,-2.0,-3.1578947368421053,440,402
22400346,2,213,2.0,0.5633802816901409,454,241
22400346,2,106,-2.0,-1.1320754716981132,222,116
22400346,2,97,-4.0,-2.4742268041237114,97,0
22400346,3,155,7.0,2.7096774193548385,720,565
22400346,3,105,4.0,2.285714285714286,547,442
22400346,3,98,3.0,1.836734693877551,442,344
22400346,3,82,2.0,1.4634146341463414,331,249
22400346,3,32,0.0,0.0,223,191
22400346,3,177,-4.0,-1.3559322033898304,177,0
22400346,4,103,0.0,0.0,720,617
22400346,4,79,4.0,3.0379746835443036,609,530
22400346,4,68,3.0,2.647058823529412,530,462
22400346,4,166,-4.0,-1.4457831325301205,462,296
22400346,4,70,2.0,1.7142857142857142,291,221
22400346,4,82,5.0,3.6585365853658534,221,139
22400346,4,82,0.0,0.0,129,47
22400347,1,314,7.0,1.3375796178343948,720,406
22400347,1,101,-2.0,-1.188118811881188,375,274
22400347,1,65,-2.0,-1.8461538461538463,274,209
22400347,1,61,4.0,3.934426229508197,209,148
22400347,1,132,1.0,0.4545454545454546,132,0
22400347,2,106,0.0,0.0,720,614
22400347,2,29,0.0,0.0,592,563
22400347,2,2,-2.0,-60.0,549,547
22400347,2,21,-2.0,-5.7142857142857135,547,526
22400347,2,102,-1.0,-0.5882352941176471,515,413
22400347,2,51,-4.0,-4.705882352941177,400,349
22400347,2,63,-6.0,-5.7142857142857135,339,276
22400347,2,32,-2.0,-3.75,259,227
22400347,2,47,-1.0,-1.2765957446808511,212,165
22400347,2,159,-4.0,-1.509433962264151,165,6
22400347,2,1,-1.0,-60.0,2,1
22400347,2,1,0.0,0.0,1,0
22400347,3,224,-5.0,-1.3392857142857144,720,496
22400347,3,175,2.0,0.6857142857142857,484,309
22400347,3,100,-3.0,-1.7999999999999998,292,192
22400347,3,45,-2.0,-2.666666666666667,170,125
22400347,3,62,5.0,4.838709677419355,62,0
22400347,4,102,4.0,2.3529411764705883,720,618
22400347,4,146,-2.0,-0.821917808219178,606,460
22400347,4,70,-2.0,-1.7142857142857142,448,378
22400347,4,119,2.0,1.0084033613445378,365,246
22400347,4,105,-2.0,-1.142857142857143,235,130
22400347,4,92,-1.0,-0.6521739130434783,124,32
22400347,4,12,2.0,10.0,32,20
22400347,4,16,0.0,0.0,16,0
22400348,1,257,0.0,0.0,720,463
22400348,1,86,-3.0,-2.0930232558139537,453,367
22400348,1,67,3.0,2.6865671641791042,367,300
22400348,1,36,3.0,5.0,284,248
22400348,1,118,-6.0,-3.050847457627119,227,109
22400348,1,100,0.0,0.0,100,0
22400348,2,197,-2.0,-0.6091370558375634,720,523
22400348,2,73,2.0,1.643835616438356,508,435
22400348,2,58,0.0,0.0,421,363
22400348,2,31,-1.0,-1.935483870967742,347,316
22400348,2,42,0.0,0.0,282,240
22400348,2,35,0.0,0.0,229,194
22400348,2,49,-1.0,-1.2244897959183672,153,104
22400348,2,95,5.0,3.1578947368421053,95,0
22400348,3,381,6.0,0.9448818897637795,720,339
22400348,3,22,2.0,5.454545454545455,325,303
22400348,3,68,5.0,4.411764705882353,292,224
22400348,3,212,-11.0,-3.1132075471698113,216,4
22400348,3,4,0.0,0.0,4,0
22400348,4,121,0.0,0.0,720,599
22400348,4,108,1.0,0.5555555555555556,590,482
22400348,4,36,2.0,3.333333333333333,382,346
22400348,4,46,-1.0,-1.3043478260869565,349,303
22400348,4,41,0.0,0.0,303,262
22400348,4,128,-3.0,-1.40625,254,126
22400348,4,106,-5.0,-2.8301886792452833,112,6
22400348,4,3,-1.0,-20.0,3,0
22400349,1,310,-1.0,-0.1935483870967742,720,410
22400349,1,57,0.0,0.0,390,333
22400349,1,22,3.0,8.181818181818182,333,311
22400349,1,1,0.0,0.0,304,303
22400349,1,38,3.0,4.7368421052631575,289,251
22400349,1,28,-4.0,-8.571428571428571,251,223
22400349,1,30,1.0,2.0,213,183
22400349,1,61,2.0,1.9672131147540985,183,122
22400349,1,122,-2.0,-0.9836065573770493,122,0
22400349,2,74,1.0,0.8108108108108109,720,646
22400349,2,169,2.0,0.7100591715976331,646,477
22400349,2,36,2.0,3.333333333333333,448,412
22400349,2,64,-6.0,-5.625,394,330
22400349,2,147,0.0,0.0,312,165
22400349,2,14,0.0,0.0,162,148
22400349,2,100,0.0,0.0,139,39
22400349,2,39,2.0,3.0769230769230766,39,0
22400349,3,299,-1.0,-0.20066889632107024,720,421
22400349,3,31,0.0,0.0,421,390
22400349,3,131,1.0,0.4580152671755725,369,238
22400349,3,90,-5.0,-3.333333333333333,238,148
22400349,3,40,0.0,0.0,130,90
22400349,3,73,2.0,1.643835616438356,82,9
22400349,3,8,2.0,15.0,8,0
22400349,4,100,-1.0,-0.6,720,620
22400349,4,23,0.0,0.0,620,597
22400349,4,73,-2.0,-1.643835616438356,591,518
22400349,4,31,-3.0,-5.806451612903226,518,487
22400349,4,124,-2.0,-0.967741935483871,473,349
22400349,4,2,0.0,0.0,345,343
22400349,4,66,0.0,0.0,330,264
22400349,4,98,0.0,0.0,259,161
22400349,4,134,3.0,1.3432835820895521,143,9
22400349,4,1,-1.0,-60.0,8,7
22400349,4,7,0.0,0.0,7,0
22400350,1,297,-3.0,-0.6060606060606061,720,423
22400350,1,58,0.0,0.0,349,291
22400350,1,50,1.0,1.2,278,228
22400350,1,46,-2.0,-2.608695652173913,220,174
22400350,1,106,-5.0,-2.8301886792452833,174,68
22400350,1,44,-1.0,-1.3636363636363638,68,24
22400350,2,155,-5.0,-1.935483870967742,720,565
22400350,2,14,1.0,4.285714285714286,557,543
22400350,2,54,4.0,4.444444444444445,543,489
22400350,2,37,0.0,0.0,428,391
22400350,2,80,3.0,2.25,391,311
22400350,2,47,-2.0,-2.5531914893617023,306,259
22400350,2,81,5.0,3.7037037037037033,253,172
22400350,2,172,-10.0,-3.488372093023256,172,0
22400350,3,341,-5.0,-0.8797653958944283,720,379
22400350,3,31,-3.0,-5.806451612903226,379,348
22400350,3,14,0.0,0.0,346,332
22400350,3,57,5.0,5.263157894736842,322,265
22400350,3,68,3.0,2.647058823529412,253,185
22400350,3,84,0.0,0.0,183,99
22400350,3,99,-1.0,-0.6060606060606061,99,0
22400350,4,142,-3.0,-1.267605633802817,720,578
22400350,4,136,3.0,1.323529411764706,578,442
22400350,4,175,3.0,1.0285714285714287,422,247
22400350,4,66,-4.0,-3.6363636363636367,236,170
22400350,4,157,-3.0,-1.1464968152866242,157,0
22400351,1,275,3.0,0.6545454545454545,720,445
22400351,1,48,2.0,2.5,438,390
22400351,1,146,-4.0,-1.643835616438356,381,235
22400351,1,46,-2.0,-2.608695652173913,221,175
22400351,1,56,-2.0,-2.142857142857143,156,100
22400351,1,51,2.0,2.3529411764705883,100,49
22400351,1,40,-2.0,-3.0,40,0
22400351,2,256,9.0,2.109375,720,464
22400351,2,44,-1.0,-1.3636363636363638,446,402
22400351,2,109,-2.0,-1.1009174311926606,393,284
22400351,2,90,1.0,0.6666666666666667,284,194
22400351,2,20,0.0,0.0,194,174
22400351,2,36,1.0,1.6666666666666665,157,121
22400351,2,117,2.0,1.0256410256410258,121,4
22400351,2,4,0.0,0.0,4,0
22400351,3,353,2.0,0.33994334277620397,720,367
22400351,3,13,-1.0,-4.615384615384616,367,354
22400351,3,23,2.0,5.217391304347826,354,331
22400351,3,70,4.0,3.4285714285714284,331,261
22400351,3,32,0.0,0.0,249,217
22400351,3,79,-4.0,-3.0379746835443036,217,138
22400351,3,127,1.0,0.47244094488188976,127,0
22400351,4,146,1.0,0.410958904109589,720,574
22400351,4,35,-3.0,-5.142857142857143,563,528
22400351,4,48,0.0,0.0,518,470
22400351,4,107,0.0,0.0,470,363
22400351,4,155,3.0,1.1612903225806452,340,185
22400351,4,72,0.0,0.0,171,99
22400351,4,2,0.0,0.0,85,83
22400351,4,60,0.0,0.0,76,16
22400351,4,6,0.0,0.0,6,0
22400352,1,308,5.0,0.9740259740259739,720,412
22400352,1,78,-5.0,-3.846153846153846,401,323
22400352,1,29,-2.0,-4.137931034482759,309,280
22400352,1,57,-1.0,-1.0526315789473684,280,223
22400352,1,35,0.0,0.0,212,177
22400352,1,73,2.0,1.643835616438356,162,89
22400352,1,47,3.0,3.829787234042553,50,3
22400352,1,3,0.0,0.0,3,0
22400352,2,25,1.0,2.4,720,695
22400352,2,127,1.0,0.47244094488188976,695,568
22400352,2,57,0.0,0.0,568,511
22400352,2,86,0.0,0.0,491,405
22400352,2,16,0.0,0.0,400,384
22400352,2,47,1.0,1.2765957446808511,367,320
22400352,2,80,1.0,0.75,306,226
22400352,2,74,-3.0,-2.4324324324324325,226,152
22400352,2,31,-3.0,-5.806451612903226,135,104
22400352,2,91,3.0,1.978021978021978,91,0
22400352,3,321,-3.0,-0.5607476635514018,720,399
22400352,3,40,2.0,3.0,399,359
22400352,3,42,3.0,4.285714285714286,345,303
22400352,3,38,4.0,6.315789473684211,290,252
22400352,3,34,0.0,0.0,232,198
22400352,3,89,-2.0,-1.348314606741573,187,98
22400352,3,85,-2.0,-1.4117647058823528,85,0
22400352,4,158,0.0,0.0,720,562
22400352,4,24,0.0,0.0,562,538
22400352,4,2,0.0,0.0,525,523
22400352,4,62,-1.0,-0.967741935483871,513,451
22400352,4,7,1.0,8.571428571428571,442,435
22400352,4,19,0.0,0.0,435,416
22400352,4,133,4.0,1.8045112781954886,411,278
22400352,4,19,1.0,3.1578947368421053,251,232
22400352,4,167,-1.0,-0.3592814371257485,232,65
22400352,4,30,-2.0,-4.0,65,35
22400352,4,22,2.0,5.454545454545455,35,13
22400352,4,3,0.0,0.0,9,6
22400352,4,3,0.0,0.0,3,0
22400353,1,339,-5.0,-0.8849557522123894,720,381
22400353,1,150,0.0,0.0,381,231
22400353,1,11,-1.0,-5.454545454545455,229,218
22400353,1,64,1.0,0.9375,218,154
22400353,1,97,-2.0,-1.2371134020618557,132,35
22400353,1,30,4.0,8.0,30,0
22400353,2,206,-5.0,-1.4563106796116505,720,514
22400353,2,111,-3.0,-1.6216216216216217,469,358
22400353,2,192,1.0,0.3125,351,159
22400353,2,137,-2.0,-0.875912408759124,141,4
22400353,3,270,-2.0,-0.4444444444444445,720,450
22400353,3,10,-2.0,-12.0,442,432
22400353,3,60,-4.0,-4.0,432,372
22400353,3,39,-2.0,-3.0769230769230766,361,322
22400353,3,31,0.0,0.0,306,275
22400353,3,50,0.0,0.0,275,225
22400353,3,212,-1.0,-0.2830188679245283,212,0
22400353,4,138,-4.0,-1.7391304347826086,720,582
22400353,4,53,0.0,0.0,582,529
22400353,4,12,0.0,0.0,525,513
22400353,4,48,1.0,1.25,508,460
22400353,4,32,4.0,7.5,460,428
22400353,4,55,-1.0,-1.0909090909090908,413,358
22400353,4,20,-1.0,-3.0,340,320
22400353,4,320,1.0,0.1875,320,0
22400354,1,181,-1.0,-0.3314917127071823,720,539
22400354,1,104,0.0,0.0,529,425
22400354,1,69,2.0,1.7391304347826086,425,356
22400354,1,55,-7.0,-7.636363636363636,349,294
22400354,1,20,-1.0,-3.0,280,260
22400354,1,87,-3.0,-2.0689655172413794,260,173
22400354,1,31,2.0,3.870967741935484,173,142
22400354,2,75,1.0,0.8,720,645
22400354,2,62,3.0,2.903225806451613,636,574
22400354,2,123,-3.0,-1.4634146341463414,554,431
22400354,2,83,-3.0,-2.1686746987951806,426,343
22400354,2,23,2.0,5.217391304347826,325,302
22400354,2,116,12.0,6.206896551724138,287,171
22400354,2,135,1.0,0.4444444444444445,148,13
22400354,2,3,0.0,0.0,3,0
22400354,3,288,-1.0,-0.20833333333333331,720,432
22400354,3,27,2.0,4.444444444444445,415,388
22400354,3,45,1.0,1.3333333333333335,374,329
22400354,3,44,-1.0,-1.3636363636363638,314,270
22400354,3,40,-3.0,-4.5,270,230
22400354,3,23,1.0,2.608695652173913,230,207
22400354,3,24,0.0,0.0,207,183
22400354,3,162,-1.0,-0.37037037037037035,183,21
22400354,4,170,0.0,0.0,720,550
22400354,4,39,6.0,9.230769230769232,534,495
22400354,4,154,-1.0,-0.38961038961038963,478,324
22400354,4,132,-3.0,-1.3636363636363638,324,192
22400354,4,172,-3.0,-1.0465116279069768,192,20
22400354,4,5,1.0,12.0,9,4
22400355,1,284,-7.0,-1.4788732394366195,720,436
22400355,1,83,3.0,2.1686746987951806,425,342
22400355,1,111,-4.0,-2.1621621621621623,333,222
22400355,1,24,0.0,0.0,211,187
22400355,1,26,0.0,0.0,170,144
22400355,1,85,3.0,2.1176470588235294,132,47
22400355,2,203,4.0,1.1822660098522169,720,517
22400355,2,48,-3.0,-3.75,517,469
22400355,2,28,0.0,0.0,460,432
22400355,2,60,6.0,6.0,418,358
22400355,2,82,1.0,0.7317073170731707,340,258
22400355,2,13,0.0,0.0,242,229
22400355,2,21,-2.0,-5.7142857142857135,218,197
22400355,2,8,0.0,0.0,189,181
22400355,2,12,0.0,0.0,181,169
22400355,2,163,0.0,0.0,169,6
22400355,3,289,8.0,1.6608996539792389,720,431
22400355,3,57,1.0,1.0526315789473684,431,374
22400355,3,29,-2.0,-4.137931034482759,367,338
22400355,3,94,0.0,0.0,326,232
22400355,3,111,3.0,1.6216216216216217,222,111
22400355,3,74,2.0,1.6216216216216217,111,37
22400355,3,26,0.0,0.0,26,0
22400355,4,143,3.0,1.2587412587412588,720,577
22400355,4,42,1.0,1.4285714285714284,553,511
22400355,4,96,-6.0,-3.75,427,331
22400355,4,110,-3.0,-1.6363636363636362,310,200
22400355,4,200,9.0,2.6999999999999997,200,0
22400356,1,363,-5.0,-0.8264462809917356,720,357
22400356,1,34,0.0,0.0,332,298
22400356,1,150,1.0,0.4,298,148
22400356,1,137,0.0,0.0,137,0
22400356,2,123,-4.0,-1.9512195121951221,720,597
22400356,2,51,2.0,2.3529411764705883,597,546
22400356,2,101,4.0,2.376237623762376,538,437
22400356,2,76,-3.0,-2.3684210526315788,410,334
22400356,2,122,1.0,0.49180327868852464,325,203
22400356,2,153,-10.0,-3.9215686274509807,185,32
22400356,3,395,3.0,0.45569620253164556,720,325
22400356,3,86,-2.0,-1.3953488372093024,325,239
22400356,3,101,-1.0,-0.594059405940594,221,120
22400356,3,120,1.0,0.5,120,0
22400356,4,61,0.0,0.0,720,659
22400356,4,103,-1.0,-0.5825242718446602,643,540
22400356,4,62,-1.0,-0.967741935483871,530,468
22400356,4,86,1.0,0.6976744186046512,456,370
22400356,4,108,2.0,1.1111111111111112,370,262
22400356,4,15,1.0,4.0,242,227
22400356,4,227,0.0,0.0,227,0
22400357,1,366,0.0,0.0,720,354
22400357,1,23,0.0,0.0,340,317
22400357,1,8,0.0,0.0,311,303
22400357,1,107,0.0,0.0,297,190
22400357,1,60,-3.0,-3.0,180,120
22400357,1,16,-1.0,-3.75,112,96
22400357,1,96,1.0,0.625,96,0
22400357,2,110,6.0,3.2727272727272725,720,610
22400357,2,51,-1.0,-1.1764705882352942,591,540
22400357,2,71,6.0,5.070422535211268,540,469
22400357,2,62,3.0,2.903225806451613,463,401
22400357,2,23,0.0,0.0,384,361
22400357,2,64,1.0,0.9375,357,293
22400357,2,268,2.0,0.44776119402985076,293,25
22400357,2,5,0.0,0.0,5,0
22400357,3,211,5.0,1.4218009478672984,720,509
22400357,3,108,-4.0,-2.2222222222222223,499,391
22400357,3,148,1.0,0.40540540540540543,382,234
22400357,3,34,1.0,1.7647058823529411,223,189
22400357,3,78,6.0,4.615384615384616,189,111
22400357,3,9,0.0,0.0,111,102
22400357,3,86,6.0,4.186046511627907,86,0
22400357,4,218,4.0,1.1009174311926606,720,502
22400357,4,175,3.0,1.0285714285714287,489,314
22400357,4,146,1.0,0.410958904109589,294,148
22400357,4,39,2.0,3.0769230769230766,140,101
22400358,1,335,-4.0,-0.7164179104477612,720,385
22400358,1,124,-1.0,-0.4838709677419355,385,261
22400358,1,6,0.0,0.0,242,236
22400358,1,92,-2.0,-1.3043478260869565,229,137
22400358,1,112,-5.0,-2.678571428571429,126,14
22400358,1,14,2.0,8.571428571428571,14,0
22400358,2,197,-2.0,-0.6091370558375634,720,523
22400358,2,53,6.0,6.7924528301886795,523,470
22400358,2,89,8.0,5.393258426966292,453,364
22400358,2,64,-2.0,-1.875,359,295
22400358,2,78,0.0,0.0,295,217
22400358,2,207,9.0,2.608695652173913,213,6
22400358,3,159,-9.0,-3.3962264150943398,720,561
22400358,3,142,2.0,0.8450704225352113,555,413
22400358,3,123,5.0,2.4390243902439024,413,290
22400358,3,38,-1.0,-1.5789473684210527,273,235
22400358,3,110,4.0,2.1818181818181817,235,125
22400358,3,125,-9.0,-4.319999999999999,125,0
22400358,4,147,7.0,2.8571428571428568,720,573
22400358,4,58,3.0,3.103448275862069,563,505
22400358,4,97,5.0,3.092783505154639,505,408
22400358,4,32,3.0,5.625,408,376
22400358,4,97,3.0,1.8556701030927836,357,260
22400358,4,89,-1.0,-0.6741573033707865,247,158
22400358,4,37,-2.0,-3.2432432432432434,158,121
22400358,4,99,-4.0,-2.4242424242424243,99,0
22400359,1,441,4.0,0.54421768707483,720,279
22400359,1,65,-1.0,-0.9230769230769231,206,141
22400359,1,58,-3.0,-3.103448275862069,141,83
22400359,1,23,-1.0,-2.608695652173913,83,60
22400359,1,60,-2.0,-2.0,60,0
22400359,2,40,-3.0,-4.5,720,680
22400359,2,146,4.0,1.643835616438356,666,520
22400359,2,47,-5.0,-6.382978723404255,512,465
22400359,2,60,0.0,0.0,451,391
22400359,2,116,2.0,1.0344827586206897,391,275
22400359,2,114,8.0,4.2105263157894735,262,148
22400359,2,85,0.0,0.0,140,55
22400359,2,36,-3.0,-5.0,46,10
22400359,2,4,0.0,0.0,10,6
22400359,2,6,0.0,0.0,6,0
22400359,3,313,4.0,0.7667731629392971,720,407
22400359,3,97,-1.0,-0.6185567010309279,407,310
22400359,3,27,-1.0,-2.2222222222222223,286,259
22400359,3,8,0.0,0.0,250,242
22400359,3,44,3.0,4.090909090909091,242,198
22400359,3,135,-1.0,-0.4444444444444445,198,63
22400359,4,119,0.0,0.0,720,601
22400359,4,18,0.0,0.0,592,574
22400359,4,99,-5.0,-3.0303030303030303,574,475
22400359,4,1,0.0,0.0,396,395
22400359,4,113,-4.0,-2.1238938053097343,373,260
22400359,4,29,0.0,0.0,251,222
22400359,4,182,0.0,0.0,218,36
22400359,4,22,-3.0,-8.181818181818182,28,6
22400360,1,291,-12.0,-2.4742268041237114,720,429
22400360,1,24,0.0,0.0,429,405
22400360,1,63,-5.0,-4.761904761904762,398,335
22400360,1,73,-1.0,-0.821917808219178,335,262
22400360,1,49,-4.0,-4.897959183673469,255,206
22400360,1,28,-2.0,-4.285714285714286,194,166
22400360,1,166,-7.0,-2.5301204819277108,166,0
22400360,2,135,8.0,3.555555555555556,720,585
22400360,2,129,2.0,0.9302325581395349,568,439
22400360,2,21,0.0,0.0,428,407
22400360,2,7,1.0,8.571428571428571,398,391
22400360,2,35,3.0,5.142857142857143,391,356
22400360,2,4,0.0,0.0,344,340
22400360,2,72,-1.0,-0.8333333333333333,333,261
22400360,2,151,1.0,0.3973509933774834,261,110
22400360,2,76,-1.0,-0.7894736842105263,110,34
22400360,2,34,0.0,0.0,34,0
22400360,3,263,-6.0,-1.3688212927756656,720,457
22400360,3,92,2.0,1.3043478260869565,453,361
22400360,3,20,0.0,0.0,342,322
22400360,3,59,-3.0,-3.050847457627119,314,255
22400360,3,136,7.0,3.0882352941176467,233,97
22400360,3,8,0.0,0.0,97,89
22400360,3,45,1.0,1.3333333333333335,89,44
22400360,4,66,1.0,0.9090909090909092,720,654
22400360,4,115,1.0,0.5217391304347826,643,528
22400360,4,22,2.0,5.454545454545455,511,489
22400360,4,106,-6.0,-3.3962264150943398,489,383
22400360,4,53,0.0,0.0,369,316
22400360,4,31,0.0,0.0,309,278
22400360,4,27,-1.0,-2.2222222222222223,261,234
22400360,4,192,7.0,2.1875,234,42
22400360,4,33,3.0,5.454545454545455,42,9
22400361,1,319,-3.0,-0.5642633228840126,720,401
22400361,1,94,-1.0,-0.6382978723404256,401,307
22400361,1,27,0.0,0.0,307,280
22400361,1,3,4.0,80.0,266,263
22400361,1,42,0.0,0.0,249,207
22400361,1,77,-4.0,-3.116883116883117,204,127
22400361,1,27,0.0,0.0,127,100
22400361,2,223,-8.0,-2.1524663677130045,720,497
22400361,2,14,0.0,0.0,497,483
22400361,2,22,-3.0,-8.181818181818182,471,449
22400361,2,101,2.0,1.188118811881188,428,327
22400361,2,57,-1.0,-1.0526315789473684,312,255
22400361,2,42,0.0,0.0,240,198
22400361,2,95,0.0,0.0,191,96
22400361,2,77,-6.0,-4.675324675324675,96,19
22400361,2,18,-2.0,-6.666666666666666,18,0
22400361,3,70,-4.0,-3.4285714285714284,720,650
22400361,3,141,3.0,1.2765957446808511,630,489
22400361,3,154,10.0,3.8961038961038956,489,335
22400361,3,82,2.0,1.4634146341463414,335,253
22400361,3,59,-3.0,-3.050847457627119,253,194
22400361,3,142,2.0,0.8450704225352113,194,52
22400361,3,30,0.0,0.0,30,0
22400361,4,103,4.0,2.3300970873786406,720,617
22400361,4,127,0.0,0.0,598,471
22400361,4,30,-2.0,-4.0,448,418
22400361,4,210,-4.0,-1.142857142857143,395,185
22400361,4,65,3.0,2.769230769230769,154,89
22400361,4,77,3.0,2.3376623376623376,77,0
22400362,1,280,-4.0,-0.8571428571428571,720,440
22400362,1,69,4.0,3.4782608695652173,440,371
22400362,1,47,0.0,0.0,351,304
22400362,1,114,-1.0,-0.5263157894736842,295,181
22400362,1,14,0.0,0.0,173,159
22400362,1,124,1.0,0.4838709677419355,157,33
22400362,1,33,-3.0,-5.454545454545455,33,0
22400362,2,140,4.0,1.7142857142857142,720,580
22400362,2,90,-2.0,-1.3333333333333335,570,480
22400362,2,19,-2.0,-6.315789473684211,463,444
22400362,2,94,3.0,1.9148936170212765,444,350
22400362,2,30,0.0,0.0,350,320
22400362,2,53,0.0,0.0,304,251
22400362,2,65,-1.0,-0.9230769230769231,244,179
22400362,2,38,-1.0,-1.5789473684210527,169,131
22400362,2,14,3.0,12.857142857142856,128,114
22400362,2,53,5.0,5.660377358490567,97,44
22400362,2,38,-1.0,-1.5789473684210527,44,6
22400362,2,6,0.0,0.0,6,0
22400362,3,193,-4.0,-1.2435233160621761,720,527
22400362,3,129,0.0,0.0,527,398
22400362,3,120,0.0,0.0,386,266
22400362,3,18,0.0,0.0,266,248
22400362,3,85,-4.0,-2.8235294117647056,237,152
22400362,3,127,3.0,1.4173228346456692,127,0
22400362,4,111,5.0,2.7027027027027026,720,609
22400362,4,54,0.0,0.0,592,538
22400362,4,65,0.0,0.0,520,455
22400362,4,25,-2.0,-4.8,443,418
22400362,4,12,-1.0,-5.0,418,406
22400362,4,66,6.0,5.454545454545455,406,340
22400362,4,65,1.0,0.9230769230769231,337,272
22400362,4,215,1.0,0.27906976744186046,272,57
22400362,4,7,0.0,0.0,48,41
22400362,4,13,-2.0,-9.230769230769232,41,28
22400362,4,26,2.0,4.615384615384616,26,0
22400363,1,241,4.0,0.995850622406639,720,479
22400363,1,9,0.0,0.0,458,449
22400363,1,118,-1.0,-0.5084745762711864,442,324
22400363,1,121,1.0,0.49586776859504134,315,194
22400363,1,81,-2.0,-1.4814814814814814,186,105
22400363,1,41,0.0,0.0,89,48
22400363,2,153,4.0,1.5686274509803921,720,567
22400363,2,34,-3.0,-5.294117647058824,561,527
22400363,2,44,0.0,0.0,520,476
22400363,2,68,0.0,0.0,466,398
22400363,2,92,0.0,0.0,383,291
22400363,2,60,-3.0,-3.0,275,215
22400363,2,133,5.0,2.2556390977443606,215,82
22400363,2,82,-2.0,-1.4634146341463414,82,0
22400363,3,275,0.0,0.0,720,445
22400363,3,25,1.0,2.4,445,420
22400363,3,70,-2.0,-1.7142857142857142,420,350
22400363,3,45,1.0,1.3333333333333335,348,303
22400363,3,42,-3.0,-4.285714285714286,303,261
22400363,3,81,0.0,0.0,261,180
22400363,3,171,3.0,1.0526315789473684,171,0
22400363,4,78,-2.0,-1.5384615384615383,720,642
22400363,4,174,-10.0,-3.4482758620689653,642,468
22400363,4,23,2.0,5.217391304347826,461,438
22400363,4,34,0.0,0.0,438,404
22400363,4,79,3.0,2.278481012658228,403,324
22400363,4,297,-9.0,-1.8181818181818183,316,19
22400363,4,8,3.0,22.5,8,0
22400364,1,258,0.0,0.0,720,462
22400364,1,69,-1.0,-0.8695652173913043,442,373
22400364,1,86,-3.0,-2.0930232558139537,366,280
22400364,1,57,0.0,0.0,274,217
22400364,1,201,3.0,0.8955223880597015,201,0
22400364,2,194,1.0,0.30927835051546393,720,526
22400364,2,24,0.0,0.0,511,487
22400364,2,73,2.0,1.643835616438356,479,406
22400364,2,49,-3.0,-3.673469387755102,404,355
22400364,2,9,0.0,0.0,340,331
22400364,2,37,1.0,1.6216216216216217,327,290
22400364,2,44,-2.0,-2.7272727272727275,290,246
22400364,2,60,0.0,0.0,246,186
22400364,2,12,-1.0,-5.0,186,174
22400364,2,68,-3.0,-2.647058823529412,158,90
22400364,2,57,0.0,0.0,79,22
22400364,2,22,-2.0,-5.454545454545455,22,0
22400364,3,182,3.0,0.989010989010989,720,538
22400364,3,202,8.0,2.376237623762376,524,322
22400364,3,61,2.0,1.9672131147540985,308,247
22400364,3,29,0.0,0.0,247,218
22400364,3,199,3.0,0.9045226130653266,199,0
22400364,4,140,2.0,0.8571428571428571,720,580
22400364,4,59,-3.0,-3.050847457627119,580,521
22400364,4,38,0.0,0.0,508,470
22400364,4,190,-1.0,-0.3157894736842105,470,280
22400364,4,233,-5.0,-1.2875536480686696,259,26
22400364,4,24,0.0,0.0,24,0
22400365,1,388,13.0,2.0103092783505154,720,332
22400365,1,82,2.0,1.4634146341463414,326,244
22400365,1,110,0.0,0.0,244,134
22400365,1,56,-2.0,-2.142857142857143,121,65
22400365,1,65,3.0,2.769230769230769,65,0
22400365,2,178,1.0,0.33707865168539325,720,542
22400365,2,90,6.0,4.0,534,444
22400365,2,46,-4.0,-5.217391304347826,427,381
22400365,2,61,2.0,1.9672131147540985,362,301
22400365,2,15,0.0,0.0,301,286
22400365,2,85,0.0,0.0,280,195
22400365,2,33,-1.0,-1.8181818181818183,183,150
22400365,2,67,1.0,0.8955223880597015,150,83
22400365,2,78,-1.0,-0.7692307692307692,83,5
22400365,2,5,0.0,0.0,5,0
22400365,3,337,10.0,1.7804154302670623,720,383
22400365,3,69,0.0,0.0,373,304
22400365,3,114,-1.0,-0.5263157894736842,304,190
22400365,3,95,-1.0,-0.631578947368421,190,95
22400365,3,91,-1.0,-0.6593406593406594,95,4
22400365,4,132,4.0,1.8181818181818183,720,588
22400365,4,93,-9.0,-5.806451612903226,576,483
22400365,4,85,2.0,1.4117647058823528,459,374
22400365,4,3,0.0,0.0,352,349
22400365,4,62,1.0,0.967741935483871,336,274
22400365,4,61,0.0,0.0,264,203
22400365,4,69,2.0,1.7391304347826086,192,123
22400365,4,4,0.0,0.0,123,119
22400365,4,109,1.0,0.5504587155963303,109,0
22400366,1,97,5.0,3.092783505154639,720,623
22400366,1,182,2.0,0.6593406593406594,617,435
22400366,1,39,2.0,3.0769230769230766,435,396
22400366,1,97,0.0,0.0,387,290
22400366,1,56,2.0,2.142857142857143,290,234
22400366,1,37,0.0,0.0,231,194
22400366,1,135,5.0,2.2222222222222223,177,42
22400366,2,21,0.0,0.0,720,699
22400366,2,228,4.0,1.0526315789473684,694,466
22400366,2,87,-4.0,-2.7586206896551726,466,379
22400366,2,81,-1.0,-0.7407407407407407,379,298
22400366,2,59,3.0,3.050847457627119,290,231
22400366,2,115,0.0,0.0,218,103
22400366,2,66,7.0,6.363636363636364,103,37
22400366,2,11,0.0,0.0,37,26
22400366,2,19,0.0,0.0,26,7
22400366,2,1,0.0,0.0,1,0
22400366,3,171,7.0,2.4561403508771926,720,549
22400366,3,53,2.0,2.2641509433962264,546,493
22400366,3,184,7.0,2.282608695652174,493,309
22400366,3,165,2.0,0.7272727272727273,295,130
22400366,3,121,2.0,0.9917355371900827,121,0
22400366,4,113,0.0,0.0,720,607
22400366,4,123,5.0,2.4390243902439024,607,484
22400366,4,69,-5.0,-4.3478260869565215,484,415
22400366,4,113,4.0,2.1238938053097343,403,290
22400366,4,89,-2.0,-1.348314606741573,290,201
22400366,4,188,0.0,0.0,188,0
22400367,1,389,1.0,0.15424164524421594,720,331
22400367,1,52,-2.0,-2.307692307692308,315,263
22400367,1,19,0.0,0.0,251,232
22400367,1,87,5.0,3.4482758620689653,218,131
22400367,1,49,-4.0,-4.897959183673469,120,71
22400367,1,39,-1.0,-1.5384615384615383,71,32
22400367,2,127,-11.0,-5.196850393700787,720,593
22400367,2,71,-2.0,-1.6901408450704225,593,522
22400367,2,143,-8.0,-3.3566433566433567,522,379
22400367,2,34,2.0,3.5294117647058822,379,345
22400367,2,122,-6.0,-2.9508196721311473,345,223
22400367,2,193,3.0,0.9326424870466321,223,30
22400367,2,30,3.0,6.0,30,0
22400367,3,321,-3.0,-0.5607476635514018,720,399
22400367,3,225,-5.0,-1.3333333333333335,399,174
22400367,3,100,-2.0,-1.2,174,74
22400367,3,66,3.0,2.7272727272727275,66,0
22400367,4,86,-5.0,-3.488372093023256,720,634
22400367,4,73,0.0,0.0,624,551
22400367,4,287,12.0,2.5087108013937285,533,246
22400367,4,127,-2.0,-0.9448818897637795,237,110
22400367,4,95,1.0,0.631578947368421,95,0
22400368,1,284,2.0,0.4225352112676056,720,436
22400368,1,60,2.0,2.0,436,376
22400368,1,79,0.0,0.0,376,297
22400368,1,14,0.0,0.0,297,283
22400368,1,96,0.0,0.0,283,187
22400368,1,25,0.0,0.0,172,147
22400368,2,111,-1.0,-0.5405405405405406,720,609
22400368,2,24,0.0,0.0,609,585
22400368,2,165,1.0,0.36363636363636365,575,410
22400368,2,230,-5.0,-1.3043478260869565,378,148
22400368,2,137,-3.0,-1.3138686131386863,137,0
22400368,3,212,0.0,0.0,720,508
22400368,3,79,3.0,2.278481012658228,508,429
22400368,3,29,-7.0,-14.482758620689657,426,397
22400368,3,56,0.0,0.0,388,332
22400368,3,69,-2.0,-1.7391304347826086,332,263
22400368,3,106,-7.0,-3.9622641509433962,263,157
22400368,3,145,1.0,0.41379310344827586,145,0
22400368,4,24,0.0,0.0,720,696
22400368,4,151,2.0,0.7947019867549668,684,533
22400368,4,54,0.0,0.0,526,472
22400368,4,113,-6.0,-3.185840707964602,472,359
22400368,4,120,0.0,0.0,348,228
22400368,4,43,-2.0,-2.7906976744186047,219,176
22400368,4,174,-6.0,-2.0689655172413794,174,0
22400369,1,395,-4.0,-0.6075949367088608,720,325
22400369,1,43,-3.0,-4.186046511627907,316,273
22400369,1,67,1.0,0.8955223880597015,259,192
22400369,1,85,-2.0,-1.4117647058823528,180,95
22400369,1,40,-1.0,-1.5,88,48
22400369,1,48,2.0,2.5,48,0
22400369,2,271,1.0,0.22140221402214022,720,449
22400369,2,3,0.0,0.0,449,446
22400369,2,58,-1.0,-1.0344827586206897,437,379
22400369,2,78,-1.0,-0.7692307692307692,379,301
22400369,2,57,-2.0,-2.1052631578947367,301,244
22400369,2,82,5.0,3.6585365853658534,244,162
22400369,2,162,1.0,0.37037037037037035,162,0
22400369,3,402,-10.0,-1.492537313432836,720,318
22400369,3,46,-3.0,-3.9130434782608696,302,256
22400369,3,58,1.0,1.0344827586206897,247,189
22400369,3,150,-3.0,-1.2,189,39
22400369,4,63,0.0,0.0,720,657
22400369,4,106,-3.0,-1.6981132075471699,657,551
22400369,4,58,1.0,1.0344827586206897,532,474
22400369,4,93,5.0,3.2258064516129035,474,381
22400369,4,57,-4.0,-4.2105263157894735,381,324
22400369,4,138,3.0,1.3043478260869565,308,170
22400369,4,30,-2.0,-4.0,30,0
22400370,1,301,9.0,1.7940199335548175,720,419
22400370,1,13,0.0,0.0,413,400
22400370,1,44,0.0,0.0,400,356
22400370,1,26,1.0,2.307692307692308,346,320
22400370,1,111,-6.0,-3.2432432432432434,320,209
22400370,1,126,5.0,2.380952380952381,199,73
22400370,1,30,1.0,2.0,63,33
22400370,1,5,-2.0,-24.0,33,28
22400370,1,28,0.0,0.0,28,0
22400370,2,197,-9.0,-2.7411167512690353,720,523
22400370,2,65,7.0,6.461538461538462,523,458
22400370,2,15,2.0,8.0,439,424
22400370,2,37,-3.0,-4.864864864864865,424,387
22400370,2,42,-2.0,-2.8571428571428568,381,339
22400370,2,72,-2.0,-1.6666666666666665,326,254
22400370,2,86,-10.0,-6.976744186046512,254,168
22400370,2,1,0.0,0.0,27,26
22400370,3,328,3.0,0.548780487804878,720,392
22400370,3,18,0.0,0.0,387,369
22400370,3,20,0.0,0.0,364,344
22400370,3,38,2.0,3.1578947368421053,321,283
22400370,3,32,1.0,1.875,267,235
22400370,3,138,1.0,0.43478260869565216,235,97
22400370,3,75,0.0,0.0,78,3
22400370,4,213,-6.0,-1.6901408450704225,720,507
22400370,4,23,2.0,5.217391304347826,507,484
22400370,4,74,2.0,1.6216216216216217,477,403
22400370,4,5,0.0,0.0,385,380
22400370,4,69,4.0,3.4782608695652173,356,287
22400370,4,2,0.0,0.0,273,271
22400370,4,198,-3.0,-0.9090909090909092,252,54
22400370,4,36,0.0,0.0,54,18
22400370,4,1,0.0,0.0,17,16
22400370,5,234,1.0,0.25641025641025644,300,66
22400370,5,13,0.0,0.0,51,38
22400370,5,1,0.0,0.0,19,18
22400370,5,14,0.0,0.0,14,0
22400371,1,273,4.0,0.8791208791208791,720,447
22400371,1,63,1.0,0.9523809523809523,435,372
22400371,1,202,-10.0,-2.9702970297029703,355,153
22400371,1,22,1.0,2.7272727272727275,153,131
22400371,1,131,0.0,0.0,131,0
22400371,2,183,7.0,2.2950819672131146,720,537
22400371,2,42,5.0,7.142857142857142,519,477
22400371,2,75,-3.0,-2.4,471,396
22400371,2,9,0.0,0.0,396,387
22400371,2,143,4.0,1.6783216783216783,387,244
22400371,2,80,8.0,6.0,227,147
22400371,2,136,-7.0,-3.0882352941176467,136,0
22400371,3,268,-1.0,-0.22388059701492538,720,452
22400371,3,122,7.0,3.4426229508196724,452,330
22400371,3,111,4.0,2.1621621621621623,318,207
22400371,4,113,-7.0,-3.7168141592920354,720,607
22400371,4,107,-3.0,-1.6822429906542056,607,500
22400371,4,130,4.0,1.8461538461538463,500,370
22400371,4,324,-5.0,-0.9259259259259258,348,24
22400372,1,368,-6.0,-0.9782608695652174,720,352
22400372,1,95,5.0,3.1578947368421053,352,257
22400372,1,70,-5.0,-4.285714285714286,240,170
22400372,1,11,0.0,0.0,160,149
22400372,1,139,0.0,0.0,149,10
22400372,2,75,2.0,1.6,720,645
22400372,2,26,0.0,0.0,645,619
22400372,2,31,-2.0,-3.870967741935484,619,588
22400372,2,23,-2.0,-5.217391304347826,573,550
22400372,2,30,0.0,0.0,550,520
22400372,2,34,3.0,5.294117647058824,520,486
22400372,2,12,-1.0,-5.0,470,458
22400372,2,37,2.0,3.2432432432432434,458,421
22400372,2,152,6.0,2.3684210526315788,413,261
22400372,2,34,0.0,0.0,261,227
22400372,2,162,-4.0,-1.4814814814814814,227,65
22400372,2,60,-1.0,-1.0,65,5
22400372,3,313,2.0,0.38338658146964855,720,407
22400372,3,59,0.0,0.0,407,348
22400372,3,72,-1.0,-0.8333333333333333,348,276
22400372,3,39,-1.0,-1.5384615384615383,267,228
22400372,3,68,0.0,0.0,204,136
22400372,3,136,-3.0,-1.323529411764706,136,0
22400372,4,183,3.0,0.9836065573770493,720,537
22400372,4,28,-2.0,-4.285714285714286,515,487
22400372,4,73,-2.0,-1.643835616438356,480,407
22400372,4,120,-2.0,-1.0,400,280
22400372,4,179,-2.0,-0.670391061452514,237,58
22400373,1,361,12.0,1.994459833795014,720,359
22400373,1,64,1.0,0.9375,349,285
22400373,1,17,1.0,3.5294117647058822,274,257
22400373,1,23,-1.0,-2.608695652173913,257,234
22400373,1,105,-1.0,-0.5714285714285715,234,129
22400373,2,57,0.0,0.0,720,663
22400373,2,93,0.0,0.0,648,555
22400373,2,79,0.0,0.0,548,469
22400373,2,87,-4.0,-2.7586206896551726,469,382
22400373,2,165,1.0,0.36363636363636365,360,195
22400373,2,104,-4.0,-2.307692307692308,172,68
22400373,2,20,4.0,12.0,60,40
22400373,3,237,8.0,2.0253164556962022,720,483
22400373,3,37,0.0,0.0,483,446
22400373,3,64,-3.0,-2.8125,446,382
22400373,3,87,-1.0,-0.6896551724137931,375,288
22400373,3,10,0.0,0.0,245,235
22400373,3,18,0.0,0.0,228,210
22400373,3,8,0.0,0.0,196,188
22400373,3,179,-2.0,-0.670391061452514,235,56
22400373,3,56,0.0,0.0,56,0
22400373,4,248,-8.0,-1.935483870967742,720,472
22400373,4,107,2.0,1.1214953271028036,457,350
22400373,4,20,-1.0,-3.0,350,330
22400373,4,142,1.0,0.4225352112676056,330,188
22400373,4,132,1.0,0.4545454545454546,183,51
22400373,4,19,2.0,6.315789473684211,51,32
22400374,1,283,0.0,0.0,720,437
22400374,1,74,2.0,1.6216216216216217,437,363
22400374,1,79,3.0,2.278481012658228,348,269
22400374,1,249,2.0,0.48192771084337344,249,0
22400374,2,163,1.0,0.36809815950920244,720,557
22400374,2,62,0.0,0.0,546,484
22400374,2,15,3.0,12.0,477,462
22400374,2,196,2.0,0.6122448979591836,448,252
22400374,2,76,4.0,3.1578947368421053,239,163
22400374,2,83,-2.0,-1.4457831325301205,152,69
22400374,2,69,1.0,0.8695652173913043,69,0
22400374,3,262,7.0,1.6030534351145038,720,458
22400374,3,65,-4.0,-3.6923076923076925,445,380
22400374,3,61,-5.0,-4.918032786885245,370,309
22400374,3,123,1.0,0.48780487804878053,276,153
22400374,3,12,0.0,0.0,139,127
22400374,3,55,0.0,0.0,121,66
22400374,3,66,8.0,7.272727272727273,66,0
22400374,4,39,2.0,3.0769230769230766,720,681
22400374,4,118,2.0,1.0169491525423728,671,553
22400374,4,80,-3.0,-2.25,542,462
22400374,4,33,0.0,0.0,462,429
22400374,4,383,-7.0,-1.0966057441253265,429,46
22400375,1,322,-1.0,-0.18633540372670807,720,398
22400375,1,75,0.0,0.0,398,323
22400375,1,29,-2.0,-4.137931034482759,310,281
22400375,1,65,-4.0,-3.6923076923076925,259,194
22400375,1,194,1.0,0.30927835051546393,194,0
22400375,2,260,0.0,0.0,720,460
22400375,2,62,4.0,3.870967741935484,441,379
22400375,2,62,-3.0,-2.903225806451613,358,296
22400375,2,197,5.0,1.5228426395939085,285,88
22400375,2,21,-2.0,-5.7142857142857135,68,47
22400375,2,47,0.0,0.0,47,0
22400375,3,101,-2.0,-1.188118811881188,720,619
22400375,3,92,0.0,0.0,607,515
22400375,3,56,4.0,4.285714285714286,501,445
22400375,3,142,-10.0,-4.225352112676057,445,303
22400375,3,46,0.0,0.0,303,257
22400375,3,38,-2.0,-3.1578947368421053,244,206
22400375,3,29,0.0,0.0,201,172
22400375,3,160,-4.0,-1.5,160,0
22400375,4,170,2.0,0.7058823529411764,720,550
22400375,4,50,0.0,0.0,537,487
22400375,4,42,1.0,1.4285714285714284,477,435
22400375,4,6,0.0,0.0,420,414
22400375,4,132,2.0,0.9090909090909092,395,263
22400375,4,253,-1.0,-0.23715415019762845,263,10
22400375,4,6,-1.0,-10.0,6,0
22400376,1,384,-9.0,-1.40625,720,336
22400376,1,117,3.0,1.5384615384615383,313,196
22400376,1,41,3.0,4.390243902439024,141,100
22400376,2,103,2.0,1.1650485436893203,720,617
22400376,2,58,-3.0,-3.103448275862069,606,548
22400376,2,101,2.0,1.188118811881188,536,435
22400376,2,19,0.0,0.0,424,405
22400376,2,26,0.0,0.0,392,366
22400376,2,202,7.0,2.0792079207920793,366,164
22400376,2,140,-3.0,-1.2857142857142858,152,12
22400376,2,12,2.0,10.0,12,0
22400376,3,187,1.0,0.32085561497326204,720,533
22400376,3,211,0.0,0.0,533,322
22400376,3,37,-2.0,-3.2432432432432434,309,272
22400376,3,60,2.0,2.0,248,188
22400376,3,60,-3.0,-3.0,188,128
22400376,3,40,0.0,0.0,121,81
22400376,3,64,-1.0,-0.9375,75,11
22400376,3,11,0.0,0.0,11,0
22400376,4,175,-2.0,-0.6857142857142857,720,545
22400376,4,122,5.0,2.4590163934426226,545,423
22400376,4,34,-2.0,-3.5294117647058822,423,389
22400376,4,125,-2.0,-0.96,373,248
22400376,4,224,4.0,1.0714285714285714,236,12
22400376,4,3,-2.0,-40.0,12,9
22400376,4,7,0.0,0.0,7,0
22400377,1,360,3.0,0.5,720,360
22400377,1,19,0.0,0.0,360,341
22400377,1,91,0.0,0.0,338,247
22400377,1,28,-4.0,-8.571428571428571,247,219
22400377,1,17,0.0,0.0,202,185
22400377,1,3,0.0,0.0,172,169
22400377,1,88,-1.0,-0.6818181818181819,141,53
22400377,1,34,-1.0,-1.7647058823529411,43,9
22400377,1,9,2.0,13.333333333333332,9,0
22400377,2,126,-4.0,-1.9047619047619047,720,594
22400377,2,19,0.0,0.0,571,552
22400377,2,14,-1.0,-4.285714285714286,537,523
22400377,2,105,-3.0,-1.7142857142857142,523,418
22400377,2,49,-2.0,-2.4489795918367343,418,369
22400377,2,76,-2.0,-1.5789473684210527,369,293
22400377,2,24,0.0,0.0,291,267
22400377,2,111,-1.0,-0.5405405405405406,263,152
22400377,2,72,2.0,1.6666666666666665,152,80
22400377,2,48,1.0,1.25,80,32
22400377,3,43,0.0,0.0,720,677
22400377,3,86,1.0,0.6976744186046512,665,579
22400377,3,213,-4.0,-1.1267605633802817,579,366
22400377,3,80,5.0,3.75,351,271
22400377,3,119,-3.0,-1.5126050420168067,254,135
22400377,3,47,-2.0,-2.5531914893617023,122,75
22400377,3,66,-5.0,-4.545454545454546,66,0
22400377,4,175,11.0,3.771428571428572,720,545
22400377,4,86,1.0,0.6976744186046512,545,459
22400377,4,113,2.0,1.0619469026548671,448,335
22400377,4,40,3.0,4.5,326,286
22400377,4,15,0.0,0.0,280,265
22400377,4,185,9.0,2.9189189189189193,254,69
22400377,4,48,-1.0,-1.25,69,21
22400377,4,8,1.0,7.5,21,13
22400377,4,7,2.0,17.142857142857142,7,0
22400378,1,297,0.0,0.0,720,423
22400378,1,39,0.0,0.0,403,364
22400378,1,80,2.0,1.5,357,277
22400378,1,33,-3.0,-5.454545454545455,266,233
22400378,1,37,0.0,0.0,220,183
22400378,2,134,-4.0,-1.791044776119403,720,586
22400378,2,46,2.0,2.608695652173913,586,540
22400378,2,9,0.0,0.0,540,531
22400378,2,64,2.0,1.875,531,467
22400378,2,55,-1.0,-1.0909090909090908,449,394
22400378,2,64,-1.0,-0.9375,376,312
22400378,2,103,1.0,0.5825242718446602,303,200
22400378,2,10,0.0,0.0,177,167
22400378,2,115,-3.0,-1.5652173913043477,151,36
22400378,2,36,-3.0,-5.0,36,0
22400378,3,190,1.0,0.3157894736842105,720,530
22400378,3,79,-4.0,-3.0379746835443036,530,451
22400378,3,44,3.0,4.090909090909091,442,398
22400378,3,9,0.0,0.0,387,378
22400378,3,21,0.0,0.0,373,352
22400378,3,25,-2.0,-4.8,344,319
22400378,3,96,2.0,1.25,319,223
22400378,3,30,0.0,0.0,223,193
22400378,3,184,1.0,0.32608695652173914,184,0
22400378,4,165,-2.0,-0.7272727272727273,720,555
22400378,4,75,5.0,4.0,537,462
22400378,4,47,-3.0,-3.829787234042553,453,406
22400378,4,34,2.0,3.5294117647058822,406,372
22400378,4,9,0.0,0.0,372,363
22400378,4,39,-3.0,-4.615384615384616,363,324
22400378,4,68,1.0,0.8823529411764706,316,248
22400378,4,121,4.0,1.9834710743801653,248,127
22400378,4,121,3.0,1.487603305785124,121,0
22400379,1,285,0.0,0.0,720,435
22400379,1,245,0.0,0.0,625,380
22400379,1,26,3.0,6.923076923076923,367,341
22400379,1,21,0.0,0.0,341,320
22400379,1,25,0.0,0.0,320,295
22400379,1,73,1.0,0.821917808219178,295,222
22400379,1,55,1.0,1.0909090909090908,222,167
22400379,1,155,1.0,0.3870967741935484,155,0
22400379,2,207,1.0,0.2898550724637681,720,513
22400379,2,19,0.0,0.0,496,477
22400379,2,142,-1.0,-0.4225352112676056,470,328
22400379,2,53,3.0,3.3962264150943398,315,262
22400379,2,102,-7.0,-4.11764705882353,256,154
22400379,2,139,-2.0,-0.8633093525179857,139,0
22400379,3,319,1.0,0.18808777429467083,720,401
22400379,3,13,0.0,0.0,394,381
22400379,3,11,1.0,5.454545454545455,369,358
22400379,3,58,-2.0,-2.0689655172413794,358,300
22400379,3,67,-5.0,-4.477611940298507,288,221
22400379,3,199,-2.0,-0.6030150753768845,199,0
22400379,4,51,-5.0,-5.88235294117647,720,669
22400379,4,103,0.0,0.0,656,553
22400379,4,42,-5.0,-7.142857142857142,553,511
22400379,4,34,3.0,5.294117647058824,511,477
22400379,4,115,0.0,0.0,462,347
22400379,4,110,0.0,0.0,330,220
22400379,4,33,1.0,1.8181818181818183,220,187
22400379,4,180,4.0,1.3333333333333335,180,0
22400380,1,368,-12.0,-1.9565217391304348,720,352
22400380,1,35,0.0,0.0,342,307
22400380,1,122,0.0,0.0,307,185
22400380,1,84,4.0,2.8571428571428568,173,89
22400380,1,84,0.0,0.0,89,5
22400380,2,152,-6.0,-2.3684210526315788,720,568
22400380,2,46,3.0,3.9130434782608696,561,515
22400380,2,60,3.0,3.0,515,455
22400380,2,9,0.0,0.0,455,446
22400380,2,14,0.0,0.0,433,419
22400380,2,61,1.0,0.9836065573770493,419,358
22400380,2,104,5.0,2.8846153846153846,348,244
22400380,2,43,0.0,0.0,225,182
22400380,2,114,1.0,0.5263157894736842,182,68
22400380,3,24,0.0,0.0,720,696
22400380,3,141,7.0,2.9787234042553195,681,540
22400380,3,68,-3.0,-2.647058823529412,528,460
22400380,3,67,-2.0,-1.791044776119403,460,393
22400380,3,38,0.0,0.0,393,355
22400380,3,187,6.0,1.9251336898395723,342,155
22400380,4,192,1.0,0.3125,720,528
22400380,4,15,3.0,12.0,506,491
22400380,4,51,3.0,3.5294117647058822,477,426
22400380,4,47,0.0,0.0,420,373
22400380,4,50,4.0,4.8,365,315
22400380,4,315,-4.0,-0.7619047619047619,315,0
22400381,1,102,-3.0,-1.7647058823529411,720,618
22400381,1,201,6.0,1.791044776119403,608,407
22400381,1,143,1.0,0.4195804195804196,393,250
22400381,1,66,-4.0,-3.6363636363636367,243,177
22400381,1,37,2.0,3.2432432432432434,177,140
22400381,1,135,-4.0,-1.777777777777778,140,5
22400381,2,94,-4.0,-2.5531914893617023,720,626
22400381,2,159,-1.0,-0.37735849056603776,622,463
22400381,2,77,2.0,1.5584415584415585,454,377
22400381,2,161,-3.0,-1.1180124223602486,377,216
22400381,2,5,0.0,0.0,204,199
22400381,2,50,-5.0,-6.0,190,140
22400381,2,140,3.0,1.2857142857142858,140,0
22400381,3,370,-1.0,-0.16216216216216217,720,350
22400381,3,107,-1.0,-0.5607476635514018,350,243
22400381,3,39,-2.0,-3.0769230769230766,231,192
22400381,3,125,-3.0,-1.44,175,50
22400381,3,41,-3.0,-4.390243902439024,41,0
22400381,4,38,0.0,0.0,720,682
22400381,4,71,-2.0,-1.6901408450704225,676,605
22400381,4,72,-3.0,-2.5,591,519
22400381,4,25,-4.0,-9.6,507,482
22400381,4,47,0.0,0.0,475,428
22400381,4,103,-2.0,-1.1650485436893203,421,318
22400381,4,15,0.0,0.0,318,303
22400381,4,34,3.0,5.294117647058824,292,258
22400381,4,47,3.0,3.829787234042553,254,207
22400381,4,79,0.0,0.0,173,94
22400382,1,303,2.0,0.39603960396039606,720,417
22400382,1,172,0.0,0.0,417,245
22400382,1,23,-3.0,-7.826086956521739,228,205
22400382,1,168,-6.0,-2.142857142857143,198,30
22400382,2,221,3.0,0.8144796380090498,720,499
22400382,2,47,-1.0,-1.2765957446808511,486,439
22400382,2,45,0.0,0.0,431,386
22400382,2,68,2.0,1.7647058823529411,378,310
22400382,2,102,5.0,2.941176470588235,297,195
22400382,2,42,3.0,4.285714285714286,192,150
22400382,2,25,0.0,0.0,131,106
22400382,2,87,0.0,0.0,93,6
22400382,3,342,9.0,1.5789473684210527,720,378
22400382,3,182,-7.0,-2.307692307692308,378,196
22400382,3,63,0.0,0.0,173,110
22400382,3,91,0.0,0.0,91,0
22400382,4,206,4.0,1.1650485436893203,720,514
22400382,4,57,-1.0,-1.0526315789473684,492,435
22400382,4,31,-2.0,-3.870967741935484,416,385
22400382,4,72,6.0,5.0,385,313
22400382,4,37,2.0,3.2432432432432434,298,261
22400382,4,158,-10.0,-3.79746835443038,261,103
22400382,4,54,-2.0,-2.2222222222222223,54,0
22400383,1,298,-3.0,-0.6040268456375839,720,422
22400383,1,8,-2.0,-15.0,407,399
22400383,1,47,3.0,3.829787234042553,383,336
22400383,1,39,0.0,0.0,312,273
22400383,1,15,-2.0,-8.0,248,233
22400383,1,28,-3.0,-6.428571428571428,233,205
22400383,1,194,-5.0,-1.5463917525773194,194,0
22400383,2,45,-2.0,-2.666666666666667,720,675
22400383,2,75,-3.0,-2.4,661,586
22400383,2,31,0.0,0.0,567,536
22400383,2,56,-3.0,-3.214285714285714,532,476
22400383,2,85,0.0,0.0,465,380
22400383,2,74,3.0,2.4324324324324325,376,302
22400383,2,34,2.0,3.5294117647058822,302,268
22400383,2,9,3.0,20.0,268,259
22400383,2,31,-2.0,-3.870967741935484,245,214
22400383,2,175,4.0,1.3714285714285714,205,30
22400383,2,1,0.0,0.0,30,29
22400383,2,22,-3.0,-8.181818181818182,22,0
22400383,3,287,8.0,1.6724738675958188,720,433
22400383,3,54,0.0,0.0,431,377
22400383,3,92,3.0,1.9565217391304348,377,285
22400383,3,103,-2.0,-1.1650485436893203,271,168
22400383,3,21,-2.0,-5.7142857142857135,154,133
22400383,3,124,0.0,0.0,124,0
22400383,4,125,5.0,2.4,720,595
22400383,4,100,0.0,0.0,595,495
22400383,4,37,0.0,0.0,495,458
22400383,4,210,-1.0,-0.28571428571428575,450,240
22400383,4,33,-2.0,-3.6363636363636367,235,202
22400383,4,69,-6.0,-5.217391304347826,196,127
22400383,4,24,3.0,7.5,126,102
22400383,4,102,-3.0,-1.7647058823529411,102,0
22400384,1,357,2.0,0.33613445378151263,720,363
22400384,1,98,0.0,0.0,345,247
22400384,1,44,-2.0,-2.7272727272727275,239,195
22400384,1,174,4.0,1.3793103448275863,195,21
22400384,1,2,-1.0,-30.0,19,17
22400384,1,17,0.0,0.0,17,0
22400384,2,42,0.0,0.0,720,678
22400384,2,128,3.0,1.40625,669,541
22400384,2,165,3.0,1.0909090909090908,530,365
22400384,2,130,-6.0,-2.769230769230769,365,235
22400384,2,191,2.0,0.6282722513089005,235,44
22400384,2,32,0.0,0.0,35,3
22400384,3,478,0.0,0.0,720,242
22400384,3,97,-3.0,-1.8556701030927836,224,127
22400384,4,112,-4.0,-2.142857142857143,720,608
22400384,4,71,-2.0,-1.6901408450704225,608,537
22400384,4,57,-3.0,-3.1578947368421053,537,480
22400384,4,135,0.0,0.0,455,320
22400384,4,96,2.0,1.25,305,209
22400384,4,66,0.0,0.0,192,126
22400384,4,110,-2.0,-1.0909090909090908,126,16
22400384,4,16,1.0,3.75,16,0
22400385,1,290,-1.0,-0.20689655172413793,720,430
22400385,1,25,3.0,7.199999999999999,411,386
22400385,1,60,-2.0,-2.0,361,301
22400385,1,27,-1.0,-2.2222222222222223,288,261
22400385,1,64,0.0,0.0,251,187
22400385,1,34,0.0,0.0,171,137
22400385,1,127,-1.0,-0.47244094488188976,127,0
22400385,2,144,6.0,2.5,720,576
22400385,2,38,-3.0,-4.7368421052631575,555,517
22400385,2,65,0.0,0.0,517,452
22400385,2,53,0.0,0.0,441,388
22400385,2,113,6.0,3.185840707964602,386,273
22400385,2,81,-2.0,-1.4814814814814814,266,185
22400385,2,33,-1.0,-1.8181818181818183,185,152
22400385,2,152,6.0,2.3684210526315788,152,0
22400385,3,272,-4.0,-0.8823529411764706,720,448
22400385,3,57,-2.0,-2.1052631578947367,448,391
22400385,3,39,-1.0,-1.5384615384615383,391,352
22400385,3,36,1.0,1.6666666666666665,344,308
22400385,3,66,-1.0,-0.9090909090909092,308,242
22400385,3,2,0.0,0.0,226,224
22400385,3,100,0.0,0.0,218,118
22400385,3,103,-1.0,-0.5825242718446602,103,0
22400385,4,164,3.0,1.097560975609756,720,556
22400385,4,155,0.0,0.0,556,401
22400385,4,83,-6.0,-4.337349397590361,393,310
22400385,4,88,1.0,0.6818181818181819,310,222
22400385,4,142,2.0,0.8450704225352113,222,80
22400385,4,43,2.0,2.7906976744186047,78,35
22400385,4,35,0.0,0.0,35,0
22400386,1,326,0.0,0.0,720,394
22400386,1,98,4.0,2.4489795918367343,387,289
22400386,1,73,2.0,1.643835616438356,281,208
22400386,1,198,-3.0,-0.9090909090909092,198,0
22400386,2,144,0.0,0.0,720,576
22400386,2,45,-3.0,-4.0,574,529
22400386,2,14,0.0,0.0,529,515
22400386,2,68,-1.0,-0.8823529411764706,502,434
22400386,2,14,0.0,0.0,365,351
22400386,2,57,-2.0,-2.1052631578947367,339,282
22400386,2,156,6.0,2.307692307692308,269,113
22400386,2,92,3.0,1.9565217391304348,92,0
22400386,3,305,1.0,0.19672131147540983,720,415
22400386,3,38,0.0,0.0,394,356
22400386,3,86,2.0,1.3953488372093024,346,260
22400386,3,3,-2.0,-40.0,250,247
22400386,3,20,0.0,0.0,233,213
22400386,3,43,4.0,5.5813953488372094,199,156
22400386,3,156,-1.0,-0.3846153846153846,156,0
22400386,4,39,1.0,1.5384615384615383,720,681
22400386,4,69,3.0,2.608695652173913,681,612
22400386,4,101,-4.0,-2.376237623762376,612,511
22400386,4,81,-1.0,-0.7407407407407407,499,418
22400386,4,6,2.0,20.0,411,405
22400386,4,189,5.0,1.5873015873015872,390,201
22400386,4,189,-3.0,-0.9523809523809523,189,0
22400387,1,357,-10.0,-1.680672268907563,720,363
22400387,1,121,-4.0,-1.9834710743801653,352,231
22400387,1,19,0.0,0.0,217,198
22400387,1,88,1.0,0.6818181818181819,193,105
22400387,1,99,-3.0,-1.8181818181818183,99,0
22400387,2,176,3.0,1.0227272727272727,720,544
22400387,2,16,-1.0,-3.75,536,520
22400387,2,221,1.0,0.2714932126696833,520,299
22400387,2,130,-1.0,-0.46153846153846156,288,158
22400387,2,143,8.0,3.3566433566433567,158,15
22400387,2,15,-2.0,-8.0,15,0
22400387,3,348,-4.0,-0.6896551724137931,720,372
22400387,3,79,4.0,3.0379746835443036,365,286
22400387,3,87,1.0,0.6896551724137931,286,199
22400387,3,220,-3.0,-0.8181818181818181,380,160
22400387,3,15,-2.0,-8.0,145,130
22400387,3,105,-1.0,-0.5714285714285715,119,14
22400387,4,133,0.0,0.0,720,587
22400387,4,63,-2.0,-1.9047619047619047,587,524
22400387,4,77,2.0,1.5584415584415585,524,447
22400387,4,37,1.0,1.6216216216216217,441,404
22400387,4,57,1.0,1.0526315789473684,395,338
22400387,4,123,1.0,0.48780487804878053,405,282
22400387,4,55,-1.0,-1.0909090909090908,282,227
22400387,4,173,3.0,1.0404624277456647,227,54
22400387,4,9,0.0,0.0,54,45
22400387,4,32,-1.0,-1.875,32,0
22400388,1,329,5.0,0.9118541033434651,720,391
22400388,1,32,0.0,0.0,381,349
22400388,1,40,5.0,7.5,337,297
22400388,1,76,1.0,0.7894736842105263,281,205
22400388,1,51,2.0,2.3529411764705883,198,147
22400388,1,133,-3.0,-1.3533834586466165,133,0
22400388,2,107,4.0,2.2429906542056073,720,613
22400388,2,52,2.0,2.307692307692308,613,561
22400388,2,8,0.0,0.0,548,540
22400388,2,62,-4.0,-3.870967741935484,530,468
22400388,2,124,0.0,0.0,430,306
22400388,2,34,-1.0,-1.7647058823529411,298,264
22400388,2,94,-2.0,-1.2765957446808511,264,170
22400388,2,50,-1.0,-1.2,170,120
22400388,2,117,2.0,1.0256410256410258,120,3
22400388,3,70,-5.0,-4.285714285714286,720,650
22400388,3,136,0.0,0.0,635,499
22400388,3,104,-3.0,-1.7307692307692308,499,395
22400388,3,94,1.0,0.6382978723404256,395,301
22400388,3,52,0.0,0.0,301,249
22400388,3,91,0.0,0.0,238,147
22400388,3,98,5.0,3.0612244897959187,147,49
22400388,3,21,-2.0,-5.7142857142857135,49,28
22400388,3,28,-2.0,-4.285714285714286,28,0
22400388,4,125,-1.0,-0.48,720,595
22400388,4,93,1.0,0.6451612903225807,576,483
22400388,4,65,-4.0,-3.6923076923076925,483,418
22400388,4,60,-2.0,-2.0,404,344
22400388,4,83,-2.0,-1.4457831325301205,342,259
22400388,4,18,0.0,0.0,241,223
22400388,4,61,2.0,1.9672131147540985,221,160
22400388,4,133,3.0,1.3533834586466165,160,27
22400388,4,6,0.0,0.0,22,16
22400388,4,13,-1.0,-4.615384615384616,13,0
22400389,1,334,-1.0,-0.17964071856287425,720,386
22400389,1,34,0.0,0.0,368,334
22400389,1,6,1.0,10.0,321,315
22400389,1,198,4.0,1.2121212121212122,315,117
22400389,1,92,-4.0,-2.608695652173913,92,0
22400389,2,133,6.0,2.706766917293233,720,587
22400389,2,51,-3.0,-3.5294117647058822,587,536
22400389,2,35,-2.0,-3.4285714285714284,536,501
22400389,2,35,-2.0,-3.4285714285714284,501,466
22400389,2,31,3.0,5.806451612903226,453,422
22400389,2,90,-7.0,-4.666666666666667,401,311
22400389,2,95,0.0,0.0,296,201
22400389,2,161,-6.0,-2.236024844720497,194,33
22400389,2,15,0.0,0.0,21,6
22400389,3,322,-3.0,-0.5590062111801243,720,398
22400389,3,26,0.0,0.0,280,254
22400389,3,94,-1.0,-0.6382978723404256,246,152
22400389,3,19,0.0,0.0,145,126
22400389,3,126,2.0,0.9523809523809523,126,0
22400389,4,111,-3.0,-1.6216216216216217,720,609
22400389,4,43,-3.0,-4.186046511627907,597,554
22400389,4,40,2.0,3.0,543,503
22400389,4,87,-8.0,-5.517241379310345,487,400
22400389,4,18,0.0,0.0,392,374
22400389,4,42,-1.0,-1.4285714285714284,371,329
22400389,4,38,-2.0,-3.1578947368421053,329,291
22400389,4,271,-2.0,-0.44280442804428044,271,0
22400390,1,425,4.0,0.5647058823529412,720,295
22400390,1,19,0.0,0.0,287,268
22400390,1,20,2.0,6.0,257,237
22400390,1,72,-2.0,-1.6666666666666665,217,145
22400390,1,21,-1.0,-2.8571428571428568,145,124
22400390,1,100,-1.0,-0.6,124,24
22400390,2,247,3.0,0.728744939271255,720,473
22400390,2,101,4.0,2.376237623762376,473,372
22400390,2,138,1.0,0.43478260869565216,360,222
22400390,2,216,-1.0,-0.2777777777777778,222,6
22400390,2,1,0.0,0.0,1,0
22400390,3,385,3.0,0.4675324675324675,720,335
22400390,3,131,3.0,1.3740458015267176,335,204
22400390,3,29,2.0,4.137931034482759,185,156
22400390,3,29,0.0,0.0,143,114
22400390,3,81,-2.0,-1.4814814814814814,110,29
22400390,3,17,0.0,0.0,19,2
22400390,3,487,-2.0,-0.24640657084188913,487,0
22400390,4,163,-6.0,-2.208588957055215,720,557
22400390,4,110,3.0,1.6363636363636362,552,442
22400390,4,51,-2.0,-2.3529411764705883,429,378
22400390,4,101,-6.0,-3.564356435643564,378,277
22400390,4,47,-2.0,-2.5531914893617023,256,209
22400390,4,201,5.0,1.492537313432836,209,8
22400390,5,291,-5.0,-1.0309278350515465,300,9
22400390,5,2,0.0,0.0,5,3
22400391,1,429,-5.0,-0.6993006993006994,720,291
22400391,1,1,0.0,0.0,279,278
22400391,1,22,0.0,0.0,263,241
22400391,1,128,-5.0,-2.34375,241,113
22400391,1,33,-3.0,-5.454545454545455,113,80
22400391,1,63,2.0,1.9047619047619047,63,0
22400391,2,126,-6.0,-2.8571428571428568,720,594
22400391,2,274,-4.0,-0.875912408759124,580,306
22400391,2,121,1.0,0.49586776859504134,299,178
22400391,2,94,-1.0,-0.6382978723404256,178,84
22400391,2,33,1.0,1.8181818181818183,63,30
22400391,2,30,-3.0,-6.0,30,0
22400391,3,133,0.0,0.0,720,587
22400391,3,227,2.0,0.5286343612334802,577,350
22400391,3,13,-1.0,-4.615384615384616,338,325
22400391,3,63,1.0,0.9523809523809523,325,262
22400391,3,10,-1.0,-6.0,262,252
22400391,3,76,6.0,4.7368421052631575,252,176
22400391,3,65,-4.0,-3.6923076923076925,161,96
22400391,3,96,2.0,1.25,96,0
22400391,4,167,-1.0,-0.3592814371257485,720,553
22400391,4,109,-1.0,-0.5504587155963303,536,427
22400391,4,33,2.0,3.6363636363636367,427,394
22400391,4,64,2.0,1.875,380,316
22400391,4,110,2.0,1.0909090909090908,316,206
22400391,4,10,0.0,0.0,194,184
22400391,4,146,4.0,1.643835616438356,169,23
22400392,1,320,9.0,1.6875,720,400
22400392,1,103,-4.0,-2.3300970873786406,388,285
22400392,1,74,-2.0,-1.6216216216216217,285,211
22400392,1,63,0.0,0.0,207,144
22400392,1,134,4.0,1.791044776119403,134,0
22400392,2,197,-4.0,-1.2182741116751268,720,523
22400392,2,22,-2.0,-5.454545454545455,514,492
22400392,2,8,0.0,0.0,480,472
22400392,2,65,4.0,3.6923076923076925,472,407
22400392,2,131,0.0,0.0,393,262
22400392,2,87,-4.0,-2.7586206896551726,249,162
22400392,2,542,5.0,0.5535055350553506,558,16
22400392,2,16,3.0,11.25,16,0
22400392,3,290,7.0,1.4482758620689655,720,430
22400392,3,143,2.0,0.8391608391608392,430,287
22400392,3,23,-3.0,-7.826086956521739,287,264
22400392,3,116,-1.0,-0.5172413793103449,245,129
22400392,3,112,4.0,2.142857142857143,112,0
22400392,4,180,-5.0,-1.6666666666666665,720,540
22400392,4,12,0.0,0.0,472,460
22400392,4,116,-4.0,-2.0689655172413794,460,344
22400392,4,12,-2.0,-10.0,343,331
22400392,4,87,0.0,0.0,325,238
22400393,1,309,-5.0,-0.9708737864077669,720,411
22400393,1,96,1.0,0.625,411,315
22400393,1,63,1.0,0.9523809523809523,312,249
22400393,1,5,0.0,0.0,228,223
22400393,1,61,-4.0,-3.934426229508197,215,154
22400393,1,125,-4.0,-1.92,144,19
22400393,2,240,0.0,0.0,720,480
22400393,2,97,2.0,1.2371134020618557,467,370
22400393,2,64,-3.0,-2.8125,351,287
22400393,2,69,2.0,1.7391304347826086,287,218
22400393,2,56,2.0,2.142857142857143,210,154
22400393,2,129,-4.0,-1.8604651162790697,144,15
22400393,2,6,0.0,0.0,6,0
22400393,3,299,8.0,1.605351170568562,720,421
22400393,3,28,-2.0,-4.285714285714286,410,382
22400393,3,124,6.0,2.903225806451613,367,243
22400393,3,55,2.0,2.1818181818181817,243,188
22400393,3,69,3.0,2.608695652173913,188,119
22400393,3,119,1.0,0.5042016806722689,119,0
22400393,4,74,3.0,2.4324324324324325,720,646
22400393,4,120,3.0,1.5,636,516
22400393,4,134,-1.0,-0.44776119402985076,503,369
22400393,4,78,1.0,0.7692307692307692,356,278
22400393,4,47,3.0,3.829787234042553,263,216
22400394,1,305,3.0,0.5901639344262296,720,415
22400394,1,82,0.0,0.0,400,318
22400394,1,49,0.0,0.0,318,269
22400394,1,81,3.0,2.2222222222222223,264,183
22400394,1,63,2.0,1.9047619047619047,183,120
22400394,1,105,-6.0,-3.4285714285714284,105,0
22400394,2,96,2.0,1.25,720,624
22400394,2,183,-1.0,-0.32786885245901637,624,441
22400394,2,14,0.0,0.0,410,396
22400394,2,51,-3.0,-3.5294117647058822,383,332
22400394,2,57,0.0,0.0,325,268
22400394,2,74,0.0,0.0,253,179
22400394,3,334,6.0,1.0778443113772456,720,386
22400394,3,6,2.0,20.0,368,362
22400394,3,13,0.0,0.0,362,349
22400394,3,77,-1.0,-0.7792207792207793,340,263
22400394,3,21,0.0,0.0,263,242
22400394,3,12,1.0,5.0,240,228
22400394,3,167,-3.0,-1.0778443113772456,210,43
22400394,4,238,-2.0,-0.5042016806722689,720,482
22400394,4,22,-3.0,-8.181818181818182,477,455
22400394,4,143,-3.0,-1.2587412587412588,452,309
22400394,4,292,4.0,0.821917808219178,292,0
22400395,1,311,9.0,1.7363344051446945,720,409
22400395,1,2,0.0,0.0,399,397
22400395,1,103,-2.0,-1.1650485436893203,397,294
22400395,1,60,3.0,3.0,284,224
22400395,1,51,3.0,3.5294117647058822,206,155
22400395,2,192,-8.0,-2.5,720,528
22400395,2,13,0.0,0.0,516,503
22400395,2,29,-3.0,-6.206896551724138,494,465
22400395,2,96,3.0,1.875,445,349
22400395,2,51,0.0,0.0,330,279
22400395,2,73,-3.0,-2.4657534246575343,259,186
22400395,2,78,1.0,0.7692307692307692,178,100
22400395,2,22,-6.0,-16.363636363636363,100,78
22400395,3,245,4.0,0.979591836734694,720,475
22400395,3,62,-2.0,-1.935483870967742,475,413
22400395,3,11,-1.0,-5.454545454545455,408,397
22400395,3,112,1.0,0.5357142857142857,383,271
22400395,3,4,4.0,60.0,252,248
22400395,3,65,-1.0,-0.9230769230769231,248,183
22400395,3,10,0.0,0.0,175,165
22400395,3,155,-4.0,-1.5483870967741935,155,0
22400395,4,154,5.0,1.9480519480519478,720,566
22400395,4,30,3.0,6.0,566,536
22400395,4,143,2.0,0.8391608391608392,515,372
22400395,4,15,2.0,8.0,363,348
22400395,4,51,0.0,0.0,333,282
22400395,4,29,0.0,0.0,282,253
22400395,4,117,6.0,3.0769230769230766,246,129
22400395,4,7,0.0,0.0,105,98
22400395,4,84,-2.0,-1.4285714285714284,84,0
22400396,1,277,2.0,0.4332129963898917,720,443
22400396,1,171,3.0,1.0526315789473684,443,272
22400396,1,55,2.0,2.1818181818181817,265,210
22400396,1,114,4.0,2.1052631578947367,194,80
22400396,1,58,3.0,3.103448275862069,74,16
22400396,1,3,0.0,0.0,3,0
22400396,2,148,-1.0,-0.40540540540540543,720,572
22400396,2,27,0.0,0.0,572,545
22400396,2,14,-1.0,-4.285714285714286,526,512
22400396,2,14,0.0,0.0,512,498
22400396,2,108,-2.0,-1.1111111111111112,490,382
22400396,2,8,2.0,15.0,367,359
22400396,2,55,1.0,1.0909090909090908,359,304
22400396,2,21,-3.0,-8.571428571428571,289,268
22400396,2,74,1.0,0.8108108108108109,258,184
22400396,2,10,-1.0,-6.0,184,174
22400396,2,170,-6.0,-2.1176470588235294,174,4
22400396,3,294,5.0,1.0204081632653061,720,426
22400396,3,47,-3.0,-3.829787234042553,407,360
22400396,3,45,0.0,0.0,350,305
22400396,3,48,3.0,3.75,293,245
22400396,3,101,-1.0,-0.594059405940594,233,132
22400396,3,55,-2.0,-2.1818181818181817,120,65
22400396,4,216,5.0,1.3888888888888888,720,504
22400396,4,63,0.0,0.0,458,395
22400396,4,26,-2.0,-4.615384615384616,373,347
22400396,4,2,0.0,0.0,326,324
22400396,4,74,4.0,3.2432432432432434,303,229
22400396,4,132,4.0,1.8181818181818183,229,97
22400396,4,81,-3.0,-2.2222222222222223,81,0
22400397,1,317,4.0,0.7570977917981072,720,403
22400397,1,86,-4.0,-2.7906976744186047,368,282
22400397,1,58,6.0,6.206896551724138,282,224
22400397,1,50,-1.0,-1.2,213,163
22400397,1,87,-4.0,-2.7586206896551726,143,56
22400397,1,56,1.0,1.0714285714285714,56,0
22400397,2,63,0.0,0.0,720,657
22400397,2,36,-4.0,-6.666666666666666,650,614
22400397,2,83,3.0,2.1686746987951806,614,531
22400397,2,78,8.0,6.153846153846153,524,446
22400397,2,28,1.0,2.142857142857143,428,400
22400397,2,43,1.0,1.3953488372093024,383,340
22400397,2,78,7.0,5.384615384615385,340,262
22400397,2,140,-1.0,-0.42857142857142855,242,102
22400397,2,102,-1.0,-0.5882352941176471,102,0
22400397,3,318,2.0,0.37735849056603776,720,402
22400397,3,69,3.0,2.608695652173913,399,330
22400397,3,21,-2.0,-5.7142857142857135,330,309
22400397,3,46,4.0,5.217391304347826,309,263
22400397,3,187,1.0,0.32085561497326204,253,66
22400397,3,66,5.0,4.545454545454546,66,0
22400397,4,319,-5.0,-0.9404388714733541,720,401
22400397,4,14,-1.0,-4.285714285714286,401,387
22400397,4,67,1.0,0.8955223880597015,387,320
22400397,4,71,-3.0,-2.535211267605634,320,249
22400397,4,34,-1.0,-1.7647058823529411,235,201
22400397,4,117,-1.0,-0.5128205128205129,201,84
22400397,4,84,-1.0,-0.7142857142857142,84,0
22400398,1,349,-6.0,-1.0315186246418337,720,371
22400398,1,108,-1.0,-0.5555555555555556,358,250
22400398,1,58,0.0,0.0,239,181
22400398,1,24,0.0,0.0,171,147
22400398,1,32,-1.0,-1.875,134,102
22400398,1,102,-6.0,-3.5294117647058822,102,0
22400398,2,85,4.0,2.8235294117647056,720,635
22400398,2,162,1.0,0.37037037037037035,635,473
22400398,2,129,-4.0,-1.8604651162790697,458,329
22400398,2,47,0.0,0.0,314,267
22400398,2,43,3.0,4.186046511627907,263,220
22400398,2,73,2.0,1.643835616438356,220,147
22400398,2,140,3.0,1.2857142857142858,142,2
22400398,3,227,0.0,0.0,720,493
22400398,3,85,-1.0,-0.7058823529411764,477,392
22400398,3,60,2.0,2.0,392,332
22400398,3,79,7.0,5.3164556962025316,328,249
22400398,3,53,-2.0,-2.2641509433962264,249,196
22400398,3,27,-3.0,-6.666666666666666,183,156
22400398,3,141,-3.0,-1.2765957446808511,141,0
22400398,4,186,-2.0,-0.6451612903225807,720,534
22400398,4,33,3.0,5.454545454545455,522,489
22400398,4,49,-2.0,-2.4489795918367343,513,464
22400398,4,114,0.0,0.0,464,350
22400398,4,82,-2.0,-1.4634146341463414,334,252
22400398,4,24,0.0,0.0,242,218
22400398,4,86,4.0,2.7906976744186047,86,0
22400399,1,364,0.0,0.0,720,356
22400399,1,67,-2.0,-1.791044776119403,356,289
22400399,1,38,2.0,3.1578947368421053,283,245
22400399,1,62,-3.0,-2.903225806451613,245,183
22400399,2,60,3.0,3.0,720,660
22400399,2,121,-1.0,-0.49586776859504134,660,539
22400399,2,73,-3.0,-2.4657534246575343,539,466
22400399,2,12,0.0,0.0,459,447
22400399,2,16,0.0,0.0,441,425
22400399,2,78,-3.0,-2.307692307692308,415,337
22400399,2,71,2.0,1.6901408450704225,327,256
22400399,2,116,5.0,2.586206896551724,241,125
22400399,3,207,0.0,0.0,720,513
22400399,3,50,-6.0,-7.199999999999999,507,457
22400399,3,93,-3.0,-1.935483870967742,442,349
22400399,3,59,-2.0,-2.0338983050847457,349,290
22400399,3,70,2.0,1.7142857142857142,284,214
22400399,3,35,-2.0,-3.4285714285714284,214,179
22400399,3,27,-1.0,-2.2222222222222223,179,152
22400399,3,23,-2.0,-5.217391304347826,152,129
22400399,3,37,-1.0,-1.6216216216216217,129,92
22400399,3,88,3.0,2.0454545454545454,88,0
22400399,4,69,-3.0,-2.608695652173913,720,651
22400399,4,235,-4.0,-1.0212765957446808,644,409
22400399,4,26,1.0,2.307692307692308,397,371
22400399,4,30,3.0,6.0,371,341
22400399,4,145,-2.0,-0.8275862068965517,326,181
22400399,4,151,1.0,0.3973509933774834,169,18
22400399,4,15,-2.0,-8.0,15,0
22400400,1,403,-8.0,-1.1910669975186103,720,317
22400400,1,35,0.0,0.0,301,266
22400400,1,54,-3.0,-3.333333333333333,259,205
22400400,1,33,2.0,3.6363636363636367,194,161
22400400,1,57,2.0,2.1052631578947367,144,87
22400400,1,87,1.0,0.6896551724137931,87,0
22400400,2,139,4.0,1.7266187050359714,720,581
22400400,2,51,3.0,3.5294117647058822,581,530
22400400,2,113,-2.0,-1.0619469026548671,508,395
22400400,2,28,4.0,8.571428571428571,395,367
22400400,2,43,0.0,0.0,356,313
22400400,2,99,0.0,0.0,313,214
22400400,2,24,1.0,2.5,214,190
22400400,2,16,0.0,0.0,190,174
22400400,2,174,-3.0,-1.0344827586206897,174,0
22400400,3,283,1.0,0.21201413427561838,720,437
22400400,3,36,2.0,3.333333333333333,422,386
22400400,3,7,1.0,8.571428571428571,379,372
22400400,3,7,0.0,0.0,372,365
22400400,3,42,-4.0,-5.7142857142857135,359,317
22400400,3,97,3.0,1.8556701030927836,317,220
22400400,3,40,-4.0,-6.0,208,168
22400400,3,74,3.0,2.4324324324324325,168,94
22400400,3,37,0.0,0.0,87,50
22400400,3,38,0.0,0.0,48,10
22400400,3,2,0.0,0.0,2,0
22400400,4,66,5.0,4.545454545454546,720,654
22400400,4,114,3.0,1.5789473684210527,647,533
22400400,4,96,4.0,2.5,516,420
22400400,4,12,0.0,0.0,420,408
22400400,4,202,-2.0,-0.594059405940594,403,201
22400400,4,12,1.0,5.0,191,179
22400400,4,2,0.0,0.0,179,177
22400400,4,69,0.0,0.0,164,95
22400400,4,84,1.0,0.7142857142857142,84,0
22400401,1,282,-2.0,-0.425531914893617,720,438
22400401,1,10,2.0,12.0,426,416
22400401,1,16,0.0,0.0,416,400
22400401,1,10,-1.0,-6.0,395,385
22400401,1,47,1.0,1.2765957446808511,385,338
22400401,1,88,1.0,0.6818181818181819,338,250
22400401,1,92,1.0,0.6521739130434783,250,158
22400401,1,111,-2.0,-1.0810810810810811,146,35
22400401,1,35,-5.0,-8.571428571428571,35,0
22400401,2,58,4.0,4.137931034482759,720,662
22400401,2,80,2.0,1.5,662,582
22400401,2,83,1.0,0.7228915662650602,558,475
22400401,2,10,1.0,6.0,463,453
22400401,2,58,2.0,2.0689655172413794,453,395
22400401,2,49,0.0,0.0,395,346
22400401,2,74,-5.0,-4.054054054054054,335,261
22400401,2,87,2.0,1.3793103448275863,261,174
22400401,2,139,1.0,0.43165467625899284,174,35
22400401,2,35,1.0,1.7142857142857142,35,0
22400401,3,259,6.0,1.3899613899613898,720,461
22400401,3,68,0.0,0.0,452,384
22400401,3,61,-2.0,-1.9672131147540985,377,316
22400401,3,85,7.0,4.9411764705882355,314,229
22400401,3,57,3.0,3.1578947368421053,229,172
22400401,3,172,2.0,0.6976744186046512,172,0
22400401,4,90,0.0,0.0,720,630
22400401,4,75,3.0,2.4,630,555
22400401,4,71,1.0,0.8450704225352113,549,478
22400401,4,136,-1.0,-0.4411764705882353,472,336
22400401,4,43,-1.0,-1.3953488372093024,328,285
22400401,4,285,-2.0,-0.4210526315789474,285,0
22400402,1,264,0.0,0.0,720,456
22400402,1,53,-1.0,-1.1320754716981132,451,398
22400402,1,95,2.0,1.263157894736842,385,290
22400402,1,70,-2.0,-1.7142857142857142,290,220
22400402,1,87,2.0,1.3793103448275863,207,120
22400402,1,105,6.0,3.4285714285714284,111,6
22400402,1,2,-1.0,-30.0,2,0
22400402,2,198,1.0,0.30303030303030304,720,522
22400402,2,87,1.0,0.6896551724137931,511,424
22400402,2,67,2.0,1.791044776119403,418,351
22400402,2,1,0.0,0.0,340,339
22400402,2,83,0.0,0.0,318,235
22400402,2,24,-2.0,-5.0,221,197
22400402,2,70,-4.0,-3.4285714285714284,188,118
22400402,2,95,-1.0,-0.631578947368421,104,9
22400402,2,6,1.0,10.0,9,3
22400402,2,11,1.0,5.454545454545455,197,186
22400402,3,338,11.0,1.952662721893491,720,382
22400402,3,81,8.0,5.925925925925926,367,286
22400402,3,67,-4.0,-3.582089552238806,272,205
22400402,3,41,2.0,2.926829268292683,189,148
22400402,3,26,-3.0,-6.923076923076923,109,83
22400402,3,76,3.0,2.3684210526315788,76,0
22400402,4,244,0.0,0.0,720,476
22400402,4,57,3.0,3.1578947368421053,462,405
22400402,4,96,0.0,0.0,392,296
22400402,4,28,3.0,6.428571428571428,272,244
22400402,4,61,0.0,0.0,226,165
22400402,4,157,2.0,0.7643312101910829,157,0
22400403,1,310,-7.0,-1.3548387096774193,720,410
22400403,1,2,-2.0,-60.0,405,403
22400403,1,83,-1.0,-0.7228915662650602,388,305
22400403,1,29,3.0,6.206896551724138,286,257
22400403,1,86,-1.0,-0.6976744186046512,257,171
22400403,1,160,4.0,1.5,160,0
22400403,2,97,5.0,3.092783505154639,720,623
22400403,2,16,1.0,3.75,607,591
22400403,2,62,5.0,4.838709677419355,591,529
22400403,2,60,0.0,0.0,515,455
22400403,2,54,-3.0,-3.333333333333333,449,395
22400403,2,94,-2.0,-1.2765957446808511,388,294
22400403,2,93,-4.0,-2.580645161290323,285,192
22400403,2,29,0.0,0.0,181,152
22400403,2,152,-9.0,-3.552631578947368,152,0
22400403,3,116,0.0,0.0,720,604
22400403,3,97,5.0,3.092783505154639,577,480
22400403,3,56,-2.0,-2.142857142857143,468,412
22400403,3,91,0.0,0.0,412,321
22400403,3,61,0.0,0.0,301,240
22400403,3,177,-4.0,-1.3559322033898304,238,61
22400403,3,55,5.0,5.454545454545455,61,6
22400403,4,153,5.0,1.9607843137254903,720,567
22400403,4,56,0.0,0.0,551,495
22400403,4,91,1.0,0.6593406593406594,480,389
22400403,4,13,0.0,0.0,389,376
22400403,4,87,0.0,0.0,370,283
22400403,4,39,0.0,0.0,269,230
22400403,4,72,-2.0,-1.6666666666666665,225,153
22400403,4,132,-2.0,-0.9090909090909092,142,10
22400403,4,2,-1.0,-30.0,10,8
22400403,4,7,0.0,0.0,7,0
22400404,1,329,9.0,1.6413373860182372,720,391
22400404,1,39,0.0,0.0,382,343
22400404,1,68,-2.0,-1.7647058823529411,333,265
22400404,1,65,-2.0,-1.8461538461538463,265,200
22400404,1,100,-1.0,-0.6,179,79
22400404,1,61,-2.0,-1.9672131147540985,67,6
22400404,2,75,-3.0,-2.4,720,645
22400404,2,118,0.0,0.0,645,527
22400404,2,43,-1.0,-1.3953488372093024,515,472
22400404,2,73,0.0,0.0,472,399
22400404,2,58,2.0,2.0689655172413794,394,336
22400404,2,103,1.0,0.5825242718446602,327,224
22400404,2,53,4.0,4.528301886792453,216,163
22400404,2,158,3.0,1.139240506329114,163,5
22400404,3,277,1.0,0.21660649819494585,720,443
22400404,3,72,0.0,0.0,424,352
22400404,3,38,-4.0,-6.315789473684211,337,299
22400404,3,28,0.0,0.0,299,271
22400404,3,199,1.0,0.30150753768844224,257,58
22400404,3,51,2.0,2.3529411764705883,58,7
22400404,3,4,-2.0,-30.0,4,0
22400404,4,126,-5.0,-2.380952380952381,720,594
22400404,4,97,-4.0,-2.4742268041237114,580,483
22400404,4,57,3.0,3.1578947368421053,471,414
22400404,4,13,0.0,0.0,414,401
22400404,4,111,-4.0,-2.1621621621621623,387,276
22400404,4,156,4.0,1.5384615384615383,262,106
22400404,4,22,0.0,0.0,106,84
22400404,4,43,2.0,2.7906976744186047,71,28
22400404,4,2,0.0,0.0,5,3
22400404,4,2,0.0,0.0,2,0
22400405,1,412,-4.0,-0.5825242718446602,720,308
22400405,1,137,2.0,0.875912408759124,284,147
22400405,1,23,0.0,0.0,141,118
22400405,1,111,-1.0,-0.5405405405405406,118,7
22400405,1,7,0.0,0.0,7,0
22400405,2,180,-8.0,-2.666666666666667,720,540
22400405,2,89,3.0,2.0224719101123596,524,435
22400405,2,19,-1.0,-3.1578947368421053,416,397
22400405,2,52,0.0,0.0,397,345
22400405,2,71,5.0,4.225352112676057,345,274
22400405,2,127,-3.0,-1.4173228346456692,259,132
22400405,2,115,-5.0,-2.608695652173913,115,0
22400405,3,412,8.0,1.1650485436893203,720,308
22400405,3,107,-4.0,-2.2429906542056073,308,201
22400405,3,78,6.0,4.615384615384616,121,43
22400405,4,147,-7.0,-2.8571428571428568,720,573
22400405,4,61,-1.0,-0.9836065573770493,558,497
22400405,4,58,-2.0,-2.0689655172413794,494,436
22400405,4,42,3.0,4.285714285714286,436,394
22400405,4,75,3.0,2.4,391,316
22400405,4,164,4.0,1.4634146341463414,301,137
22400405,4,99,2.0,1.2121212121212122,137,38
22400405,4,21,0.0,0.0,21,0
22400406,1,259,4.0,0.9266409266409267,720,461
22400406,1,87,1.0,0.6896551724137931,454,367
22400406,1,97,1.0,0.6185567010309279,346,249
22400406,1,49,0.0,0.0,239,190
22400406,1,56,3.0,3.214285714285714,179,123
22400406,1,109,-4.0,-2.2018348623853212,109,0
22400406,2,185,-2.0,-0.6486486486486487,720,535
22400406,2,62,0.0,0.0,518,456
22400406,2,61,-1.0,-0.9836065573770493,442,381
22400406,2,33,3.0,5.454545454545455,366,333
22400406,2,81,-1.0,-0.7407407407407407,269,188
22400406,2,37,-3.0,-4.864864864864865,188,151
22400406,2,35,-1.0,-1.7142857142857142,135,100
22400406,2,70,-3.0,-2.5714285714285716,100,30
22400406,2,30,0.0,0.0,30,0
22400406,3,218,-1.0,-0.27522935779816515,720,502
22400406,3,49,-2.0,-2.4489795918367343,485,436
22400406,3,170,-4.0,-1.4117647058823528,425,255
22400406,3,238,-2.0,-0.5042016806722689,242,4
22400406,3,4,0.0,0.0,4,0
22400406,4,45,5.0,6.666666666666666,720,675
22400406,4,71,1.0,0.8450704225352113,675,604
22400406,4,87,1.0,0.6896551724137931,588,501
22400406,4,66,-2.0,-1.8181818181818183,494,428
22400406,4,58,0.0,0.0,419,361
22400406,4,21,0.0,0.0,353,332
22400406,4,74,0.0,0.0,322,248
22400406,4,186,7.0,2.2580645161290325,234,48
22400406,4,18,-2.0,-6.666666666666666,36,18
22400406,4,14,-2.0,-8.571428571428571,18,4
22400407,1,334,-6.0,-1.0778443113772456,720,386
22400407,1,228,-1.0,-0.2631578947368421,495,267
22400407,1,39,-2.0,-3.0769230769230766,267,228
22400407,1,39,-2.0,-3.0769230769230766,228,189
22400407,1,67,4.0,3.582089552238806,172,105
22400407,1,33,-2.0,-3.6363636363636367,88,55
22400407,1,41,-2.0,-2.926829268292683,41,0
22400407,2,194,0.0,0.0,720,526
22400407,2,127,-6.0,-2.8346456692913384,526,399
22400407,2,40,-2.0,-3.0,391,351
22400407,2,65,2.0,1.8461538461538463,342,277
22400407,2,243,5.0,1.2345679012345678,277,34
22400407,2,14,-3.0,-12.857142857142856,14,0
22400407,3,322,5.0,0.9316770186335404,720,398
22400407,3,96,1.0,0.625,383,287
22400407,3,54,4.0,4.444444444444445,271,217
22400407,3,28,2.0,4.285714285714286,204,176
22400407,3,146,-1.0,-0.410958904109589,176,30
22400407,3,30,0.0,0.0,30,0
22400407,4,128,-8.0,-3.75,720,592
22400407,4,104,-5.0,-2.8846153846153846,575,471
22400407,4,17,0.0,0.0,465,448
22400407,4,46,-1.0,-1.3043478260869565,442,396
22400407,4,99,2.0,1.2121212121212122,386,287
22400407,4,229,9.0,2.3580786026200875,269,40
22400407,4,11,1.0,5.454545454545455,17,6
22400407,4,6,1.0,10.0,6,0
22400408,1,373,-1.0,-0.16085790884718498,720,347
22400408,1,43,3.0,4.186046511627907,331,288
22400408,1,126,0.0,0.0,272,146
22400408,1,121,0.0,0.0,121,0
22400408,2,142,-3.0,-1.267605633802817,720,578
22400408,2,95,-3.0,-1.8947368421052633,578,483
22400408,2,47,0.0,0.0,481,434
22400408,2,9,-2.0,-13.333333333333332,423,414
22400408,2,66,1.0,0.9090909090909092,401,335
22400408,2,90,0.0,0.0,320,230
22400408,2,54,2.0,2.2222222222222223,215,161
22400408,2,159,1.0,0.37735849056603776,159,0
22400408,3,287,0.0,0.0,720,433
22400408,3,92,0.0,0.0,410,318
22400408,3,47,-2.0,-2.5531914893617023,318,271
22400408,3,29,-3.0,-6.206896551724138,259,230
22400408,3,77,1.0,0.7792207792207793,218,141
22400408,3,35,0.0,0.0,130,95
22400408,3,87,0.0,0.0,87,0
22400408,4,153,3.0,1.1764705882352942,720,567
22400408,4,105,-1.0,-0.5714285714285715,557,452
22400408,4,40,1.0,1.5,452,412
22400408,4,41,0.0,0.0,412,371
22400408,4,63,3.0,2.8571428571428568,361,298
22400408,4,70,-5.0,-4.285714285714286,298,228
22400408,4,198,4.0,1.2121212121212122,220,22
22400408,4,4,-1.0,-15.0,12,8
22400408,4,1,0.0,0.0,7,6
22400408,4,1,0.0,0.0,1,0
22400409,1,339,7.0,1.238938053097345,720,381
22400409,1,90,-3.0,-2.0,373,283
22400409,1,30,2.0,4.0,283,253
22400409,1,41,-1.0,-1.4634146341463414,253,212
22400409,1,42,3.0,4.285714285714286,207,165
22400409,1,149,-1.0,-0.40268456375838924,149,0
22400409,2,111,4.0,2.1621621621621623,720,609
22400409,2,95,3.0,1.8947368421052633,597,502
22400409,2,104,-3.0,-1.7307692307692308,492,388
22400409,2,128,0.0,0.0,376,248
22400409,2,48,-5.0,-6.25,236,188
22400409,2,109,-1.0,-0.5504587155963303,179,70
22400409,3,200,0.0,0.0,720,520
22400409,3,195,1.0,0.3076923076923077,505,310
22400409,3,104,1.0,0.576923076923077,296,192
22400409,3,177,3.0,1.0169491525423728,177,0
22400409,4,159,-1.0,-0.37735849056603776,720,561
22400409,4,121,7.0,3.4710743801652892,561,440
22400409,4,113,2.0,1.0619469026548671,429,316
22400409,4,106,-3.0,-1.6981132075471699,316,210
22400410,1,83,2.0,1.4457831325301205,720,637
22400410,1,246,4.0,0.9756097560975611,622,376
22400410,1,54,2.0,2.2222222222222223,376,322
22400410,1,54,5.0,5.555555555555555,308,254
22400410,1,24,0.0,0.0,234,210
22400410,1,99,-4.0,-2.4242424242424243,204,105
22400410,1,105,0.0,0.0,105,0
22400410,2,208,-5.0,-1.4423076923076923,720,512
22400410,2,126,3.0,1.4285714285714284,497,371
22400410,2,1,0.0,0.0,366,365
22400410,2,75,-3.0,-2.4,348,273
22400410,2,87,-3.0,-2.0689655172413794,273,186
22400410,2,64,3.0,2.8125,186,122
22400410,2,122,-1.0,-0.49180327868852464,122,0
22400410,3,365,-1.0,-0.1643835616438356,720,355
22400410,3,86,1.0,0.6976744186046512,335,249
22400410,3,126,-3.0,-1.4285714285714284,229,103
22400410,3,29,-2.0,-4.137931034482759,92,63
22400410,4,229,1.0,0.26200873362445415,720,491
22400410,4,56,2.0,2.142857142857143,468,412
22400410,4,376,-10.0,-1.5957446808510638,412,36
22400410,4,15,-1.0,-4.0,36,21
22400410,4,21,3.0,8.571428571428571,21,0
22400411,1,250,12.0,2.88,720,470
22400411,1,18,0.0,0.0,454,436
22400411,1,77,2.0,1.5584415584415585,425,348
22400411,1,33,-2.0,-3.6363636363636367,336,303
22400411,1,76,-2.0,-1.5789473684210527,303,227
22400411,1,67,-2.0,-1.791044776119403,227,160
22400411,1,73,1.0,0.821917808219178,152,79
22400411,1,67,-3.0,-2.6865671641791042,67,0
22400411,2,114,2.0,1.0526315789473684,720,606
22400411,2,52,3.0,3.4615384615384617,595,543
22400411,2,51,0.0,0.0,523,472
22400411,2,27,2.0,4.444444444444445,461,434
22400411,2,55,0.0,0.0,426,371
22400411,2,100,-1.0,-0.6,358,258
22400411,2,93,2.0,1.2903225806451615,249,156
22400411,2,121,4.0,1.9834710743801653,141,20
22400411,2,20,0.0,0.0,20,0
22400411,3,398,-1.0,-0.15075376884422112,720,322
22400411,3,105,-2.0,-1.142857142857143,297,192
22400411,3,36,2.0,3.333333333333333,192,156
22400411,3,41,-1.0,-1.4634146341463414,153,112
22400411,3,28,1.0,2.142857142857143,112,84
22400411,3,84,0.0,0.0,84,0
22400411,4,92,-3.0,-1.9565217391304348,720,628
22400411,4,97,-4.0,-2.4742268041237114,609,512
22400411,4,64,-2.0,-1.875,509,445
22400411,4,126,2.0,0.9523809523809523,429,303
22400411,4,291,3.0,0.6185567010309279,295,4
22400412,1,331,3.0,0.5438066465256798,720,389
22400412,1,69,0.0,0.0,389,320
22400412,1,15,0.0,0.0,320,305
22400412,1,122,0.0,0.0,292,170
22400412,1,87,5.0,3.4482758620689653,170,83
22400412,1,83,-4.0,-2.891566265060241,83,0
22400412,2,132,4.0,1.8181818181818183,720,588
22400412,2,30,2.0,4.0,573,543
22400412,2,4,0.0,0.0,527,523
22400412,2,68,-2.0,-1.7647058823529411,518,450
22400412,2,152,4.0,1.5789473684210527,450,298
22400412,2,102,2.0,1.1764705882352942,282,180
22400412,2,57,4.0,4.2105263157894735,173,116
22400412,2,67,-2.0,-1.791044776119403,116,49
22400412,2,30,-3.0,-6.0,44,14
22400412,2,14,0.0,0.0,14,0
22400412,3,324,-6.0,-1.1111111111111112,720,396
22400412,3,27,0.0,0.0,396,369
22400412,3,38,5.0,7.894736842105263,363,325
22400412,3,141,0.0,0.0,315,174
22400412,3,169,-1.0,-0.35502958579881655,169,0
22400412,4,252,-8.0,-1.9047619047619047,720,468
22400412,4,121,-2.0,-0.9917355371900827,462,341
22400412,4,12,0.0,0.0,323,311
22400412,4,261,3.0,0.6896551724137931,299,38
22400412,4,24,2.0,5.0,38,14
22400412,4,2,-2.0,-60.0,14,12
22400412,4,30,3.0,6.0,38,8
22400412,4,5,1.0,12.0,6,1
22400412,4,1,0.0,0.0,1,0
22400413,1,217,5.0,1.3824884792626728,720,503
22400413,1,94,-6.0,-3.829787234042553,488,394
22400413,1,84,-3.0,-2.142857142857143,394,310
22400413,1,94,-2.0,-1.2765957446808511,298,204
22400413,1,126,-2.0,-0.9523809523809523,192,66
22400413,2,141,-1.0,-0.425531914893617,720,579
22400413,2,95,1.0,0.631578947368421,572,477
22400413,2,30,-2.0,-4.0,477,447
22400413,2,1,0.0,0.0,424,423
22400413,2,120,6.0,3.0,407,287
22400413,2,104,-2.0,-1.153846153846154,287,183
22400413,2,175,-3.0,-1.0285714285714287,175,0
22400413,3,171,1.0,0.3508771929824561,720,549
22400413,3,168,-1.0,-0.3571428571428571,549,381
22400413,3,15,1.0,4.0,373,358
22400413,3,94,5.0,3.1914893617021276,358,264
22400413,3,51,0.0,0.0,245,194
22400413,3,21,-1.0,-2.8571428571428568,189,168
22400413,3,168,-4.0,-1.4285714285714284,168,0
22400413,4,174,3.0,1.0344827586206897,720,546
22400413,4,44,-3.0,-4.090909090909091,546,502
22400413,4,12,1.0,5.0,487,475
22400413,4,24,0.0,0.0,475,451
22400413,4,61,-2.0,-1.9672131147540985,441,380
22400413,4,79,2.0,1.5189873417721518,380,301
22400414,1,289,8.0,1.6608996539792389,720,431
22400414,1,67,1.0,0.8955223880597015,421,354
22400414,1,32,2.0,3.75,343,311
22400414,1,33,1.0,1.8181818181818183,309,276
22400414,1,43,0.0,0.0,266,223
22400414,1,190,-3.0,-0.9473684210526316,223,33
22400414,1,33,-5.0,-9.090909090909092,33,0
22400414,2,178,4.0,1.348314606741573,720,542
22400414,2,23,0.0,0.0,519,496
22400414,2,75,-3.0,-2.4,487,412
22400414,2,21,-2.0,-5.7142857142857135,403,382
22400414,2,21,-2.0,-5.7142857142857135,380,359
22400414,2,107,5.0,2.803738317757009,354,247
22400414,2,41,-4.0,-5.853658536585366,245,204
22400414,2,97,1.0,0.6185567010309279,204,107
22400414,2,99,4.0,2.4242424242424243,99,0
22400414,3,384,5.0,0.78125,720,336
22400414,3,19,2.0,6.315789473684211,336,317
22400414,3,52,0.0,0.0,311,259
22400414,3,34,3.0,5.294117647058824,250,216
22400414,3,55,-3.0,-3.2727272727272725,211,156
22400414,3,101,4.0,2.376237623762376,139,38
22400414,4,9,0.0,0.0,720,711
22400414,4,188,6.0,1.9148936170212765,700,512
22400414,4,43,5.0,6.976744186046512,506,463
22400414,4,122,-4.0,-1.9672131147540985,449,327
22400414,4,35,2.0,3.4285714285714284,327,292
22400414,4,116,2.0,1.0344827586206897,292,176
22400414,4,165,0.0,0.0,165,0
22400415,1,222,4.0,1.0810810810810811,720,498
22400415,1,196,-4.0,-1.2244897959183672,498,302
22400415,1,26,2.0,4.615384615384616,302,276
22400415,1,75,1.0,0.8,259,184
22400415,1,151,1.0,0.3973509933774834,184,33
22400415,1,33,0.0,0.0,33,0
22400415,2,257,9.0,2.1011673151750974,720,463
22400415,2,19,0.0,0.0,457,438
22400415,2,44,6.0,8.181818181818182,433,389
22400415,2,41,-2.0,-2.926829268292683,365,324
22400415,2,122,0.0,0.0,324,202
22400415,2,73,4.0,3.287671232876712,185,112
22400415,2,94,-4.0,-2.5531914893617023,97,3
22400415,2,3,0.0,0.0,3,0
22400415,3,337,1.0,0.17804154302670624,720,383
22400415,3,19,-1.0,-3.1578947368421053,356,337
22400415,3,25,0.0,0.0,337,312
22400415,3,93,2.0,1.2903225806451615,311,218
22400415,3,198,0.0,0.0,202,4
22400415,3,3,0.0,0.0,4,1
22400415,3,1,0.0,0.0,1,0
22400415,4,270,-2.0,-0.4444444444444445,720,450
22400415,4,24,-3.0,-7.5,450,426
22400415,4,55,1.0,1.0909090909090908,410,355
22400415,4,41,0.0,0.0,355,314
22400415,4,145,-7.0,-2.896551724137931,303,158
22400415,4,19,-1.0,-3.1578947368421053,158,139
22400415,4,70,-4.0,-3.4285714285714284,117,47
22400415,4,6,3.0,30.0,46,40
22400415,4,33,-2.0,-3.6363636363636367,33,0
22400416,1,367,0.0,0.0,720,353
22400416,1,15,-2.0,-8.0,337,322
22400416,1,76,0.0,0.0,322,246
22400416,1,5,0.0,0.0,236,231
22400416,1,38,-1.0,-1.5789473684210527,220,182
22400416,1,66,-1.0,-0.9090909090909092,182,116
22400416,1,10,0.0,0.0,116,106
22400416,1,91,-5.0,-3.2967032967032965,94,3
22400416,2,243,-4.0,-0.9876543209876544,720,477
22400416,2,128,3.0,1.40625,464,336
22400416,2,39,-2.0,-3.0769230769230766,316,277
22400416,2,41,3.0,4.390243902439024,267,226
22400416,2,115,2.0,1.0434782608695652,224,109
22400416,3,407,1.0,0.14742014742014742,720,313
22400416,3,109,-2.0,-1.1009174311926606,298,189
22400416,3,60,-2.0,-2.0,189,129
22400416,3,39,-4.0,-6.153846153846153,115,76
22400416,4,186,0.0,0.0,720,534
22400416,4,527,8.0,0.9108159392789374,527,0
22400417,1,335,-1.0,-0.1791044776119403,720,385
22400417,1,101,2.0,1.188118811881188,372,271
22400417,1,46,1.0,1.3043478260869565,265,219
22400417,1,124,0.0,0.0,219,95
22400417,1,95,0.0,0.0,95,0
22400417,2,181,-1.0,-0.3314917127071823,720,539
22400417,2,76,-4.0,-3.1578947368421053,524,448
22400417,2,40,2.0,3.0,368,328
22400417,2,103,0.0,0.0,328,225
22400417,2,26,-1.0,-2.307692307692308,214,188
22400417,2,188,6.0,1.9148936170212765,188,0
22400417,3,219,-15.0,-4.10958904109589,720,501
22400417,3,77,5.0,3.8961038961038956,501,424
22400417,3,53,-1.0,-1.1320754716981132,424,371
22400417,3,175,2.0,0.6857142857142857,371,196
22400417,3,17,-2.0,-7.0588235294117645,195,178
22400417,3,115,2.0,1.0434782608695652,178,63
22400417,3,63,1.0,0.9523809523809523,63,0
22400417,4,95,-2.0,-1.263157894736842,720,625
22400417,4,260,7.0,1.6153846153846154,625,365
22400417,4,24,1.0,2.5,353,329
22400417,4,103,3.0,1.7475728155339807,329,226
22400417,4,186,5.0,1.6129032258064517,226,40
22400417,4,11,0.0,0.0,40,29
22400417,4,14,-1.0,-4.285714285714286,14,0
22400418,1,205,1.0,0.2926829268292683,720,515
22400418,1,158,-2.0,-0.7594936708860759,515,357
22400418,1,49,5.0,6.122448979591837,334,285
22400418,1,78,-2.0,-1.5384615384615383,279,201
22400418,1,41,-5.0,-7.317073170731707,201,160
22400418,1,45,-2.0,-2.666666666666667,145,100
22400418,1,59,0.0,0.0,90,31
22400418,1,26,0.0,0.0,31,5
22400418,2,168,7.0,2.5,720,552
22400418,2,62,3.0,2.903225806451613,552,490
22400418,2,52,0.0,0.0,484,432
22400418,2,20,1.0,3.0,404,384
22400418,2,177,-8.0,-2.711864406779661,384,207
22400418,2,207,8.0,2.318840579710145,207,0
22400418,3,173,3.0,1.0404624277456647,720,547
22400418,3,111,0.0,0.0,537,426
22400418,3,14,-1.0,-4.285714285714286,422,408
22400418,3,59,-2.0,-2.0338983050847457,391,332
22400418,3,65,3.0,2.769230769230769,315,250
22400418,3,30,-1.0,-2.0,235,205
22400418,3,40,2.0,3.0,205,165
22400418,3,20,-1.0,-3.0,165,145
22400418,3,41,3.0,4.390243902439024,145,104
22400418,3,83,-6.0,-4.337349397590361,104,21
22400418,3,20,0.0,0.0,21,1
22400418,4,165,-2.0,-0.7272727272727273,720,555
22400418,4,44,1.0,1.3636363636363638,544,500
22400418,4,61,-3.0,-2.9508196721311473,492,431
22400418,4,15,0.0,0.0,408,393
22400418,4,24,-1.0,-2.5,378,354
22400418,4,71,1.0,0.8450704225352113,354,283
22400418,4,108,1.0,0.5555555555555556,274,166
22400418,4,127,-6.0,-2.8346456692913384,161,34
22400418,4,1,0.0,0.0,19,18
22400418,4,4,1.0,15.0,14,10
22400418,4,3,0.0,0.0,3,0
22400419,1,407,2.0,0.29484029484029484,720,313
22400419,1,125,0.0,0.0,308,183
22400419,1,112,2.0,1.0714285714285714,172,60
22400419,1,36,1.0,1.6666666666666665,54,18
22400419,2,72,0.0,0.0,720,648
22400419,2,105,0.0,0.0,637,532
22400419,2,17,0.0,0.0,532,515
22400419,2,14,0.0,0.0,515,501
22400419,2,31,-2.0,-3.870967741935484,488,457
22400419,2,49,0.0,0.0,454,405
22400419,2,19,0.0,0.0,405,386
22400419,2,86,-2.0,-1.3953488372093024,386,300
22400419,2,47,2.0,2.5531914893617023,281,234
22400419,2,47,-2.0,-2.5531914893617023,194,147
22400419,2,55,-2.0,-2.1818181818181817,147,92
22400419,2,92,-1.0,-0.6521739130434783,92,0
22400419,3,140,-2.0,-0.8571428571428571,720,580
22400419,3,178,0.0,0.0,561,383
22400419,3,101,-3.0,-1.782178217821782,383,282
22400419,3,96,-2.0,-1.25,282,186
22400419,3,34,-1.0,-1.7647058823529411,173,139
22400419,3,131,1.0,0.4580152671755725,139,8
22400419,3,1,-2.0,-120.0,1,0
22400419,4,89,-7.0,-4.719101123595506,720,631
22400419,4,124,0.0,0.0,613,489
22400419,4,147,0.0,0.0,472,325
22400419,4,53,-4.0,-4.528301886792453,325,272
22400419,4,77,-4.0,-3.116883116883117,263,186
22400419,4,108,1.0,0.5555555555555556,186,78
22400419,4,4,0.0,0.0,38,34
22400420,1,331,0.0,0.0,720,389
22400420,1,129,6.0,2.7906976744186047,383,254
22400420,1,90,4.0,2.666666666666667,233,143
22400420,1,12,2.0,10.0,141,129
22400420,1,28,-2.0,-4.285714285714286,112,84
22400420,1,82,0.0,0.0,84,2
22400420,1,2,0.0,0.0,2,0
22400420,2,111,-3.0,-1.6216216216216217,720,609
22400420,2,129,1.0,0.46511627906976744,596,467
22400420,2,103,3.0,1.7475728155339807,453,350
22400420,2,36,-3.0,-5.0,332,296
22400420,2,53,2.0,2.2641509433962264,286,233
22400420,2,233,5.0,1.2875536480686696,233,0
22400420,3,352,7.0,1.1931818181818181,720,368
22400420,3,86,-1.0,-0.6976744186046512,368,282
22400420,3,142,-2.0,-0.8450704225352113,282,140
22400420,3,92,-1.0,-0.6521739130434783,123,31
22400420,3,10,-2.0,-12.0,10,0
22400420,4,181,5.0,1.6574585635359116,720,539
22400420,4,30,-2.0,-4.0,533,503
22400420,4,35,3.0,5.142857142857143,496,461
22400420,4,79,7.0,5.3164556962025316,461,382
22400420,4,82,2.0,1.4634146341463414,382,300
22400420,4,271,2.0,0.44280442804428044,300,29
22400421,1,304,3.0,0.5921052631578947,720,416
22400421,1,12,0.0,0.0,394,382
22400421,1,136,0.0,0.0,372,236
22400421,1,85,0.0,0.0,219,134
22400421,1,128,1.0,0.46875,128,0
22400421,2,12,-3.0,-15.0,720,708
22400421,2,163,-6.0,-2.208588957055215,708,545
22400421,2,38,-2.0,-3.1578947368421053,545,507
22400421,2,29,0.0,0.0,485,456
22400421,2,47,-1.0,-1.2765957446808511,456,409
22400421,2,49,0.0,0.0,384,335
22400421,2,29,2.0,4.137931034482759,335,306
22400421,2,58,0.0,0.0,306,248
22400421,2,27,0.0,0.0,198,171
22400421,2,159,-3.0,-1.1320754716981132,159,0
22400421,3,317,-8.0,-1.5141955835962144,720,403
22400421,3,297,-3.0,-0.6060606060606061,580,283
22400421,3,163,-1.0,-0.36809815950920244,276,113
22400421,3,94,-3.0,-1.9148936170212765,94,0
22400421,4,168,2.0,0.7142857142857142,720,552
22400421,4,96,-5.0,-3.125,518,422
22400421,4,131,3.0,1.3740458015267176,413,282
22400421,4,27,3.0,6.666666666666666,268,241
22400421,4,86,1.0,0.6976744186046512,241,155
22400421,4,149,1.0,0.40268456375838924,149,0
22400422,1,413,4.0,0.5811138014527846,720,307
22400422,1,53,0.0,0.0,298,245
22400422,1,106,-2.0,-1.1320754716981132,245,139
22400422,1,87,1.0,0.6896551724137931,117,30
22400422,1,30,-2.0,-4.0,30,0
22400422,2,246,-6.0,-1.4634146341463414,720,474
22400422,2,91,0.0,0.0,462,371
22400422,2,67,0.0,0.0,371,304
22400422,2,153,-2.0,-0.7843137254901961,304,151
22400422,2,138,1.0,0.43478260869565216,138,0
22400422,3,270,9.0,2.0,720,450
22400422,3,62,0.0,0.0,441,379
22400422,3,3,0.0,0.0,363,360
22400422,3,28,-1.0,-2.142857142857143,349,321
22400422,3,117,0.0,0.0,321,204
22400422,3,55,1.0,1.0909090909090908,196,141
22400422,3,13,0.0,0.0,134,121
22400422,3,108,6.0,3.333333333333333,108,0
22400422,4,40,-1.0,-1.5,720,680
22400422,4,165,0.0,0.0,680,515
22400422,4,1,0.0,0.0,505,504
22400422,4,89,0.0,0.0,488,399
22400422,4,65,1.0,0.9230769230769231,387,322
22400422,4,228,-14.0,-3.6842105263157894,297,69
22400422,4,69,-4.0,-3.4782608695652173,69,0
22400423,1,306,-4.0,-0.7843137254901961,720,414
22400423,1,120,0.0,0.0,414,294
22400423,1,30,4.0,8.0,294,264
22400423,1,35,0.0,0.0,244,209
22400423,1,38,-4.0,-6.315789473684211,201,163
22400423,1,163,2.0,0.7361963190184049,163,0
22400423,2,23,2.0,5.217391304347826,720,697
22400423,2,78,-10.0,-7.692307692307692,697,619
22400423,2,25,-3.0,-7.199999999999999,508,483
22400423,2,67,4.0,3.582089552238806,473,406
22400423,2,119,1.0,0.5042016806722689,392,273
22400423,2,37,1.0,1.6216216216216217,273,236
22400423,2,37,0.0,0.0,236,199
22400423,2,61,2.0,1.9672131147540985,199,138
22400423,2,138,-10.0,-4.3478260869565215,138,0
22400423,3,55,1.0,1.0909090909090908,720,665
22400423,3,276,-4.0,-0.8695652173913043,665,389
22400423,3,41,-2.0,-2.926829268292683,389,348
22400423,3,13,0.0,0.0,348,335
22400423,3,29,-2.0,-4.137931034482759,335,306
22400423,3,18,1.0,3.333333333333333,306,288
22400423,3,35,2.0,3.4285714285714284,288,253
22400423,3,74,4.0,3.2432432432432434,246,172
22400423,3,24,3.0,7.5,172,148
22400423,3,36,1.0,1.6666666666666665,136,100
22400423,3,73,-6.0,-4.931506849315069,100,27
22400423,3,27,0.0,0.0,27,0
22400423,4,106,-3.0,-1.6981132075471699,720,614
22400423,4,86,1.0,0.6976744186046512,602,516
22400423,4,87,8.0,5.517241379310345,492,405
22400423,4,17,0.0,0.0,389,372
22400423,4,363,3.0,0.49586776859504134,363,0
22400424,1,296,-5.0,-1.0135135135135136,720,424
22400424,1,89,-3.0,-2.0224719101123596,414,325
22400424,1,135,4.0,1.777777777777778,313,178
22400424,1,41,5.0,7.317073170731707,178,137
22400424,1,124,-3.0,-1.4516129032258065,124,0
22400424,2,160,1.0,0.375,720,560
22400424,2,72,-2.0,-1.6666666666666665,560,488
22400424,2,119,-4.0,-2.0168067226890756,488,369
22400424,2,130,-7.0,-3.230769230769231,367,237
22400424,2,20,-3.0,-9.0,237,217
22400424,2,198,-1.0,-0.30303030303030304,199,1
22400424,3,162,2.0,0.7407407407407407,720,558
22400424,3,169,0.0,0.0,558,389
22400424,3,36,0.0,0.0,376,340
22400424,3,90,0.0,0.0,336,246
22400424,3,72,-3.0,-2.5,236,164
22400424,3,155,2.0,0.7741935483870968,155,0
22400424,4,279,0.0,0.0,720,441
22400424,4,9,0.0,0.0,441,432
22400424,4,20,-4.0,-12.0,420,400
22400424,4,211,1.0,0.28436018957345977,391,180
22400424,4,84,0.0,0.0,180,96
22400424,4,86,0.0,0.0,86,0
22400425,1,406,-3.0,-0.44334975369458124,720,314
22400425,1,94,-2.0,-1.2765957446808511,307,213
22400425,1,27,3.0,6.666666666666666,202,175
22400425,1,142,1.0,0.4225352112676056,167,25
22400425,1,2,0.0,0.0,2,0
22400425,2,201,-6.0,-1.791044776119403,720,519
22400425,2,16,0.0,0.0,510,494
22400425,2,59,2.0,2.0338983050847457,493,434
22400425,2,84,3.0,2.142857142857143,434,350
22400425,2,178,-3.0,-1.0112359550561798,350,172
22400425,2,9,0.0,0.0,172,163
22400425,2,137,-5.0,-2.18978102189781,158,21
22400425,2,21,-2.0,-5.7142857142857135,21,0
22400425,3,178,1.0,0.33707865168539325,720,542
22400425,3,85,3.0,2.1176470588235294,523,438
22400425,3,40,2.0,3.0,417,377
22400425,3,224,-4.0,-1.0714285714285714,501,277
22400425,3,86,0.0,0.0,277,191
22400425,3,13,0.0,0.0,177,164
22400425,3,164,6.0,2.195121951219512,164,0
22400425,4,203,-3.0,-0.8866995073891625,720,517
22400425,4,21,2.0,5.7142857142857135,503,482
22400425,4,34,-2.0,-3.5294117647058822,474,440
22400425,4,80,2.0,1.5,419,339
22400425,4,237,0.0,0.0,334,97
22400425,4,45,-3.0,-4.0,97,52
22400425,4,44,0.0,0.0,44,0
22400426,1,351,2.0,0.3418803418803419,720,369
22400426,1,50,0.0,0.0,367,317
22400426,1,88,-3.0,-2.0454545454545454,302,214
22400426,1,201,-5.0,-1.492537313432836,201,0
22400426,2,173,4.0,1.3872832369942196,720,547
22400426,2,67,-4.0,-3.582089552238806,526,459
22400426,2,10,0.0,0.0,409,399
22400426,2,144,-1.0,-0.41666666666666663,388,244
22400426,2,232,2.0,0.5172413793103449,232,0
22400426,3,275,4.0,0.8727272727272727,720,445
22400426,3,39,4.0,6.153846153846153,445,406
22400426,3,127,-2.0,-0.9448818897637795,397,270
22400426,3,17,-2.0,-7.0588235294117645,265,248
22400426,3,36,3.0,5.0,223,187
22400426,3,159,5.0,1.8867924528301887,187,28
22400426,3,28,-2.0,-4.285714285714286,28,0
22400426,4,229,-3.0,-0.7860262008733624,720,491
22400426,4,74,-4.0,-3.2432432432432434,471,397
22400426,4,70,-3.0,-2.5714285714285716,389,319
22400426,4,155,-3.0,-1.1612903225806452,319,164
22400426,4,116,5.0,2.586206896551724,164,48
22400426,4,48,-2.0,-2.5,48,0
22400427,1,319,0.0,0.0,720,401
22400427,1,50,1.0,1.2,390,340
22400427,1,29,-1.0,-2.0689655172413794,334,305
22400427,1,53,-1.0,-1.1320754716981132,305,252
22400427,1,111,8.0,4.324324324324325,252,141
22400427,1,39,0.0,0.0,141,102
22400427,1,102,5.0,2.941176470588235,102,0
22400427,2,52,-2.0,-2.307692307692308,720,668
22400427,2,73,0.0,0.0,668,595
22400427,2,51,3.0,3.5294117647058822,576,525
22400427,2,58,-2.0,-2.0689655172413794,513,455
22400427,2,104,-3.0,-1.7307692307692308,446,342
22400427,2,72,-1.0,-0.8333333333333333,342,270
22400427,2,73,4.0,3.287671232876712,270,197
22400427,2,197,-2.0,-0.6091370558375634,197,0
22400427,3,338,2.0,0.35502958579881655,720,382
22400427,3,59,-2.0,-2.0338983050847457,366,307
22400427,3,20,3.0,9.0,294,274
22400427,3,87,-2.0,-1.3793103448275863,255,168
22400427,3,88,1.0,0.6818181818181819,168,80
22400427,3,75,1.0,0.8,75,0
22400427,4,120,-1.0,-0.5,720,600
22400427,4,79,-4.0,-3.0379746835443036,600,521
22400427,4,29,3.0,6.206896551724138,510,481
22400427,4,61,1.0,0.9836065573770493,461,400
22400427,4,117,-2.0,-1.0256410256410258,400,283
22400427,4,8,0.0,0.0,266,258
22400427,4,247,9.0,2.186234817813765,247,0
22400428,1,404,-6.0,-0.891089108910891,720,316
22400428,1,55,-1.0,-1.0909090909090908,316,261
22400428,1,59,0.0,0.0,261,202
22400428,1,109,3.0,1.651376146788991,191,82
22400428,2,162,-2.0,-0.7407407407407407,720,558
22400428,2,225,2.0,0.5333333333333333,558,333
22400428,2,29,0.0,0.0,333,304
22400428,2,13,1.0,4.615384615384616,304,291
22400428,2,45,-5.0,-6.666666666666666,291,246
22400428,2,29,-2.0,-4.137931034482759,223,194
22400428,2,54,0.0,0.0,192,138
22400428,2,62,2.0,1.935483870967742,125,63
22400428,2,31,1.0,1.935483870967742,50,19
22400428,2,19,-3.0,-9.473684210526315,19,0
22400428,3,321,0.0,0.0,720,399
22400428,3,2,-1.0,-30.0,374,372
22400428,3,14,1.0,4.285714285714286,372,358
22400428,3,99,-1.0,-0.6060606060606061,358,259
22400428,3,30,-1.0,-2.0,259,229
22400428,3,70,0.0,0.0,229,159
22400428,3,143,1.0,0.4195804195804196,143,0
22400428,4,108,5.0,2.7777777777777777,720,612
22400428,4,247,-5.0,-1.214574898785425,592,345
22400428,4,23,0.0,0.0,328,305
22400428,4,9,0.0,0.0,293,284
22400428,4,28,1.0,2.142857142857143,261,233
22400428,4,14,0.0,0.0,233,219
22400428,4,63,5.0,4.761904761904762,208,145
22400428,4,89,-1.0,-0.6741573033707865,145,56
22400428,4,56,0.0,0.0,56,0
22400429,1,343,6.0,1.0495626822157436,720,377
22400429,1,10,-2.0,-12.0,369,359
22400429,1,43,1.0,1.3953488372093024,348,305
22400429,1,31,1.0,1.935483870967742,305,274
22400429,1,83,-1.0,-0.7228915662650602,274,191
22400429,1,146,-4.0,-1.643835616438356,191,45
22400429,1,34,0.0,0.0,34,0
22400429,2,256,-2.0,-0.46875,720,464
22400429,2,73,2.0,1.643835616438356,457,384
22400429,2,246,2.0,0.48780487804878053,366,120
22400429,2,208,1.0,0.2884615384615385,208,0
22400429,3,340,2.0,0.3529411764705882,720,380
22400429,3,56,-3.0,-3.214285714285714,359,303
22400429,3,131,4.0,1.83206106870229,303,172
22400429,3,157,6.0,2.2929936305732483,157,0
22400429,4,83,-3.0,-2.1686746987951806,720,637
22400429,4,172,-3.0,-1.0465116279069768,618,446
22400429,4,307,1.0,0.19543973941368079,439,132
22400429,4,122,-1.0,-0.49180327868852464,132,10
22400429,4,1,0.0,0.0,1,0
22400429,5,290,-1.0,-0.20689655172413793,300,10
22400429,5,5,-1.0,-12.0,9,4
22400429,5,2,1.0,30.0,4,2
22400429,5,2,-1.0,-30.0,2,0
22400430,1,239,5.0,1.2552301255230125,720,481
22400430,1,184,4.0,1.3043478260869565,473,289
22400430,1,97,-1.0,-0.6185567010309279,283,186
22400430,1,59,0.0,0.0,175,116
22400430,1,105,0.0,0.0,105,0
22400430,2,43,-2.0,-2.7906976744186047,720,677
22400430,2,85,0.0,0.0,663,578
22400430,2,1,0.0,0.0,560,559
22400430,2,81,-2.0,-1.4814814814814814,547,466
22400430,2,54,2.0,2.2222222222222223,466,412
22400430,2,9,0.0,0.0,403,394
22400430,2,59,2.0,2.0338983050847457,385,326
22400430,2,36,2.0,3.333333333333333,305,269
22400430,2,50,-2.0,-2.4,267,217
22400430,2,96,-4.0,-2.5,205,109
22400430,2,42,-1.0,-1.4285714285714284,104,62
22400430,2,40,0.0,0.0,40,0
22400430,3,240,3.0,0.75,720,480
22400430,3,132,-8.0,-3.6363636363636367,469,337
22400430,3,102,5.0,2.941176470588235,314,212
22400430,3,28,-4.0,-8.571428571428571,176,148
22400430,3,19,0.0,0.0,148,129
22400430,3,122,0.0,0.0,122,0
22400430,4,100,8.0,4.8,720,620
22400430,4,18,0.0,0.0,593,575
22400430,4,85,-4.0,-2.8235294117647056,569,484
22400430,4,46,-4.0,-5.217391304347826,482,436
22400430,4,104,-1.0,-0.576923076923077,436,332
22400430,4,1,0.0,0.0,327,326
22400430,4,78,0.0,0.0,307,229
22400430,4,169,7.0,2.4852071005917162,219,50
22400430,4,43,2.0,2.7906976744186047,43,0
22400431,1,327,1.0,0.1834862385321101,720,393
22400431,1,47,0.0,0.0,388,341
22400431,1,46,4.0,5.217391304347826,328,282
22400431,1,59,5.0,5.084745762711864,282,223
22400431,1,35,0.0,0.0,209,174
22400431,1,174,0.0,0.0,174,0
22400431,2,139,-5.0,-2.158273381294964,720,581
22400431,2,25,0.0,0.0,575,550
22400431,2,70,0.0,0.0,550,480
22400431,2,143,-7.0,-2.937062937062937,463,320
22400431,2,45,-4.0,-5.333333333333334,306,261
22400431,2,75,4.0,3.2,261,186
22400431,2,28,2.0,4.285714285714286,176,148
22400431,2,108,3.0,1.6666666666666665,148,40
22400431,3,246,2.0,0.48780487804878053,720,474
22400431,3,100,3.0,1.7999999999999998,460,360
22400431,3,183,2.0,0.6557377049180327,360,177
22400431,3,168,-6.0,-2.142857142857143,168,0
22400431,4,140,-2.0,-0.8571428571428571,720,580
22400431,4,112,1.0,0.5357142857142857,580,468
22400431,4,16,0.0,0.0,468,452
22400431,4,126,1.0,0.47619047619047616,448,322
22400431,4,16,0.0,0.0,305,289
22400431,4,148,4.0,1.6216216216216217,283,135
22400431,4,106,0.0,0.0,135,29
22400431,4,15,3.0,12.0,15,0
22400432,1,322,5.0,0.9316770186335404,720,398
22400432,1,28,-1.0,-2.142857142857143,392,364
22400432,1,46,0.0,0.0,348,302
22400432,1,27,-4.0,-8.88888888888889,294,267
22400432,1,27,-3.0,-6.666666666666666,255,228
22400432,1,57,2.0,2.1052631578947367,214,157
22400432,1,134,0.0,0.0,147,13
22400432,1,1,0.0,0.0,1,0
22400432,2,204,0.0,0.0,720,516
22400432,2,40,4.0,6.0,493,453
22400432,2,92,-7.0,-4.565217391304348,453,361
22400432,2,52,-1.0,-1.153846153846154,348,296
22400432,2,51,2.0,2.3529411764705883,286,235
22400432,2,130,5.0,2.307692307692308,235,105
22400432,2,105,2.0,1.142857142857143,105,0
22400432,3,330,6.0,1.0909090909090908,720,390
22400432,3,71,0.0,0.0,380,309
22400432,3,54,0.0,0.0,309,255
22400432,3,56,-1.0,-1.0714285714285714,246,190
22400432,3,148,6.0,2.4324324324324325,190,42
22400432,3,41,4.0,5.853658536585366,41,0
22400432,4,63,-2.0,-1.9047619047619047,720,657
22400432,4,178,-5.0,-1.6853932584269662,657,479
22400432,4,33,-2.0,-3.6363636363636367,466,433
22400432,4,136,-5.0,-2.2058823529411766,433,297
22400432,4,297,3.0,0.6060606060606061,297,0
22400433,1,353,12.0,2.039660056657224,720,367
22400433,1,10,0.0,0.0,365,355
22400433,1,134,-2.0,-0.8955223880597015,347,213
22400433,1,155,-1.0,-0.3870967741935484,213,58
22400433,1,49,4.0,4.897959183673469,49,0
22400433,2,155,-2.0,-0.7741935483870968,720,565
22400433,2,81,-1.0,-0.7407407407407407,554,473
22400433,2,82,-1.0,-0.7317073170731707,461,379
22400433,2,42,-4.0,-5.7142857142857135,379,337
22400433,2,25,-3.0,-7.199999999999999,325,300
22400433,2,69,-2.0,-1.7391304347826086,273,204
22400433,2,77,-2.0,-1.5584415584415585,194,117
22400433,2,60,1.0,1.0,112,52
22400433,2,52,0.0,0.0,52,0
22400433,3,325,7.0,1.2923076923076922,720,395
22400433,3,70,-1.0,-0.8571428571428571,395,325
22400433,3,164,-2.0,-0.7317073170731707,325,161
22400433,3,152,4.0,1.5789473684210527,152,0
22400433,4,127,2.0,0.9448818897637795,720,593
22400433,4,130,0.0,0.0,593,463
22400433,4,15,0.0,0.0,463,448
22400433,4,83,1.0,0.7228915662650602,448,365
22400433,4,45,-1.0,-1.3333333333333335,365,320
22400433,4,293,-5.0,-1.0238907849829353,301,8
22400433,4,1,0.0,0.0,5,4
22400433,4,2,0.0,0.0,2,0
22400434,1,216,2.0,0.5555555555555556,720,504
22400434,1,45,0.0,0.0,486,441
22400434,1,69,4.0,3.4782608695652173,436,367
22400434,1,61,5.0,4.918032786885245,352,291
22400434,1,44,2.0,2.7272727272727275,291,247
22400434,1,29,-2.0,-4.137931034482759,231,202
22400434,1,34,2.0,3.5294117647058822,192,158
22400434,1,59,-1.0,-1.0169491525423728,145,86
22400434,1,83,-4.0,-2.891566265060241,83,0
22400434,2,73,-1.0,-0.821917808219178,720,647
22400434,2,106,0.0,0.0,647,541
22400434,2,31,2.0,3.870967741935484,541,510
22400434,2,17,-1.0,-3.5294117647058822,498,481
22400434,2,14,2.0,8.571428571428571,481,467
22400434,2,143,-3.0,-1.2587412587412588,467,324
22400434,2,68,2.0,1.7647058823529411,324,256
22400434,2,56,-3.0,-3.214285714285714,256,200
22400434,2,49,2.0,2.4489795918367343,200,151
22400434,2,39,0.0,0.0,151,112
22400434,2,112,-2.0,-1.0714285714285714,112,0
22400434,3,257,2.0,0.4669260700389105,720,463
22400434,3,22,2.0,5.454545454545455,446,424
22400434,3,16,-1.0,-3.75,424,408
22400434,3,92,2.0,1.3043478260869565,408,316
22400434,3,14,0.0,0.0,306,292
22400434,3,82,-1.0,-0.7317073170731707,292,210
22400434,3,19,2.0,6.315789473684211,194,175
22400434,3,88,-3.0,-2.0454545454545454,164,76
22400434,3,62,1.0,0.967741935483871,62,0
22400434,4,126,-5.0,-2.380952380952381,720,594
22400434,4,174,-3.0,-1.0344827586206897,581,407
22400434,4,71,3.0,2.535211267605634,398,327
22400434,4,74,1.0,0.8108108108108109,327,253
22400434,4,219,-3.0,-0.821917808219178,235,16
22400434,4,16,-3.0,-11.25,16,0
22400435,1,324,2.0,0.37037037037037035,720,396
22400435,1,17,0.0,0.0,386,369
22400435,1,9,0.0,0.0,358,349
22400435,1,80,0.0,0.0,332,252
22400435,1,65,2.0,1.8461538461538463,242,177
22400435,1,177,8.0,2.711864406779661,177,0
22400435,2,161,-7.0,-2.608695652173913,720,559
22400435,2,30,-1.0,-2.0,554,524
22400435,2,50,1.0,1.2,518,468
22400435,2,69,-4.0,-3.4782608695652173,468,399
22400435,2,39,0.0,0.0,399,360
22400435,2,97,-1.0,-0.6185567010309279,360,263
22400435,2,33,0.0,0.0,263,230
22400435,2,40,0.0,0.0,230,190
22400435,2,145,-1.0,-0.41379310344827586,190,45
22400435,2,32,-2.0,-3.75,45,13
22400435,2,13,0.0,0.0,13,0
22400435,3,344,9.0,1.5697674418604652,720,376
22400435,3,31,2.0,3.870967741935484,363,332
22400435,3,62,1.0,0.967741935483871,319,257
22400435,3,80,2.0,1.5,257,177
22400435,3,89,8.0,5.393258426966292,165,76
22400435,4,100,2.0,1.2,720,620
22400435,4,8,0.0,0.0,602,594
22400435,4,19,0.0,0.0,594,575
22400435,4,73,-7.0,-5.7534246575342465,569,496
22400435,4,107,-4.0,-2.2429906542056073,477,370
22400435,4,41,0.0,0.0,361,320
22400435,4,156,1.0,0.3846153846153846,320,164
22400435,4,164,0.0,0.0,164,0
22400436,1,287,1.0,0.20905923344947736,720,433
22400436,1,76,-1.0,-0.7894736842105263,420,344
22400436,1,35,0.0,0.0,323,288
22400436,1,45,3.0,4.0,288,243
22400436,1,59,2.0,2.0338983050847457,215,156
22400436,1,141,-4.0,-1.702127659574468,141,0
22400436,2,96,-4.0,-2.5,720,624
22400436,2,13,0.0,0.0,612,599
22400436,2,32,0.0,0.0,581,549
22400436,2,42,1.0,1.4285714285714284,549,507
22400436,2,29,-3.0,-6.206896551724138,507,478
22400436,2,70,-4.0,-3.4285714285714284,456,386
22400436,2,121,1.0,0.49586776859504134,386,265
22400436,2,265,-3.0,-0.6792452830188679,265,0
22400436,3,286,0.0,0.0,720,434
22400436,3,87,4.0,2.7586206896551726,434,347
22400436,3,63,0.0,0.0,347,284
22400436,3,55,2.0,2.1818181818181817,277,222
22400436,3,13,2.0,9.230769230769232,217,204
22400436,3,181,-6.0,-1.9889502762430937,185,4
22400436,3,4,0.0,0.0,4,0
22400436,4,126,1.0,0.47619047619047616,720,594
22400436,4,64,1.0,0.9375,594,530
22400436,4,39,0.0,0.0,530,491
22400436,4,114,2.0,1.0526315789473684,483,369
22400436,4,89,3.0,2.0224719101123596,361,272
22400436,4,29,2.0,4.137931034482759,256,227
22400436,4,149,5.0,2.0134228187919465,227,78
22400436,4,72,4.0,3.333333333333333,78,6
22400437,1,363,-6.0,-0.9917355371900827,720,357
22400437,1,87,4.0,2.7586206896551726,349,262
22400437,1,108,6.0,3.333333333333333,249,141
22400437,1,4,0.0,0.0,131,127
22400437,1,127,1.0,0.47244094488188976,127,0
22400437,2,81,1.0,0.7407407407407407,720,639
22400437,2,105,-7.0,-4.0,639,534
22400437,2,52,0.0,0.0,512,460
22400437,2,48,-5.0,-6.25,447,399
22400437,2,10,-1.0,-6.0,378,368
22400437,2,277,-2.0,-0.4332129963898917,368,91
22400437,2,91,2.0,1.3186813186813189,91,0
22400437,3,330,2.0,0.36363636363636365,720,390
22400437,3,23,-1.0,-2.608695652173913,382,359
22400437,3,148,1.0,0.40540540540540543,359,211
22400437,3,193,-1.0,-0.31088082901554404,193,0
22400437,4,176,-4.0,-1.3636363636363638,720,544
22400437,4,34,4.0,7.0588235294117645,537,503
22400437,4,110,-4.0,-2.1818181818181817,481,371
22400437,4,90,-4.0,-2.666666666666667,361,271
22400437,4,55,0.0,0.0,266,211
22400437,4,49,-2.0,-2.4489795918367343,194,145
22400437,4,9,1.0,6.666666666666666,134,125
22400437,4,31,-1.0,-1.935483870967742,125,94
22400437,4,61,4.0,3.934426229508197,61,0
22400438,1,379,-3.0,-0.474934036939314,720,341
22400438,1,20,-1.0,-3.0,324,304
22400438,1,68,2.0,1.7647058823529411,304,236
22400438,1,37,2.0,3.2432432432432434,226,189
22400438,1,175,-4.0,-1.3714285714285714,175,0
22400438,2,68,3.0,2.647058823529412,720,652
22400438,2,37,2.0,3.2432432432432434,652,615
22400438,2,30,-2.0,-4.0,608,578
22400438,2,102,-1.0,-0.5882352941176471,578,476
22400438,2,2,2.0,60.0,457,455
22400438,2,140,5.0,2.142857142857143,440,300
22400438,2,20,-1.0,-3.0,281,261
22400438,2,83,-2.0,-1.4457831325301205,261,178
22400438,2,91,-1.0,-0.6593406593406594,165,74
22400438,2,74,7.0,5.675675675675676,74,0
22400438,3,100,-4.0,-2.4,720,620
22400438,3,35,-1.0,-1.7142857142857142,610,575
22400438,3,234,-7.0,-1.794871794871795,575,341
22400438,3,75,-4.0,-3.2,326,251
22400438,3,18,0.0,0.0,248,230
22400438,3,70,0.0,0.0,230,160
22400438,3,40,2.0,3.0,160,120
22400438,3,103,-5.0,-2.912621359223301,103,0
22400438,4,48,-3.0,-3.75,720,672
22400438,4,60,1.0,1.0,672,612
22400438,4,89,-3.0,-2.0224719101123596,612,523
22400438,4,45,0.0,0.0,510,465
22400438,4,78,-3.0,-2.307692307692308,465,387
22400438,4,182,1.0,0.3296703296703297,381,199
22400438,4,179,1.0,0.335195530726257,179,0
22400439,1,378,-5.0,-0.7936507936507936,720,342
22400439,1,52,0.0,0.0,333,281
22400439,1,51,0.0,0.0,263,212
22400439,1,129,0.0,0.0,201,72
22400439,1,72,-2.0,-1.6666666666666665,72,0
22400439,2,86,2.0,1.3953488372093024,720,634
22400439,2,82,0.0,0.0,624,542
22400439,2,120,0.0,0.0,531,411
22400439,2,62,-2.0,-1.935483870967742,395,333
22400439,2,30,3.0,6.0,311,281
22400439,2,37,1.0,1.6216216216216217,277,240
22400439,2,113,-3.0,-1.592920353982301,240,127
22400439,2,120,1.0,0.5,120,0
22400439,3,359,10.0,1.671309192200557,720,361
22400439,3,31,3.0,5.806451612903226,350,319
22400439,3,14,0.0,0.0,303,289
22400439,3,37,2.0,3.2432432432432434,279,242
22400439,3,17,0.0,0.0,222,205
22400439,3,114,-3.0,-1.5789473684210527,205,91
22400439,3,79,-4.0,-3.0379746835443036,79,0
22400439,4,164,4.0,1.4634146341463414,720,556
22400439,4,67,2.0,1.791044776119403,541,474
22400439,4,1,0.0,0.0,455,454
22400439,4,87,-2.0,-1.3793103448275863,448,361
22400439,4,24,-1.0,-2.5,342,318
22400439,4,195,-2.0,-0.6153846153846154,318,123
22400439,4,37,0.0,0.0,116,79
22400439,4,24,-4.0,-10.0,71,47
22400439,4,4,-2.0,-30.0,39,35
22400440,1,305,-3.0,-0.5901639344262296,720,415
22400440,1,38,3.0,4.7368421052631575,406,368
22400440,1,159,-3.0,-1.1320754716981132,351,192
22400440,1,165,10.0,3.6363636363636367,192,27
22400440,1,27,-2.0,-4.444444444444445,27,0
22400440,2,205,5.0,1.4634146341463414,720,515
22400440,2,17,0.0,0.0,503,486
22400440,2,142,6.0,2.535211267605634,476,334
22400440,2,53,7.0,7.9245283018867925,322,269
22400440,2,40,3.0,4.5,261,221
22400440,2,88,2.0,1.3636363636363638,212,124
22400440,2,63,1.0,0.9523809523809523,110,47
22400440,2,28,1.0,2.142857142857143,47,19
22400440,2,14,0.0,0.0,19,5
22400440,2,3,0.0,0.0,3,0
22400440,3,229,0.0,0.0,720,491
22400440,3,170,-1.0,-0.3529411764705882,489,319
22400440,3,67,3.0,2.6865671641791042,299,232
22400440,3,99,2.0,1.2121212121212122,232,133
22400440,3,15,0.0,0.0,133,118
22400440,3,113,1.0,0.5309734513274336,113,0
22400440,4,59,1.0,1.0169491525423728,720,661
22400440,4,70,-1.0,-0.8571428571428571,650,580
22400440,4,130,-2.0,-0.9230769230769231,570,440
22400440,4,31,0.0,0.0,425,394
22400440,4,44,1.0,1.3636363636363638,382,338
22400440,4,68,2.0,1.7647058823529411,338,270
22400440,4,17,0.0,0.0,257,240
22400440,4,233,-3.0,-0.7725321888412017,233,0
22400441,1,464,-7.0,-0.9051724137931035,720,256
22400441,1,64,1.0,0.9375,240,176
22400441,1,172,0.0,0.0,176,4
22400441,2,198,10.0,3.0303030303030303,720,522
22400441,2,98,0.0,0.0,522,424
22400441,2,30,2.0,4.0,424,394
22400441,2,137,6.0,2.6277372262773726,376,239
22400441,2,217,2.0,0.5529953917050692,217,0
22400441,3,312,-7.0,-1.3461538461538463,720,408
22400441,3,128,-1.0,-0.46875,388,260
22400441,3,68,2.0,1.7647058823529411,260,192
22400441,3,64,-1.0,-0.9375,192,128
22400441,3,21,0.0,0.0,124,103
22400441,3,72,-2.0,-1.6666666666666665,90,18
22400441,3,18,0.0,0.0,18,0
22400441,4,86,-4.0,-2.7906976744186047,720,634
22400441,4,62,4.0,3.870967741935484,634,572
22400441,4,85,0.0,0.0,563,478
22400441,4,117,2.0,1.0256410256410258,478,361
22400441,4,63,5.0,4.761904761904762,347,284
22400441,4,67,0.0,0.0,265,198
22400441,4,180,-1.0,-0.33333333333333337,192,12
22400441,4,2,0.0,0.0,2,0
22400442,1,251,6.0,1.4342629482071714,720,469
22400442,1,132,2.0,0.9090909090909092,452,320
22400442,1,62,-2.0,-1.935483870967742,310,248
22400442,1,26,4.0,9.230769230769232,245,219
22400442,1,29,0.0,0.0,219,190
22400442,1,103,-3.0,-1.7475728155339807,178,75
22400442,1,75,2.0,1.6,75,0
22400442,2,138,-3.0,-1.3043478260869565,720,582
22400442,2,44,-2.0,-2.7272727272727275,582,538
22400442,2,105,2.0,1.142857142857143,538,433
22400442,2,63,-3.0,-2.8571428571428568,433,370
22400442,2,79,-4.0,-3.0379746835443036,359,280
22400442,2,63,-5.0,-4.761904761904762,280,217
22400442,2,31,2.0,3.870967741935484,217,186
22400442,2,157,0.0,0.0,166,9
22400442,3,260,13.0,3.0,720,460
22400442,3,119,-3.0,-1.5126050420168067,460,341
22400442,3,24,-1.0,-2.5,341,317
22400442,3,54,0.0,0.0,317,263
22400442,3,38,0.0,0.0,249,211
22400442,3,43,2.0,2.7906976744186047,211,168
22400442,3,148,1.0,0.40540540540540543,148,0
22400442,4,143,-4.0,-1.6783216783216783,720,577
22400442,4,40,2.0,3.0,554,514
22400442,4,13,1.0,4.615384615384616,514,501
22400442,4,27,-2.0,-4.444444444444445,501,474
22400442,4,53,0.0,0.0,464,411
22400442,4,29,0.0,0.0,390,361
22400442,4,113,0.0,0.0,361,248
22400442,4,156,5.0,1.923076923076923,248,92
22400442,4,72,-2.0,-1.6666666666666665,92,20
22400442,4,1,0.0,0.0,11,10
22400442,4,1,0.0,0.0,6,5
22400442,5,131,-6.0,-2.7480916030534353,300,169
22400442,5,58,-3.0,-3.103448275862069,154,96
22400442,5,73,2.0,1.643835616438356,96,23
22400442,5,15,-2.0,-8.0,15,0
22400443,1,348,-6.0,-1.0344827586206897,720,372
22400443,1,104,-1.0,-0.576923076923077,372,268
22400443,1,130,-1.0,-0.46153846153846156,381,251
22400443,1,44,3.0,4.090909090909091,240,196
22400443,1,196,5.0,1.5306122448979593,196,0
22400443,2,65,-1.0,-0.9230769230769231,720,655
22400443,2,18,2.0,6.666666666666666,655,637
22400443,2,70,0.0,0.0,626,556
22400443,2,142,-5.0,-2.1126760563380285,550,408
22400443,2,76,-5.0,-3.9473684210526314,394,318
22400443,2,154,1.0,0.38961038961038963,318,164
22400443,2,111,3.0,1.6216216216216217,139,28
22400443,3,418,-4.0,-0.5741626794258373,720,302
22400443,3,114,2.0,1.0526315789473684,302,188
22400443,3,33,-3.0,-5.454545454545455,171,138
22400443,3,29,-2.0,-4.137931034482759,138,109
22400443,3,109,-3.0,-1.651376146788991,109,0
22400443,4,160,-2.0,-0.75,720,560
22400443,4,35,0.0,0.0,542,507
22400443,4,28,-3.0,-6.428571428571428,495,467
22400443,4,19,-2.0,-6.315789473684211,467,448
22400443,4,105,-1.0,-0.5714285714285715,448,343
22400443,4,233,-1.0,-0.2575107296137339,341,108
22400443,4,42,2.0,2.8571428571428568,94,52
22400443,4,42,-3.0,-4.285714285714286,42,0
22400444,1,480,-1.0,-0.125,720,240
22400444,1,23,0.0,0.0,230,207
22400444,1,148,3.0,1.2162162162162162,200,52
22400444,1,52,1.0,1.153846153846154,52,0
22400444,2,167,-3.0,-1.0778443113772456,720,553
22400444,2,55,-4.0,-4.363636363636363,553,498
22400444,2,9,0.0,0.0,483,474
22400444,2,88,6.0,4.090909090909091,456,368
22400444,2,29,0.0,0.0,347,318
22400444,2,221,3.0,0.8144796380090498,318,97
22400444,2,54,-5.0,-5.555555555555555,88,34
22400444,3,456,2.0,0.2631578947368421,720,264
22400444,3,15,-1.0,-4.0,250,235
22400444,3,10,0.0,0.0,235,225
22400444,3,80,-1.0,-0.75,205,125
22400444,3,29,-3.0,-6.206896551724138,115,86
22400444,3,61,2.0,1.9672131147540985,61,0
22400444,4,206,1.0,0.2912621359223301,720,514
22400444,4,54,-3.0,-3.333333333333333,514,460
22400444,4,88,-2.0,-1.3636363636363638,439,351
22400444,4,63,1.0,0.9523809523809523,351,288
22400444,4,243,-3.0,-0.7407407407407407,288,45
22400444,4,150,0.0,0.0,154,4
22400444,4,3,-1.0,-20.0,4,1
22400445,1,404,3.0,0.4455445544554455,720,316
22400445,1,71,-2.0,-1.6901408450704225,305,234
22400445,1,8,0.0,0.0,226,218
22400445,1,57,-4.0,-4.2105263157894735,218,161
22400445,1,159,6.0,2.2641509433962264,159,0
22400445,2,222,0.0,0.0,720,498
22400445,2,70,1.0,0.8571428571428571,480,410
22400445,2,43,4.0,5.5813953488372094,410,367
22400445,2,58,-2.0,-2.0689655172413794,356,298
22400445,2,8,1.0,7.5,273,265
22400445,2,93,-4.0,-2.580645161290323,258,165
22400445,2,155,0.0,0.0,155,0
22400445,3,280,-3.0,-0.6428571428571429,720,440
22400445,3,66,-3.0,-2.7272727272727275,440,374
22400445,3,109,0.0,0.0,368,259
22400445,3,70,-3.0,-2.5714285714285716,259,189
22400445,3,16,0.0,0.0,189,173
22400445,3,94,-3.0,-1.9148936170212765,165,71
22400445,4,272,6.0,1.323529411764706,720,448
22400445,4,41,-5.0,-7.317073170731707,448,407
22400445,4,206,-2.0,-0.5825242718446602,394,188
22400445,4,188,-1.0,-0.3191489361702128,188,0
22400446,1,376,1.0,0.1595744680851064,720,344
22400446,1,90,3.0,2.0,344,254
22400446,1,28,-2.0,-4.285714285714286,240,212
22400446,1,181,1.0,0.3314917127071823,203,22
22400446,2,80,0.0,0.0,720,640
22400446,2,49,0.0,0.0,625,576
22400446,2,147,-1.0,-0.40816326530612246,576,429
22400446,2,100,-5.0,-3.0,417,317
22400446,2,13,2.0,9.230769230769232,303,290
22400446,2,233,-5.0,-1.2875536480686696,271,38
22400446,2,38,0.0,0.0,38,0
22400446,3,241,-15.0,-3.7344398340248963,720,479
22400446,3,4,0.0,0.0,467,463
22400446,3,49,1.0,1.2244897959183672,463,414
22400446,3,93,3.0,1.935483870967742,439,346
22400446,3,58,-4.0,-4.137931034482759,328,270
22400446,3,38,1.0,1.5789473684210527,270,232
22400446,3,36,-1.0,-1.6666666666666665,215,179
22400446,3,151,5.0,1.9867549668874174,179,28
22400446,3,15,0.0,0.0,28,13
22400446,4,41,0.0,0.0,720,679
22400446,4,33,-1.0,-1.8181818181818183,669,636
22400446,4,136,-5.0,-2.2058823529411766,636,500
22400446,4,5,-1.0,-12.0,486,481
22400446,4,150,1.0,0.4,481,331
22400446,4,46,2.0,2.608695652173913,325,279
22400446,4,34,-3.0,-5.294117647058824,279,245
22400446,4,11,0.0,0.0,245,234
22400446,4,222,4.0,1.0810810810810811,222,0
22400447,1,279,-8.0,-1.7204301075268817,720,441
22400447,1,85,1.0,0.7058823529411764,441,356
22400447,1,97,0.0,0.0,356,259
22400447,1,283,1.0,0.21201413427561838,502,219
22400447,1,33,-1.0,-1.8181818181818183,219,186
22400447,1,123,5.0,2.4390243902439024,186,63
22400447,2,170,-2.0,-0.7058823529411764,720,550
22400447,2,37,-2.0,-3.2432432432432434,536,499
22400447,2,196,-7.0,-2.142857142857143,486,290
22400447,2,46,-1.0,-1.3043478260869565,290,244
22400447,2,132,4.0,1.8181818181818183,244,112
22400447,2,112,2.0,1.0714285714285714,112,0
22400447,3,249,-1.0,-0.24096385542168672,720,471
22400447,3,143,-2.0,-0.8391608391608392,471,328
22400447,3,61,2.0,1.9672131147540985,328,267
22400447,3,63,0.0,0.0,264,201
22400447,3,114,-3.0,-1.5789473684210527,193,79
22400447,3,79,-4.0,-3.0379746835443036,79,0
22400447,4,82,3.0,2.195121951219512,720,638
22400447,4,60,2.0,2.0,638,578
22400447,4,52,-5.0,-5.769230769230769,578,526
22400447,4,96,-2.0,-1.25,497,401
22400447,4,35,-2.0,-3.4285714285714284,392,357
22400447,4,49,1.0,1.2244897959183672,340,291
22400447,4,48,0.0,0.0,291,243
22400447,4,57,1.0,1.0526315789473684,233,176
22400447,4,176,2.0,0.6818181818181819,176,0
22400448,1,346,-2.0,-0.3468208092485549,720,374
22400448,1,17,0.0,0.0,355,338
22400448,1,132,-9.0,-4.090909090909091,337,205
22400448,1,42,-1.0,-1.4285714285714284,193,151
22400448,1,131,-3.0,-1.3740458015267176,134,3
22400448,2,129,2.0,0.9302325581395349,720,591
22400448,2,27,2.0,4.444444444444445,591,564
22400448,2,46,0.0,0.0,564,518
22400448,2,68,0.0,0.0,500,432
22400448,2,22,1.0,2.7272727272727275,420,398
22400448,2,14,0.0,0.0,398,384
22400448,2,10,1.0,6.0,375,365
22400448,2,116,3.0,1.5517241379310345,361,245
22400448,2,87,-5.0,-3.4482758620689653,239,152
22400448,2,114,4.0,2.1052631578947367,152,38
22400448,2,28,0.0,0.0,28,0
22400448,3,210,-2.0,-0.5714285714285715,720,510
22400448,3,28,1.0,2.142857142857143,510,482
22400448,3,36,-1.0,-1.6666666666666665,482,446
22400448,3,19,-2.0,-6.315789473684211,435,416
22400448,3,49,-3.0,-3.673469387755102,416,367
22400448,3,92,0.0,0.0,367,275
22400448,3,41,3.0,4.390243902439024,275,234
22400448,3,59,2.0,2.0338983050847457,234,175
22400448,3,29,-2.0,-4.137931034482759,166,137
22400448,3,68,3.0,2.647058823529412,130,62
22400448,3,24,2.0,5.0,62,38
22400448,4,119,4.0,2.0168067226890756,720,601
22400448,4,48,3.0,3.75,586,538
22400448,4,99,-1.0,-0.6060606060606061,518,419
22400448,4,77,4.0,3.116883116883117,395,318
22400448,4,50,0.0,0.0,301,251
22400448,4,27,0.0,0.0,241,214
22400448,4,33,-3.0,-5.454545454545455,214,181
22400448,4,47,2.0,2.5531914893617023,176,129
22400448,4,33,1.0,1.8181818181818183,117,84
22400448,4,84,-2.0,-1.4285714285714284,84,0
22400449,1,266,0.0,0.0,720,454
22400449,1,126,5.0,2.380952380952381,441,315
22400449,1,111,6.0,3.2432432432432434,290,179
22400449,1,62,-2.0,-1.935483870967742,169,107
22400449,1,93,5.0,3.2258064516129035,93,0
22400449,2,93,3.0,1.935483870967742,720,627
22400449,2,85,2.0,1.4117647058823528,617,532
22400449,2,80,-6.0,-4.5,521,441
22400449,2,114,0.0,0.0,436,322
22400449,2,32,0.0,0.0,307,275
22400449,2,110,-1.0,-0.5454545454545454,272,162
22400449,2,162,-1.0,-0.37037037037037035,162,0
22400449,3,274,7.0,1.532846715328467,720,446
22400449,3,104,3.0,1.7307692307692308,421,317
22400449,3,9,1.0,6.666666666666666,291,282
22400449,3,85,3.0,2.1176470588235294,282,197
22400449,3,23,0.0,0.0,197,174
22400449,3,174,9.0,3.103448275862069,174,0
22400449,4,176,7.0,2.3863636363636362,720,544
22400449,4,23,0.0,0.0,532,509
22400449,4,76,2.0,1.5789473684210527,500,424
22400449,4,42,2.0,2.8571428571428568,416,374
22400449,4,100,0.0,0.0,372,272
22400449,4,140,4.0,1.7142857142857142,272,132
22400449,4,117,3.0,1.5384615384615383,117,0
22400450,1,301,4.0,0.7973421926910299,720,419
22400450,1,2,0.0,0.0,406,404
22400450,1,70,-4.0,-3.4285714285714284,383,313
22400450,1,49,5.0,6.122448979591837,296,247
22400450,1,70,3.0,2.5714285714285716,245,175
22400450,1,93,-4.0,-2.580645161290323,175,82
22400450,1,66,-3.0,-2.7272727272727275,66,0
22400450,2,252,4.0,0.9523809523809523,720,468
22400450,2,51,2.0,2.3529411764705883,467,416
22400450,2,67,-1.0,-0.8955223880597015,410,343
22400450,2,87,0.0,0.0,343,256
22400450,2,91,6.0,3.956043956043956,256,165
22400450,2,165,1.0,0.36363636363636365,165,0
22400450,3,304,8.0,1.5789473684210527,720,416
22400450,3,60,-3.0,-3.0,401,341
22400450,3,88,-3.0,-2.0454545454545454,341,253
22400450,3,28,-1.0,-2.142857142857143,247,219
22400450,3,86,2.0,1.3953488372093024,219,133
22400450,3,91,-1.0,-0.6593406593406594,122,31
22400450,3,31,-2.0,-3.870967741935484,31,0
22400450,4,89,2.0,1.348314606741573,720,631
22400450,4,52,-1.0,-1.153846153846154,626,574
22400450,4,33,-2.0,-3.6363636363636367,574,541
22400450,4,38,1.0,1.5789473684210527,530,492
22400450,4,161,1.0,0.37267080745341613,492,331
22400450,4,132,-4.0,-1.8181818181818183,331,199
22400450,4,192,-7.0,-2.1875,192,0
22400451,1,318,6.0,1.1320754716981132,720,402
22400451,1,130,-2.0,-0.9230769230769231,390,260
22400451,1,43,0.0,0.0,260,217
22400451,1,58,-1.0,-1.0344827586206897,193,135
22400451,1,120,7.0,3.5,120,0
22400451,2,224,3.0,0.8035714285714285,720,496
22400451,2,69,-3.0,-2.608695652173913,477,408
22400451,2,81,0.0,0.0,387,306
22400451,2,11,0.0,0.0,306,295
22400451,2,132,6.0,2.7272727272727275,287,155
22400451,2,69,4.0,3.4782608695652173,149,80
22400451,2,80,-3.0,-2.25,80,0
22400451,3,291,2.0,0.41237113402061853,720,429
22400451,3,100,5.0,3.0,420,320
22400451,3,176,2.0,0.6818181818181819,305,129
22400451,3,118,-1.0,-0.5084745762711864,118,0
22400451,4,201,4.0,1.1940298507462686,720,519
22400451,4,36,2.0,3.333333333333333,508,472
22400451,4,17,3.0,10.588235294117649,459,442
22400451,4,107,0.0,0.0,442,335
22400451,4,321,0.0,0.0,321,0
22400452,1,314,-3.0,-0.5732484076433121,720,406
22400452,1,42,-1.0,-1.4285714285714284,406,364
22400452,1,72,-3.0,-2.5,352,280
22400452,1,123,3.0,1.4634146341463414,280,157
22400452,1,25,0.0,0.0,149,124
22400452,1,119,0.0,0.0,119,0
22400452,2,93,-1.0,-0.6451612903225807,720,627
22400452,2,66,0.0,0.0,621,555
22400452,2,75,-3.0,-2.4,545,470
22400452,2,59,-4.0,-4.067796610169491,470,411
22400452,2,104,1.0,0.576923076923077,400,296
22400452,2,30,3.0,6.0,280,250
22400452,2,34,-3.0,-5.294117647058824,232,198
22400452,2,28,3.0,6.428571428571428,186,158
22400452,2,148,1.0,0.40540540540540543,148,0
22400452,3,299,1.0,0.20066889632107024,720,421
22400452,3,13,3.0,13.846153846153847,408,395
22400452,3,9,0.0,0.0,375,366
22400452,3,40,3.0,4.5,358,318
22400452,3,14,0.0,0.0,307,293
22400452,3,37,3.0,4.864864864864865,277,240
22400452,3,49,3.0,3.673469387755102,226,177
22400452,3,177,9.0,3.050847457627119,177,0
22400452,4,54,-2.0,-2.2222222222222223,720,666
22400452,4,72,4.0,3.333333333333333,660,588
22400452,4,126,-2.0,-0.9523809523809523,588,462
22400452,4,91,-3.0,-1.978021978021978,440,349
22400452,4,22,2.0,5.454545454545455,349,327
22400452,4,257,-2.0,-0.4669260700389105,315,58
22400452,4,44,2.0,2.7272727272727275,44,0
22400453,1,135,-7.0,-3.111111111111111,720,585
22400453,1,178,1.0,0.33707865168539325,570,392
22400453,1,99,-6.0,-3.6363636363636367,379,280
22400453,1,78,-1.0,-0.7692307692307692,280,202
22400453,1,47,0.0,0.0,184,137
22400453,1,14,-1.0,-4.285714285714286,137,123
22400453,1,106,0.0,0.0,123,17
22400453,1,2,0.0,0.0,2,0
22400453,2,222,4.0,1.0810810810810811,720,498
22400453,2,83,-6.0,-4.337349397590361,498,415
22400453,2,34,0.0,0.0,403,369
22400453,2,21,2.0,5.7142857142857135,353,332
22400453,2,58,3.0,3.103448275862069,324,266
22400453,2,124,-3.0,-1.4516129032258065,264,140
22400453,2,40,-1.0,-1.5,140,100
22400453,2,11,1.0,5.454545454545455,100,89
22400453,2,89,-6.0,-4.044943820224719,89,0
22400453,3,248,10.0,2.4193548387096775,720,472
22400453,3,32,-3.0,-5.625,454,422
22400453,3,48,0.0,0.0,418,370
22400453,3,16,0.0,0.0,370,354
22400453,3,74,-5.0,-4.054054054054054,346,272
22400453,3,64,2.0,1.875,265,201
22400453,3,93,3.0,1.935483870967742,191,98
22400453,4,200,1.0,0.3,720,520
22400453,4,63,0.0,0.0,520,457
22400453,4,2,0.0,0.0,445,443
22400453,4,80,1.0,0.75,443,363
22400453,4,46,-3.0,-3.9130434782608696,363,317
22400453,4,15,1.0,4.0,317,302
22400453,4,100,0.0,0.0,302,202
22400453,4,187,-2.0,-0.6417112299465241,189,2
22400453,4,19,0.0,0.0,35,16
22400454,1,308,-6.0,-1.1688311688311688,720,412
22400454,1,31,1.0,1.935483870967742,412,381
22400454,1,43,-3.0,-4.186046511627907,381,338
22400454,1,100,3.0,1.7999999999999998,338,238
22400454,1,86,2.0,1.3953488372093024,238,152
22400454,1,15,0.0,0.0,152,137
22400454,1,30,3.0,6.0,122,92
22400454,1,53,0.0,0.0,76,23
22400454,1,23,0.0,0.0,23,0
22400454,2,58,2.0,2.0689655172413794,720,662
22400454,2,89,-2.0,-1.348314606741573,646,557
22400454,2,43,-3.0,-4.186046511627907,557,514
22400454,2,44,4.0,5.454545454545455,494,450
22400454,2,72,3.0,2.5,442,370
22400454,2,104,-7.0,-4.038461538461538,370,266
22400454,2,183,-2.0,-0.6557377049180327,254,71
22400454,2,57,2.0,2.1052631578947367,57,0
22400454,3,246,3.0,0.7317073170731707,720,474
22400454,3,117,-7.0,-3.58974358974359,463,346
22400454,3,110,7.0,3.818181818181818,331,221
22400454,3,48,-1.0,-1.25,205,157
22400454,3,91,0.0,0.0,157,66
22400454,3,52,-3.0,-3.4615384615384617,54,2
22400454,3,1,0.0,0.0,1,0
22400454,4,148,-7.0,-2.837837837837838,720,572
22400454,4,56,2.0,2.142857142857143,548,492
22400454,4,111,0.0,0.0,492,381
22400454,4,11,1.0,5.454545454545455,360,349
22400454,4,76,0.0,0.0,349,273
22400454,4,267,-1.0,-0.2247191011235955,267,0
22400455,1,323,6.0,1.1145510835913313,720,397
22400455,1,47,-3.0,-3.829787234042553,397,350
22400455,1,69,-1.0,-0.8695652173913043,326,257
22400455,1,92,-2.0,-1.3043478260869565,247,155
22400455,1,101,5.0,2.9702970297029703,155,54
22400455,1,46,-2.0,-2.608695652173913,46,0
22400455,2,156,2.0,0.7692307692307692,720,564
22400455,2,21,2.0,5.7142857142857135,564,543
22400455,2,30,1.0,2.0,531,501
22400455,2,49,-3.0,-3.673469387755102,501,452
22400455,2,29,-2.0,-4.137931034482759,431,402
22400455,2,69,0.0,0.0,396,327
22400455,2,196,2.0,0.6122448979591836,313,117
22400455,2,56,1.0,1.0714285714285714,117,61
22400455,2,23,-2.0,-5.217391304347826,45,22
22400455,2,22,0.0,0.0,22,0
22400455,3,327,1.0,0.1834862385321101,720,393
22400455,3,18,2.0,6.666666666666666,393,375
22400455,3,37,0.0,0.0,361,324
22400455,3,27,-1.0,-2.2222222222222223,306,279
22400455,3,87,-4.0,-2.7586206896551726,279,192
22400455,4,90,-2.0,-1.3333333333333335,720,630
22400455,4,23,-1.0,-2.608695652173913,630,607
22400455,4,61,0.0,0.0,598,537
22400455,4,164,-1.0,-0.36585365853658536,529,365
22400455,4,62,4.0,3.870967741935484,343,281
22400455,4,51,2.0,2.3529411764705883,264,213
22400455,4,87,1.0,0.6896551724137931,206,119
22400455,4,76,-3.0,-2.3684210526315788,114,38
22400456,1,315,-1.0,-0.19047619047619047,720,405
22400456,1,62,0.0,0.0,405,343
22400456,1,33,0.0,0.0,333,300
22400456,1,93,-4.0,-2.580645161290323,299,206
22400456,1,38,0.0,0.0,192,154
22400456,1,141,3.0,1.2765957446808511,143,2
22400456,1,40,0.0,0.0,40,0
22400456,2,124,4.0,1.935483870967742,720,596
22400456,2,21,-2.0,-5.7142857142857135,590,569
22400456,2,37,1.0,1.6216216216216217,558,521
22400456,2,97,-2.0,-1.2371134020618557,521,424
22400456,2,75,3.0,2.4,410,335
22400456,2,108,0.0,0.0,335,227
22400456,2,72,-1.0,-0.8333333333333333,224,152
22400456,2,147,-2.0,-0.8163265306122449,147,0
22400456,3,220,8.0,2.1818181818181817,720,500
22400456,3,84,0.0,0.0,494,410
22400456,3,20,0.0,0.0,396,376
22400456,3,66,-2.0,-1.8181818181818183,361,295
22400456,3,100,-4.0,-2.4,291,191
22400456,3,17,-2.0,-7.0588235294117645,191,174
22400456,3,97,5.0,3.092783505154639,154,57
22400456,3,42,3.0,4.285714285714286,42,0
22400456,4,118,5.0,2.542372881355932,720,602
22400456,4,2,0.0,0.0,593,591
22400456,4,138,0.0,0.0,579,441
22400456,4,54,-3.0,-3.333333333333333,427,373
22400456,4,45,-2.0,-2.666666666666667,373,328
22400456,4,138,7.0,3.0434782608695654,320,182
22400456,4,23,2.0,5.217391304347826,172,149
22400456,4,45,3.0,4.0,145,100
22400456,4,88,-2.0,-1.3636363636363638,88,0
22400457,1,316,12.0,2.278481012658228,720,404
22400457,1,97,-3.0,-1.8556701030927836,404,307
22400457,1,152,-3.0,-1.1842105263157894,307,155
22400457,1,145,4.0,1.6551724137931034,145,0
22400457,2,179,3.0,1.005586592178771,720,541
22400457,2,57,-4.0,-4.2105263157894735,526,469
22400457,2,42,0.0,0.0,450,408
22400457,2,77,1.0,0.7792207792207793,397,320
22400457,2,17,0.0,0.0,300,283
22400457,2,53,-2.0,-2.2641509433962264,266,213
22400457,2,40,0.0,0.0,213,173
22400457,2,150,0.0,0.0,150,0
22400457,3,417,0.0,0.0,720,303
22400457,3,78,2.0,1.5384615384615383,287,209
22400457,3,19,0.0,0.0,203,184
22400457,3,100,3.0,1.7999999999999998,170,70
22400457,3,48,3.0,3.75,48,0
22400457,4,218,-4.0,-1.1009174311926606,720,502
22400457,4,69,-1.0,-0.8695652173913043,502,433
22400457,4,48,4.0,5.0,417,369
22400457,4,142,-2.0,-0.8450704225352113,369,227
22400457,4,222,1.0,0.2702702702702703,222,0
22400458,1,312,-7.0,-1.3461538461538463,720,408
22400458,1,236,2.0,0.5084745762711864,408,172
22400458,1,151,1.0,0.3973509933774834,162,11
22400458,2,107,2.0,1.1214953271028036,720,613
22400458,2,168,2.0,0.7142857142857142,606,438
22400458,2,32,-2.0,-3.75,427,395
22400458,2,157,5.0,1.910828025477707,384,227
22400458,2,52,4.0,4.615384615384616,220,168
22400458,2,165,-4.0,-1.4545454545454546,168,3
22400458,2,1,0.0,0.0,3,2
22400458,3,326,3.0,0.5521472392638037,720,394
22400458,3,106,-2.0,-1.1320754716981132,391,285
22400458,3,86,-1.0,-0.6976744186046512,273,187
22400458,3,29,0.0,0.0,181,152
22400458,3,50,1.0,1.2,152,102
22400458,3,53,0.0,0.0,102,49
22400458,3,2,0.0,0.0,200,198
22400458,4,108,7.0,3.888888888888889,720,612
22400458,4,123,-1.0,-0.48780487804878053,612,489
22400458,4,34,2.0,3.5294117647058822,489,455
22400458,4,29,2.0,4.137931034482759,434,405
22400458,4,388,1.0,0.15463917525773196,388,0
22400459,1,296,-4.0,-0.8108108108108109,720,424
22400459,1,28,3.0,6.428571428571428,411,383
22400459,1,98,-3.0,-1.836734693877551,373,275
22400459,1,44,0.0,0.0,275,231
22400459,1,50,-3.0,-3.5999999999999996,223,173
22400459,1,42,1.0,1.4285714285714284,163,121
22400459,1,8,-2.0,-15.0,117,109
22400459,1,109,-3.0,-1.651376146788991,109,0
22400459,2,112,-1.0,-0.5357142857142857,720,608
22400459,2,155,3.0,1.1612903225806452,597,442
22400459,2,14,0.0,0.0,442,428
22400459,2,62,1.0,0.967741935483871,419,357
22400459,2,30,3.0,6.0,344,314
22400459,2,49,-5.0,-6.122448979591837,295,246
22400459,2,104,-1.0,-0.576923076923077,246,142
22400459,2,20,0.0,0.0,126,106
22400459,2,96,-1.0,-0.625,96,0
22400459,3,273,3.0,0.6593406593406594,720,447
22400459,3,31,0.0,0.0,447,416
22400459,3,57,3.0,3.1578947368421053,416,359
22400459,3,104,-6.0,-3.4615384615384617,344,240
22400459,3,110,0.0,0.0,240,130
22400459,3,82,0.0,0.0,108,26
22400459,3,24,0.0,0.0,26,2
22400459,4,100,4.0,2.4,720,620
22400459,4,13,0.0,0.0,596,583
22400459,4,150,2.0,0.8,571,421
22400459,4,118,5.0,2.542372881355932,410,292
22400459,4,23,5.0,13.043478260869565,279,256
22400459,4,13,-2.0,-9.230769230769232,245,232
22400459,4,65,1.0,0.9230769230769231,232,167
22400459,4,115,2.0,1.0434782608695652,156,41
22400459,4,41,-2.0,-2.926829268292683,41,0
22400460,1,271,-6.0,-1.3284132841328413,720,449
22400460,1,90,7.0,4.666666666666667,442,352
22400460,1,59,1.0,1.0169491525423728,352,293
22400460,1,73,2.0,1.643835616438356,293,220
22400460,1,97,-4.0,-2.4742268041237114,220,123
22400460,1,77,-3.0,-2.3376623376623376,110,33
22400460,1,33,0.0,0.0,33,0
22400460,2,91,0.0,0.0,720,629
22400460,2,90,-3.0,-2.0,617,527
22400460,2,29,-3.0,-6.206896551724138,521,492
22400460,2,35,2.0,3.4285714285714284,471,436
22400460,2,144,7.0,2.9166666666666665,427,283
22400460,2,116,3.0,1.5517241379310345,364,248
22400460,2,221,4.0,1.0859728506787332,248,27
22400460,2,27,0.0,0.0,27,0
22400460,3,248,1.0,0.24193548387096775,720,472
22400460,3,88,1.0,0.6818181818181819,460,372
22400460,3,10,0.0,0.0,372,362
22400460,3,80,0.0,0.0,358,278
22400460,3,201,3.0,0.8955223880597015,275,74
22400460,3,17,-1.0,-3.5294117647058822,65,48
22400460,4,205,1.0,0.2926829268292683,720,515
22400460,4,36,-2.0,-3.333333333333333,506,470
22400460,4,51,5.0,5.88235294117647,461,410
22400460,4,86,-2.0,-1.3953488372093024,389,303
22400460,4,41,-2.0,-2.926829268292683,285,244
22400460,4,121,1.0,0.49586776859504134,244,123
22400460,4,14,0.0,0.0,96,82
22400460,4,62,-4.0,-3.870967741935484,62,0
22400461,1,248,4.0,0.967741935483871,720,472
22400461,1,131,-2.0,-0.916030534351145,464,333
22400461,1,34,0.0,0.0,320,286
22400461,1,73,-3.0,-2.4657534246575343,279,206
22400461,1,195,3.0,0.9230769230769231,195,0
22400461,2,181,-1.0,-0.3314917127071823,720,539
22400461,2,60,-1.0,-1.0,527,467
22400461,2,44,2.0,2.7272727272727275,460,416
22400461,2,72,-7.0,-5.833333333333333,403,331
22400461,2,90,4.0,2.666666666666667,316,226
22400461,2,77,0.0,0.0,203,126
22400461,2,64,-3.0,-2.8125,118,54
22400461,2,41,4.0,5.853658536585366,54,13
22400461,2,4,0.0,0.0,13,9
22400461,3,275,9.0,1.9636363636363638,720,445
22400461,3,57,2.0,2.1052631578947367,436,379
22400461,3,52,2.0,2.307692307692308,375,323
22400461,3,63,1.0,0.9523809523809523,323,260
22400461,3,16,2.0,7.5,244,228
22400461,3,70,5.0,4.285714285714286,218,148
22400461,3,141,-3.0,-1.2765957446808511,141,0
22400461,4,140,0.0,0.0,720,580
22400461,4,51,2.0,2.3529411764705883,580,529
22400461,4,46,1.0,1.3043478260869565,505,459
22400461,4,208,-3.0,-0.8653846153846154,450,242
22400461,4,32,3.0,5.625,234,202
22400461,4,195,-6.0,-1.8461538461538463,195,0
22400462,1,323,6.0,1.1145510835913313,720,397
22400462,1,18,0.0,0.0,395,377
22400462,1,133,-2.0,-0.9022556390977443,372,239
22400462,1,79,3.0,2.278481012658228,230,151
22400462,1,66,-4.0,-3.6363636363636367,139,73
22400462,1,44,-3.0,-4.090909090909091,73,29
22400462,1,19,0.0,0.0,29,10
22400462,1,250,-1.0,-0.24,250,0
22400462,2,205,-2.0,-0.5853658536585366,720,515
22400462,2,3,-2.0,-40.0,508,505
22400462,2,60,1.0,1.0,494,434
22400462,2,137,-1.0,-0.437956204379562,420,283
22400462,2,132,5.0,2.272727272727273,283,151
22400462,2,138,2.0,0.8695652173913043,138,0
22400462,3,304,-9.0,-1.776315789473684,720,416
22400462,3,104,-1.0,-0.576923076923077,416,312
22400462,3,70,0.0,0.0,299,229
22400462,3,19,-2.0,-6.315789473684211,212,193
22400462,3,133,-3.0,-1.3533834586466165,185,52
22400462,3,35,0.0,0.0,38,3
22400462,4,108,4.0,2.2222222222222223,720,612
22400462,4,156,2.0,0.7692307692307692,602,446
22400462,4,22,-3.0,-8.181818181818182,434,412
22400462,4,34,-2.0,-3.5294117647058822,394,360
22400462,4,58,0.0,0.0,351,293
22400462,4,27,1.0,2.2222222222222223,281,254
22400462,4,100,-1.0,-0.6,254,154
22400462,4,147,7.0,2.8571428571428568,154,7
22400462,4,6,2.0,20.0,6,0
22400463,1,399,-9.0,-1.3533834586466165,720,321
22400463,1,73,-2.0,-1.643835616438356,310,237
22400463,1,153,-7.0,-2.7450980392156863,223,70
22400463,1,70,2.0,1.7142857142857142,70,0
22400463,2,190,2.0,0.631578947368421,720,530
22400463,2,63,0.0,0.0,524,461
22400463,2,111,-2.0,-1.0810810810810811,446,335
22400463,2,29,0.0,0.0,226,197
22400463,2,148,-2.0,-0.8108108108108109,197,49
22400463,2,49,1.0,1.2244897959183672,49,0
22400463,3,267,-5.0,-1.1235955056179776,720,453
22400463,3,99,-1.0,-0.6060606060606061,437,338
22400463,3,49,2.0,2.4489795918367343,338,289
22400463,3,158,-3.0,-1.139240506329114,272,114
22400463,3,86,1.0,0.6976744186046512,92,6
22400463,3,3,0.0,0.0,3,0
22400463,4,177,5.0,1.694915254237288,720,543
22400463,4,29,1.0,2.0689655172413794,523,494
22400463,4,60,3.0,3.0,494,434
22400463,4,64,0.0,0.0,411,347
22400463,4,225,-2.0,-0.5333333333333333,347,122
22400463,4,69,2.0,1.7391304347826086,100,31
22400463,4,24,2.0,5.0,24,0
22400464,1,367,7.0,1.1444141689373297,720,353
22400464,1,189,0.0,0.0,343,154
22400464,1,34,1.0,1.7647058823529411,147,113
22400464,1,96,-1.0,-0.625,113,17
22400464,1,17,0.0,0.0,17,0
22400464,2,179,-4.0,-1.340782122905028,720,541
22400464,2,10,0.0,0.0,523,513
22400464,2,4,-2.0,-30.0,489,485
22400464,2,118,0.0,0.0,485,367
22400464,2,46,2.0,2.608695652173913,348,302
22400464,2,107,-4.0,-2.2429906542056073,302,195
22400464,2,26,0.0,0.0,179,153
22400464,2,141,-4.0,-1.702127659574468,141,0
22400464,3,404,4.0,0.594059405940594,720,316
22400464,3,50,1.0,1.2,306,256
22400464,3,68,-6.0,-5.294117647058824,225,157
22400464,3,35,2.0,3.4285714285714284,143,108
22400464,3,103,5.0,2.912621359223301,103,0
22400464,4,238,7.0,1.7647058823529411,720,482
22400464,4,28,-2.0,-4.285714285714286,470,442
22400464,4,88,-2.0,-1.3636363636363638,435,347
22400464,4,227,-6.0,-1.5859030837004406,335,108
22400464,4,73,5.0,4.10958904109589,94,21
22400464,4,2,0.0,0.0,5,3
22400464,4,1,0.0,0.0,1,0
22400465,1,271,10.0,2.2140221402214024,720,449
22400465,1,106,-1.0,-0.5660377358490566,429,323
22400465,1,72,-4.0,-3.333333333333333,323,251
22400465,1,168,-7.0,-2.5,251,83
22400465,1,83,0.0,0.0,83,0
22400465,2,135,-1.0,-0.4444444444444445,720,585
22400465,2,36,-3.0,-5.0,579,543
22400465,2,71,0.0,0.0,543,472
22400465,2,114,0.0,0.0,465,351
22400465,2,206,-2.0,-0.5825242718446602,275,69
22400465,2,46,1.0,1.3043478260869565,47,1
22400465,3,313,-8.0,-1.5335463258785942,720,407
22400465,3,57,-1.0,-1.0526315789473684,407,350
22400465,3,21,1.0,2.8571428571428568,335,314
22400465,3,104,3.0,1.7307692307692308,314,210
22400465,3,29,4.0,8.275862068965518,202,173
22400465,3,69,-2.0,-1.7391304347826086,173,104
22400465,3,104,4.0,2.307692307692308,104,0
22400465,4,75,-3.0,-2.4,720,645
22400465,4,66,-3.0,-2.7272727272727275,645,579
22400465,4,34,1.0,1.7647058823529411,579,545
22400465,4,30,0.0,0.0,545,515
22400465,4,74,-2.0,-1.6216216216216217,509,435
22400465,4,10,0.0,0.0,415,405
22400465,4,52,1.0,1.153846153846154,398,346
22400465,4,38,2.0,3.1578947368421053,346,308
22400465,4,112,4.0,2.142857142857143,308,196
22400465,4,113,7.0,3.7168141592920354,179,66
22400465,4,21,1.0,2.8571428571428568,44,23
22400465,4,4,0.0,0.0,4,0
22400466,1,315,-4.0,-0.7619047619047619,720,405
22400466,1,121,3.0,1.487603305785124,388,267
22400466,1,29,4.0,8.275862068965518,255,226
22400466,1,50,0.0,0.0,212,162
22400466,1,154,-10.0,-3.8961038961038956,154,0
22400466,2,277,0.0,0.0,720,443
22400466,2,10,0.0,0.0,430,420
22400466,2,41,-2.0,-2.926829268292683,408,367
22400466,2,45,-2.0,-2.666666666666667,367,322
22400466,2,76,2.0,1.5789473684210527,297,221
22400466,2,47,2.0,2.5531914893617023,212,165
22400466,2,20,-1.0,-3.0,158,138
22400466,2,43,3.0,4.186046511627907,138,95
22400466,2,39,-2.0,-3.0769230769230766,88,49
22400466,2,31,1.0,1.935483870967742,31,0
22400466,3,339,13.0,2.3008849557522124,720,381
22400466,3,68,5.0,4.411764705882353,381,313
22400466,3,122,0.0,0.0,299,177
22400466,3,85,-1.0,-0.7058823529411764,160,75
22400466,3,58,2.0,2.0689655172413794,75,17
22400466,4,191,5.0,1.5706806282722514,720,529
22400466,4,83,5.0,3.6144578313253013,514,431
22400466,4,69,-4.0,-3.4782608695652173,416,347
22400466,4,148,-5.0,-2.027027027027027,338,190
22400466,4,186,-2.0,-0.6451612903225807,186,0
22400467,1,359,8.0,1.3370473537604457,720,361
22400467,1,175,0.0,0.0,348,173
22400467,1,24,0.0,0.0,153,129
22400467,1,129,5.0,2.3255813953488373,129,0
22400467,2,248,-2.0,-0.4838709677419355,720,472
22400467,2,173,-4.0,-1.3872832369942196,404,231
22400467,2,214,5.0,1.4018691588785046,214,0
22400467,3,217,3.0,0.8294930875576038,720,503
22400467,3,68,0.0,0.0,499,431
22400467,3,160,2.0,0.75,431,271
22400467,3,37,3.0,4.864864864864865,271,234
22400467,3,1,0.0,0.0,227,226
22400467,3,147,1.0,0.40816326530612246,200,53
22400467,3,46,-1.0,-1.3043478260869565,53,7
22400467,3,7,0.0,0.0,7,0
22400467,4,169,5.0,1.7751479289940828,720,551
22400467,4,101,3.0,1.782178217821782,552,451
22400467,4,436,1.0,0.13761467889908258,436,0
22400468,1,325,-5.0,-0.9230769230769231,720,395
22400468,1,35,2.0,3.4285714285714284,395,360
22400468,1,122,-1.0,-0.49180327868852464,349,227
22400468,1,114,0.0,0.0,227,113
22400468,1,108,2.0,1.1111111111111112,108,0
22400468,2,143,0.0,0.0,720,577
22400468,2,121,-2.0,-0.9917355371900827,577,456
22400468,2,128,6.0,2.8125,442,314
22400468,2,73,0.0,0.0,314,241
22400468,2,80,6.0,4.5,241,161
22400468,2,150,8.0,3.2,150,0
22400468,3,310,4.0,0.7741935483870968,720,410
22400468,3,13,0.0,0.0,388,375
22400468,3,51,-4.0,-4.705882352941177,368,317
22400468,3,30,0.0,0.0,299,269
22400468,3,39,2.0,3.0769230769230766,255,216
22400468,3,57,1.0,1.0526315789473684,210,153
22400468,3,143,0.0,0.0,143,0
22400468,4,136,2.0,0.8823529411764706,720,584
22400468,4,140,-3.0,-1.2857142857142858,575,435
22400468,4,146,-1.0,-0.410958904109589,406,260
22400468,4,33,-4.0,-7.272727272727273,252,219
22400468,4,213,3.0,0.8450704225352113,219,6
22400468,4,6,0.0,0.0,6,0
22400469,1,360,4.0,0.6666666666666667,720,360
22400469,1,22,0.0,0.0,351,329
22400469,1,9,0.0,0.0,329,320
22400469,1,127,1.0,0.47244094488188976,296,169
22400469,1,53,0.0,0.0,169,116
22400469,1,39,-1.0,-1.5384615384615383,99,60
22400469,1,39,-3.0,-4.615384615384616,47,8
22400469,2,67,0.0,0.0,720,653
22400469,2,102,0.0,0.0,653,551
22400469,2,29,4.0,8.275862068965518,546,517
22400469,2,43,1.0,1.3953488372093024,504,461
22400469,2,65,0.0,0.0,442,377
22400469,2,63,1.0,0.9523809523809523,375,312
22400469,2,65,0.0,0.0,312,247
22400469,2,6,-2.0,-20.0,227,221
22400469,2,47,0.0,0.0,221,174
22400469,2,123,-5.0,-2.4390243902439024,158,35
22400469,3,309,4.0,0.7766990291262136,720,411
22400469,3,73,4.0,3.287671232876712,409,336
22400469,3,57,-3.0,-3.1578947368421053,324,267
22400469,3,129,0.0,0.0,246,117
22400469,3,57,1.0,1.0526315789473684,112,55
22400469,4,96,2.0,1.25,720,624
22400469,4,28,-2.0,-4.285714285714286,602,574
22400469,4,23,0.0,0.0,559,536
22400469,4,71,0.0,0.0,536,465
22400469,4,180,6.0,2.0,457,277
22400469,4,36,-2.0,-3.333333333333333,268,232
22400469,4,63,-1.0,-0.9523809523809523,214,151
22400469,4,46,2.0,2.608695652173913,151,105
22400469,4,86,-3.0,-2.0930232558139537,105,19
22400469,4,2,0.0,0.0,15,13
22400469,4,1,0.0,0.0,13,12
22400469,4,2,1.0,30.0,2,0
22400470,1,315,-5.0,-0.9523809523809523,720,405
22400470,1,56,0.0,0.0,394,338
22400470,1,49,-3.0,-3.673469387755102,327,278
22400470,1,68,-3.0,-2.647058823529412,275,207
22400470,1,48,-1.0,-1.25,197,149
22400470,2,121,4.0,1.9834710743801653,720,599
22400470,2,40,0.0,0.0,575,535
22400470,2,29,-2.0,-4.137931034482759,517,488
22400470,2,43,-5.0,-6.976744186046512,479,436
22400470,2,173,-1.0,-0.3468208092485549,423,250
22400470,2,58,0.0,0.0,244,186
22400470,2,168,3.0,1.0714285714285714,168,0
22400470,3,152,-5.0,-1.9736842105263157,720,568
22400470,3,175,-5.0,-1.7142857142857142,550,375
22400470,3,156,-1.0,-0.3846153846153846,357,201
22400470,3,20,0.0,0.0,195,175
22400470,3,123,0.0,0.0,175,52
22400470,3,30,-1.0,-2.0,30,0
22400470,4,163,8.0,2.9447852760736195,720,557
22400470,4,69,-1.0,-0.8695652173913043,533,464
22400470,4,145,1.0,0.41379310344827586,464,319
22400470,4,53,2.0,2.2641509433962264,310,257
22400470,4,35,-2.0,-3.4285714285714284,241,206
22400470,4,183,5.0,1.639344262295082,183,0
22400471,1,271,1.0,0.22140221402214022,720,449
22400471,1,216,-11.0,-3.0555555555555554,440,224
22400471,1,88,1.0,0.6818181818181819,208,120
22400471,1,118,3.0,1.5254237288135595,118,0
22400471,2,264,-4.0,-0.9090909090909092,720,456
22400471,2,20,3.0,9.0,437,417
22400471,2,126,3.0,1.4285714285714284,406,280
22400471,2,23,0.0,0.0,262,239
22400471,2,64,-2.0,-1.875,209,145
22400471,2,43,0.0,0.0,145,102
22400471,2,75,-3.0,-2.4,102,27
22400471,2,27,-2.0,-4.444444444444445,27,0
22400471,3,312,0.0,0.0,720,408
22400471,3,129,-3.0,-1.3953488372093024,406,277
22400471,3,71,-1.0,-0.8450704225352113,258,187
22400471,3,62,0.0,0.0,187,125
22400471,3,125,3.0,1.44,125,0
22400471,4,80,-4.0,-3.0,720,640
22400471,4,14,0.0,0.0,640,626
22400471,4,84,-7.0,-5.0,607,523
22400471,4,92,2.0,1.3043478260869565,505,413
22400471,4,110,0.0,0.0,403,293
22400471,4,51,0.0,0.0,283,232
22400471,4,230,-2.0,-0.5217391304347826,230,0
22400472,1,355,0.0,0.0,720,365
22400472,1,43,0.0,0.0,365,322
22400472,1,37,-2.0,-3.2432432432432434,322,285
22400472,1,87,0.0,0.0,273,186
22400472,1,132,-1.0,-0.4545454545454546,144,12
22400472,1,8,0.0,0.0,12,4
22400472,2,105,4.0,2.285714285714286,720,615
22400472,2,160,4.0,1.5,615,455
22400472,2,16,3.0,11.25,451,435
22400472,2,65,-2.0,-1.8461538461538463,430,365
22400472,2,198,-1.0,-0.30303030303030304,365,167
22400472,2,68,0.0,0.0,144,76
22400472,2,76,-5.0,-3.9473684210526314,76,0
22400472,3,94,5.0,3.1914893617021276,720,626
22400472,3,74,7.0,5.675675675675676,626,552
22400472,3,111,0.0,0.0,535,424
22400472,3,66,2.0,1.8181818181818183,424,358
22400472,3,123,-3.0,-1.4634146341463414,358,235
22400472,3,27,-2.0,-4.444444444444445,215,188
22400472,3,176,0.0,0.0,182,6
22400472,4,196,8.0,2.4489795918367343,720,524
22400472,4,44,-2.0,-2.7272727272727275,524,480
22400472,4,10,0.0,0.0,473,463
22400472,4,49,2.0,2.4489795918367343,448,399
22400472,4,332,4.0,0.7228915662650602,598,266
22400472,4,199,1.0,0.30150753768844224,266,67
22400472,4,67,-3.0,-2.6865671641791042,67,0
22400473,1,375,-5.0,-0.8,720,345
22400473,1,79,6.0,4.556962025316456,340,261
22400473,1,14,0.0,0.0,261,247
22400473,1,147,1.0,0.40816326530612246,238,91
22400473,1,48,0.0,0.0,71,23
22400473,1,5,2.0,24.0,5,0
22400473,2,164,-1.0,-0.36585365853658536,720,556
22400473,2,106,-3.0,-1.6981132075471699,543,437
22400473,2,40,-5.0,-7.5,364,324
22400473,2,204,-6.0,-1.7647058823529411,310,106
22400473,2,106,-3.0,-1.6981132075471699,106,0
22400473,3,419,5.0,0.7159904534606205,720,301
22400473,3,47,-4.0,-5.1063829787234045,286,239
22400473,3,29,2.0,4.137931034482759,239,210
22400473,3,46,3.0,3.9130434782608696,210,164
22400473,3,74,0.0,0.0,164,90
22400473,3,61,0.0,0.0,90,29
22400473,3,29,0.0,0.0,29,0
22400473,4,189,6.0,1.9047619047619047,720,531
22400473,4,71,1.0,0.8450704225352113,508,437
22400473,4,34,-2.0,-3.5294117647058822,431,397
22400473,4,179,4.0,1.340782122905028,389,210
22400473,4,210,8.0,2.285714285714286,210,0
22400474,1,262,-7.0,-1.6030534351145038,720,458
22400474,1,13,3.0,13.846153846153847,447,434
22400474,1,89,0.0,0.0,417,328
22400474,1,105,4.0,2.285714285714286,328,223
22400474,1,63,-4.0,-3.8095238095238093,217,154
22400474,1,14,0.0,0.0,140,126
22400474,1,124,-7.0,-3.3870967741935485,124,0
22400474,2,76,-5.0,-3.9473684210526314,720,644
22400474,2,31,0.0,0.0,632,601
22400474,2,109,3.0,1.651376146788991,601,492
22400474,2,25,0.0,0.0,483,458
22400474,2,59,0.0,0.0,445,386
22400474,2,16,0.0,0.0,386,370
22400474,2,92,-1.0,-0.6521739130434783,363,271
22400474,2,18,1.0,3.333333333333333,249,231
22400474,2,78,3.0,2.307692307692308,231,153
22400474,2,135,-1.0,-0.4444444444444445,135,0
22400474,3,236,-6.0,-1.5254237288135595,720,484
22400474,3,14,3.0,12.857142857142856,469,455
22400474,3,17,0.0,0.0,441,424
22400474,3,150,-4.0,-1.6,424,274
22400474,3,44,0.0,0.0,274,230
22400474,3,44,5.0,6.818181818181818,230,186
22400474,3,154,2.0,0.7792207792207793,167,13
22400474,3,1,2.0,120.0,1,0
22400474,4,82,0.0,0.0,720,638
22400474,4,89,4.0,2.696629213483146,626,537
22400474,4,42,-4.0,-5.7142857142857135,537,495
22400474,4,58,4.0,4.137931034482759,495,437
22400474,4,21,2.0,5.7142857142857135,437,416
22400474,4,57,-2.0,-2.1052631578947367,403,346
22400474,4,43,-2.0,-2.7906976744186047,290,247
22400474,4,235,4.0,1.0212765957446808,235,0
22400475,1,357,-8.0,-1.3445378151260505,720,363
22400475,1,138,-2.0,-0.8695652173913043,348,210
22400475,1,94,7.0,4.468085106382978,201,107
22400475,1,91,-1.0,-0.6593406593406594,91,0
22400475,2,214,-8.0,-2.2429906542056073,720,506
22400475,2,92,0.0,0.0,494,402
22400475,2,34,-2.0,-3.5294117647058822,402,368
22400475,2,11,0.0,0.0,368,357
22400475,2,54,0.0,0.0,344,290
22400475,2,49,2.0,2.4489795918367343,290,241
22400475,2,12,0.0,0.0,234,222
22400475,2,31,0.0,0.0,212,181
22400475,2,167,1.0,0.3592814371257485,181,14
22400475,2,5,0.0,0.0,14,9
22400475,3,405,9.0,1.3333333333333335,720,315
22400475,3,54,-2.0,-2.2222222222222223,305,251
22400475,3,11,2.0,10.90909090909091,241,230
22400475,3,134,-1.0,-0.44776119402985076,230,96
22400475,3,86,1.0,0.6976744186046512,86,0
22400475,4,248,-8.0,-1.935483870967742,720,472
22400475,4,43,0.0,0.0,463,420
22400475,4,62,0.0,0.0,406,344
22400475,4,127,4.0,1.889763779527559,330,203
22400476,1,301,-1.0,-0.19933554817275748,720,419
22400476,1,5,1.0,12.0,401,396
22400476,1,52,-3.0,-3.4615384615384617,396,344
22400476,1,111,5.0,2.7027027027027026,344,233
22400476,1,64,2.0,1.875,217,153
22400476,1,133,5.0,2.2556390977443606,133,0
22400476,2,159,-5.0,-1.8867924528301887,720,561
22400476,2,67,3.0,2.6865671641791042,561,494
22400476,2,77,-1.0,-0.7792207792207793,470,393
22400476,2,3,0.0,0.0,393,390
22400476,2,29,2.0,4.137931034482759,383,354
22400476,2,143,0.0,0.0,347,204
22400476,2,128,-1.0,-0.46875,199,71
22400476,2,70,0.0,0.0,71,1
22400476,2,1,0.0,0.0,1,0
22400476,3,107,9.0,5.046728971962617,720,613
22400476,3,57,-2.0,-2.1052631578947367,594,537
22400476,3,239,-3.0,-0.7531380753138075,690,451
22400476,3,169,-4.0,-1.4201183431952662,451,282
22400476,3,49,0.0,0.0,268,219
22400476,3,54,-2.0,-2.2222222222222223,205,151
22400476,3,64,-3.0,-2.8125,151,87
22400476,4,64,-1.0,-0.9375,720,656
22400476,4,74,2.0,1.6216216216216217,656,582
22400476,4,63,2.0,1.9047619047619047,582,519
22400476,4,27,-2.0,-4.444444444444445,503,476
22400476,4,21,3.0,8.571428571428571,450,429
22400476,4,8,0.0,0.0,413,405
22400476,4,110,4.0,2.1818181818181817,405,295
22400476,4,51,0.0,0.0,282,231
22400476,4,188,0.0,0.0,231,43
22400476,4,38,-1.0,-1.5789473684210527,43,5
22400477,1,334,1.0,0.17964071856287425,720,386
22400477,1,77,3.0,2.3376623376623376,384,307
22400477,1,36,0.0,0.0,307,271
22400477,1,106,-1.0,-0.5660377358490566,267,161
22400477,1,61,-3.0,-2.9508196721311473,161,100
22400477,1,87,-1.0,-0.6896551724137931,87,0
22400477,2,103,2.0,1.1650485436893203,720,617
22400477,2,132,0.0,0.0,610,478
22400477,2,15,1.0,4.0,469,454
22400477,2,31,0.0,0.0,454,423
22400477,2,47,3.0,3.829787234042553,409,362
22400477,2,182,-1.0,-0.3296703296703297,362,180
22400477,2,21,-3.0,-8.571428571428571,164,143
22400477,2,131,5.0,2.290076335877863,131,0
22400477,3,292,-1.0,-0.2054794520547945,720,428
22400477,3,36,0.0,0.0,423,387
22400477,3,164,-3.0,-1.097560975609756,383,219
22400477,3,102,2.0,1.1764705882352942,219,117
22400477,3,107,2.0,1.1214953271028036,107,0
22400477,4,199,0.0,0.0,720,521
22400477,4,56,2.0,2.142857142857143,521,465
22400477,4,95,4.0,2.526315789473684,453,358
22400477,4,59,-2.0,-2.0338983050847457,346,287
22400477,4,173,1.0,0.3468208092485549,274,101
22400477,4,91,2.0,1.3186813186813189,91,0
22400478,1,325,-1.0,-0.18461538461538463,720,395
22400478,1,99,-7.0,-4.242424242424242,376,277
22400478,1,71,-3.0,-2.535211267605634,262,191
22400478,1,191,-3.0,-0.9424083769633508,191,0
22400478,2,148,-2.0,-0.8108108108108109,720,572
22400478,2,50,2.0,2.4,555,505
22400478,2,32,1.0,1.875,494,462
22400478,2,57,0.0,0.0,462,405
22400478,2,107,-1.0,-0.5607476635514018,405,298
22400478,2,67,1.0,0.8955223880597015,298,231
22400478,2,143,-4.0,-1.6783216783216783,231,88
22400478,2,88,-2.0,-1.3636363636363638,88,0
22400478,3,314,-7.0,-1.3375796178343948,720,406
22400478,3,100,1.0,0.6,385,285
22400478,3,39,1.0,1.5384615384615383,285,246
22400478,3,68,0.0,0.0,246,178
22400478,3,158,-2.0,-0.7594936708860759,162,4
22400478,3,4,0.0,0.0,4,0
22400478,4,65,-3.0,-2.769230769230769,720,655
22400478,4,114,2.0,1.0526315789473684,645,531
22400478,4,121,-3.0,-1.487603305785124,531,410
22400478,4,340,1.0,0.1764705882352941,397,57
22400478,4,57,0.0,0.0,57,0
22400479,1,407,3.0,0.44226044226044225,720,313
22400479,1,74,-3.0,-2.4324324324324325,305,231
22400479,1,110,3.0,1.6363636363636362,214,104
22400479,1,82,0.0,0.0,104,22
22400479,2,213,11.0,3.098591549295775,720,507
22400479,2,40,2.0,3.0,494,454
22400479,2,27,0.0,0.0,448,421
22400479,2,41,0.0,0.0,406,365
22400479,2,126,-1.0,-0.47619047619047616,347,221
22400479,2,87,2.0,1.3793103448275863,214,127
22400479,2,20,0.0,0.0,127,107
22400479,2,66,-3.0,-2.7272727272727275,94,28
22400479,3,237,8.0,2.0253164556962022,720,483
22400479,3,52,-3.0,-3.4615384615384617,483,431
22400479,3,24,3.0,7.5,416,392
22400479,3,160,1.0,0.375,370,210
22400479,3,106,2.0,1.1320754716981132,210,104
22400479,3,104,-5.0,-2.8846153846153846,104,0
22400479,4,52,-2.0,-2.307692307692308,720,668
22400479,4,143,1.0,0.4195804195804196,659,516
22400479,4,57,-3.0,-3.1578947368421053,493,436
22400479,4,35,3.0,5.142857142857143,436,401
22400479,4,41,2.0,2.926829268292683,401,360
22400479,4,58,-2.0,-2.0689655172413794,348,290
22400479,4,57,0.0,0.0,290,233
22400479,4,53,2.0,2.2641509433962264,215,162
22400479,4,162,-2.0,-0.7407407407407407,162,0
22400480,1,336,2.0,0.3571428571428571,720,384
22400480,1,90,0.0,0.0,375,285
22400480,1,5,-1.0,-12.0,276,271
22400480,1,142,-3.0,-1.267605633802817,271,129
22400480,1,129,2.0,0.9302325581395349,129,0
22400480,2,147,3.0,1.2244897959183672,720,573
22400480,2,88,-6.0,-4.090909090909091,562,474
22400480,2,40,0.0,0.0,461,421
22400480,2,137,-1.0,-0.437956204379562,415,278
22400480,2,73,-3.0,-2.4657534246575343,229,156
22400480,2,140,4.0,1.7142857142857142,140,0
22400480,3,221,5.0,1.3574660633484164,720,499
22400480,3,23,3.0,7.826086956521739,499,476
22400480,3,235,0.0,0.0,461,226
22400480,3,9,-1.0,-6.666666666666666,226,217
22400480,3,41,2.0,2.926829268292683,217,176
22400480,3,64,-1.0,-0.9375,176,112
22400480,3,78,4.0,3.0769230769230766,112,34
22400480,4,101,-3.0,-1.782178217821782,720,619
22400480,4,30,2.0,4.0,619,589
22400480,4,141,-1.0,-0.425531914893617,584,443
22400480,4,183,1.0,0.32786885245901637,429,246
22400480,4,171,6.0,2.1052631578947367,225,54
22400480,4,44,-2.0,-2.7272727272727275,44,0
22400481,1,243,7.0,1.7283950617283952,720,477
22400481,1,132,-3.0,-1.3636363636363638,477,345
22400481,1,16,0.0,0.0,325,309
22400481,1,91,0.0,0.0,305,214
22400481,1,28,0.0,0.0,203,175
22400481,1,25,0.0,0.0,162,137
22400481,1,83,-1.0,-0.7228915662650602,131,48
22400481,1,42,0.0,0.0,42,0
22400481,2,177,-9.0,-3.050847457627119,720,543
22400481,2,44,-3.0,-4.090909090909091,534,490
22400481,2,148,-1.0,-0.40540540540540543,476,328
22400481,2,108,-3.0,-1.6666666666666665,326,218
22400481,2,65,-4.0,-3.6923076923076925,206,141
22400481,2,138,-2.0,-0.8695652173913043,138,0
22400481,3,190,-6.0,-1.8947368421052633,720,530
22400481,3,97,-3.0,-1.8556701030927836,518,421
22400481,3,24,-1.0,-2.5,412,388
22400481,3,90,0.0,0.0,388,298
22400481,3,47,-2.0,-2.5531914893617023,283,236
22400481,3,69,3.0,2.608695652173913,226,157
22400481,3,29,-2.0,-4.137931034482759,146,117
22400481,3,104,4.0,2.307692307692308,104,0
22400481,4,166,-8.0,-2.891566265060241,720,554
22400481,4,97,2.0,1.2371134020618557,542,445
22400481,4,40,-5.0,-7.5,439,399
22400481,4,390,3.0,0.46153846153846156,390,0
22400482,1,312,-7.0,-1.3461538461538463,720,408
22400482,1,98,1.0,0.6122448979591836,394,296
22400482,1,80,-2.0,-1.5,296,216
22400482,1,12,0.0,0.0,204,192
22400482,1,148,0.0,0.0,182,34
22400482,1,34,3.0,5.294117647058824,34,0
22400482,2,147,-2.0,-0.8163265306122449,720,573
22400482,2,26,0.0,0.0,573,547
22400482,2,63,0.0,0.0,547,484
22400482,2,31,-1.0,-1.935483870967742,474,443
22400482,2,19,-1.0,-3.1578947368421053,443,424
22400482,2,121,4.0,1.9834710743801653,424,303
22400482,2,174,0.0,0.0,286,112
22400482,2,112,-2.0,-1.0714285714285714,112,0
22400482,3,254,4.0,0.9448818897637795,720,466
22400482,3,170,7.0,2.4705882352941178,459,289
22400482,3,90,4.0,2.666666666666667,282,192
22400482,3,19,2.0,6.315789473684211,173,154
22400482,3,154,7.0,2.7272727272727275,154,0
22400482,4,158,2.0,0.7594936708860759,720,562
22400482,4,17,0.0,0.0,559,542
22400482,4,24,-3.0,-7.5,532,508
22400482,4,31,0.0,0.0,501,470
22400482,4,98,-9.0,-5.510204081632653,470,372
22400482,4,44,3.0,4.090909090909091,365,321
22400482,4,19,0.0,0.0,321,302
22400482,4,191,2.0,0.6282722513089005,285,94
22400483,1,355,1.0,0.16901408450704225,720,365
22400483,1,35,0.0,0.0,345,310
22400483,1,60,1.0,1.0,310,250
22400483,1,12,-1.0,-5.0,250,238
22400483,1,156,2.0,0.7692307692307692,238,82
22400483,1,69,4.0,3.4782608695652173,69,0
22400483,2,173,-1.0,-0.3468208092485549,720,547
22400483,2,188,-4.0,-1.2765957446808511,497,309
22400483,2,81,5.0,3.7037037037037033,295,214
22400483,2,12,0.0,0.0,214,202
22400483,3,395,-2.0,-0.3037974683544304,720,325
22400483,3,25,0.0,0.0,238,213
22400483,3,91,4.0,2.6373626373626378,207,116
22400483,3,107,5.0,2.803738317757009,107,0
22400483,4,130,-4.0,-1.8461538461538463,720,590
22400483,4,79,-1.0,-0.7594936708860759,590,511
22400483,4,61,0.0,0.0,511,450
22400483,4,140,5.0,2.142857142857143,450,310
22400483,4,287,-2.0,-0.4181184668989547,295,8
22400484,1,216,4.0,1.1111111111111112,720,504
22400484,1,53,-2.0,-2.2641509433962264,433,380
22400484,1,49,-2.0,-2.4489795918367343,368,319
22400484,1,89,6.0,4.044943820224719,319,230
22400484,1,160,-5.0,-1.875,218,58
22400484,1,46,5.0,6.521739130434782,46,0
22400484,2,200,-1.0,-0.3,720,520
22400484,2,71,6.0,5.070422535211268,520,449
22400484,2,175,3.0,1.0285714285714287,438,263
22400484,2,12,0.0,0.0,263,251
22400484,2,66,0.0,0.0,238,172
22400484,2,119,-1.0,-0.5042016806722689,159,40
22400484,2,35,-2.0,-3.4285714285714284,35,0
22400484,3,410,9.0,1.3170731707317072,720,310
22400484,3,45,0.0,0.0,307,262
22400484,3,65,2.0,1.8461538461538463,258,193
22400484,3,111,0.0,0.0,184,73
22400484,3,73,3.0,2.4657534246575343,73,0
22400484,4,83,-1.0,-0.7228915662650602,720,637
22400484,4,78,-2.0,-1.5384615384615383,628,550
22400484,4,32,0.0,0.0,533,501
22400484,4,14,0.0,0.0,501,487
22400484,4,67,0.0,0.0,477,410
22400484,4,112,-1.0,-0.5357142857142857,410,298
22400484,4,53,-3.0,-3.3962264150943398,298,245
22400484,4,160,-4.0,-1.5,226,66
22400484,4,52,0.0,0.0,66,14
22400484,4,14,0.0,0.0,14,0
22400484,5,169,-4.0,-1.4201183431952662,300,131
22400484,5,131,-5.0,-2.290076335877863,131,0
22400485,1,338,7.0,1.2426035502958581,720,382
22400485,1,58,0.0,0.0,372,314
22400485,1,48,1.0,1.25,292,244
22400485,1,115,0.0,0.0,229,114
22400485,1,114,-6.0,-3.1578947368421053,114,0
22400485,2,83,8.0,5.783132530120482,720,637
22400485,2,98,0.0,0.0,614,516
22400485,2,6,0.0,0.0,516,510
22400485,2,29,-4.0,-8.275862068965518,502,473
22400485,2,61,0.0,0.0,451,390
22400485,2,32,2.0,3.75,390,358
22400485,2,90,-5.0,-3.333333333333333,356,266
22400485,2,49,-2.0,-2.4489795918367343,252,203
22400485,2,47,0.0,0.0,194,147
22400485,2,55,1.0,1.0909090909090908,147,92
22400485,2,71,1.0,0.8450704225352113,92,21
22400485,2,4,0.0,0.0,4,0
22400485,3,299,0.0,0.0,720,421
22400485,3,65,1.0,0.9230769230769231,415,350
22400485,3,36,-2.0,-3.333333333333333,350,314
22400485,3,150,3.0,1.2,312,162
22400485,3,26,0.0,0.0,151,125
22400485,3,73,1.0,0.821917808219178,114,41
22400485,3,33,-3.0,-5.454545454545455,33,0
22400485,4,36,-3.0,-5.0,720,684
22400485,4,81,3.0,2.2222222222222223,673,592
22400485,4,56,-2.0,-2.142857142857143,580,524
22400485,4,203,3.0,0.8866995073891625,504,301
22400485,4,82,0.0,0.0,289,207
22400485,4,200,1.0,0.3,200,0
22400486,1,309,-1.0,-0.1941747572815534,720,411
22400486,1,129,5.0,2.3255813953488373,411,282
22400486,1,105,6.0,3.4285714285714284,271,166
22400486,1,166,-12.0,-4.337349397590361,166,0
22400486,2,115,1.0,0.5217391304347826,720,605
22400486,2,95,5.0,3.1578947368421053,599,504
22400486,2,127,1.0,0.47244094488188976,489,362
22400486,2,38,2.0,3.1578947368421053,362,324
22400486,2,28,5.0,10.714285714285715,315,287
22400486,2,42,3.0,4.285714285714286,287,245
22400486,2,145,3.0,1.2413793103448276,233,88
22400486,2,88,-5.0,-3.409090909090909,88,0
22400486,3,216,-5.0,-1.3888888888888888,720,504
22400486,3,82,5.0,3.6585365853658534,491,409
22400486,3,52,1.0,1.153846153846154,409,357
22400486,3,69,2.0,1.7391304347826086,335,266
22400486,3,11,0.0,0.0,254,243
22400486,3,234,1.0,0.25641025641025644,234,0
22400486,4,175,1.0,0.34285714285714286,720,545
22400486,4,99,-1.0,-0.6060606060606061,545,446
22400486,4,104,2.0,1.153846153846154,446,342
22400486,4,20,0.0,0.0,326,306
22400486,4,282,2.0,0.425531914893617,282,0
22400487,1,314,2.0,0.3821656050955414,720,406
22400487,1,22,-1.0,-2.7272727272727275,392,370
22400487,1,122,-5.0,-2.4590163934426226,370,248
22400487,1,224,2.0,0.5357142857142857,227,3
22400487,1,3,0.0,0.0,3,0
22400487,2,162,-2.0,-0.7407407407407407,720,558
22400487,2,28,-2.0,-4.285714285714286,552,524
22400487,2,59,0.0,0.0,513,454
22400487,2,51,-2.0,-2.3529411764705883,454,403
22400487,2,167,0.0,0.0,392,225
22400487,2,14,2.0,8.571428571428571,220,206
22400487,2,49,0.0,0.0,206,157
22400487,2,16,-1.0,-3.75,143,127
22400487,3,315,2.0,0.38095238095238093,720,405
22400487,3,26,0.0,0.0,399,373
22400487,3,89,0.0,0.0,365,276
22400487,3,47,2.0,2.5531914893617023,276,229
22400487,3,86,-2.0,-1.3953488372093024,217,131
22400487,3,113,3.0,1.592920353982301,118,5
22400487,4,231,6.0,1.5584415584415585,720,489
22400487,4,59,-1.0,-1.0169491525423728,478,419
22400487,4,72,5.0,4.166666666666667,419,347
22400487,4,156,-1.0,-0.3846153846153846,333,177
22400487,4,158,7.0,2.6582278481012658,158,0
22400488,1,293,0.0,0.0,720,427
22400488,1,89,-5.0,-3.3707865168539324,410,321
22400488,1,7,0.0,0.0,315,308
22400488,1,108,6.0,3.333333333333333,290,182
22400488,1,66,2.0,1.8181818181818183,169,103
22400488,2,117,3.0,1.5384615384615383,720,603
22400488,2,41,5.0,7.317073170731707,589,548
22400488,2,72,0.0,0.0,526,454
22400488,2,87,7.0,4.827586206896552,439,352
22400488,2,50,4.0,4.8,352,302
22400488,2,72,-3.0,-2.5,302,230
22400488,2,191,-3.0,-0.9424083769633508,230,39
22400488,2,39,-3.0,-4.615384615384616,39,0
22400488,3,204,2.0,0.5882352941176471,720,516
22400488,3,88,-5.0,-3.409090909090909,516,428
22400488,3,113,0.0,0.0,413,300
22400488,3,61,2.0,1.9672131147540985,291,230
22400488,3,217,-6.0,-1.6589861751152075,230,13
22400488,4,87,2.0,1.3793103448275863,720,633
22400488,4,57,2.0,2.1052631578947367,633,576
22400488,4,110,3.0,1.6363636363636362,567,457
22400488,4,46,3.0,3.9130434782608696,445,399
22400488,4,172,-2.0,-0.6976744186046512,388,216
22400488,4,28,1.0,2.142857142857143,211,183
22400488,4,58,-4.0,-4.137931034482759,173,115
22400488,4,103,-5.0,-2.912621359223301,103,0
22400489,1,349,7.0,1.2034383954154728,720,371
22400489,1,88,-1.0,-0.6818181818181819,350,262
22400489,1,40,0.0,0.0,262,222
22400489,1,17,0.0,0.0,207,190
22400489,1,51,-12.0,-14.117647058823529,172,121
22400489,2,167,-5.0,-1.7964071856287425,720,553
22400489,2,23,0.0,0.0,536,513
22400489,2,48,4.0,5.0,496,448
22400489,2,34,1.0,1.7647058823529411,433,399
22400489,2,151,0.0,0.0,379,228
22400489,2,172,-3.0,-1.0465116279069768,228,56
22400489,2,11,-1.0,-5.454545454545455,42,31
22400489,3,185,-6.0,-1.945945945945946,720,535
22400489,3,267,7.0,1.5730337078651686,535,268
22400489,3,18,-2.0,-6.666666666666666,257,239
22400489,3,34,0.0,0.0,216,182
22400489,3,14,0.0,0.0,170,156
22400489,3,55,-2.0,-2.1818181818181817,141,86
22400489,3,62,5.0,4.838709677419355,62,0
22400489,4,197,-1.0,-0.3045685279187817,720,523
22400489,4,20,0.0,0.0,512,492
22400489,4,23,1.0,2.608695652173913,478,455
22400489,4,48,1.0,1.25,450,402
22400489,4,30,-5.0,-10.0,392,362
22400489,4,184,0.0,0.0,349,165
22400489,4,165,3.0,1.0909090909090908,165,0
22400490,1,390,2.0,0.3076923076923077,720,330
22400490,1,104,-4.0,-2.307692307692308,316,212
22400490,1,212,5.0,1.4150943396226416,212,0
22400490,2,149,-2.0,-0.8053691275167785,720,571
22400490,2,40,-4.0,-6.0,554,514
22400490,2,102,-2.0,-1.1764705882352942,505,403
22400490,2,66,2.0,1.8181818181818183,394,328
22400490,2,65,0.0,0.0,313,248
22400490,2,227,-2.0,-0.5286343612334802,227,0
22400490,3,164,-3.0,-1.097560975609756,720,556
22400490,3,120,0.0,0.0,535,415
22400490,3,51,-2.0,-2.3529411764705883,406,355
22400490,3,65,0.0,0.0,345,280
22400490,3,60,1.0,1.0,280,220
22400490,3,69,4.0,3.4782608695652173,205,136
22400490,3,55,-4.0,-4.363636363636363,136,81
22400490,4,92,-5.0,-3.260869565217391,720,628
22400490,4,91,0.0,0.0,620,529
22400490,4,127,-3.0,-1.4173228346456692,518,391
22400490,4,5,0.0,0.0,386,381
22400490,4,50,0.0,0.0,381,331
22400490,4,18,-3.0,-10.0,319,301
22400490,4,56,1.0,1.0714285714285714,288,232
22400490,4,77,5.0,3.8961038961038956,232,155
22400491,1,422,-4.0,-0.5687203791469195,720,298
22400491,1,68,4.0,3.5294117647058822,284,216
22400491,1,71,3.0,2.535211267605634,212,141
22400491,1,137,9.0,3.9416058394160585,137,0
22400491,2,81,3.0,2.2222222222222223,720,639
22400491,2,115,1.0,0.5217391304347826,633,518
22400491,2,61,-1.0,-0.9836065573770493,518,457
22400491,2,42,2.0,2.8571428571428568,436,394
22400491,2,16,0.0,0.0,382,366
22400491,2,22,0.0,0.0,366,344
22400491,2,174,-6.0,-2.0689655172413794,336,162
22400491,2,161,4.0,1.4906832298136645,162,1
22400491,2,1,0.0,0.0,1,0
22400491,3,50,1.0,1.2,720,670
22400491,3,430,-14.0,-1.9534883720930232,670,240
22400491,3,22,2.0,5.454545454545455,240,218
22400491,3,13,0.0,0.0,208,195
22400491,3,15,-1.0,-4.0,189,174
22400491,3,36,-3.0,-5.0,174,138
22400491,3,106,-3.0,-1.6981132075471699,138,32
22400491,3,18,-1.0,-3.333333333333333,32,14
22400491,3,14,0.0,0.0,14,0
22400491,4,93,5.0,3.2258064516129035,720,627
22400491,4,144,2.0,0.8333333333333333,618,474
22400491,4,71,0.0,0.0,457,386
22400491,4,61,-2.0,-1.9672131147540985,378,317
22400491,4,54,-4.0,-4.444444444444445,299,245
22400491,4,35,2.0,3.4285714285714284,245,210
22400491,4,30,1.0,2.0,197,167
22400491,4,160,-1.0,-0.375,167,7
22400492,1,348,-4.0,-0.6896551724137931,720,372
22400492,1,106,-5.0,-2.8301886792452833,366,260
22400492,1,16,0.0,0.0,246,230
22400492,1,32,2.0,3.75,219,187
22400492,1,32,-2.0,-3.75,187,155
22400492,1,134,0.0,0.0,147,13
22400492,1,13,2.0,9.230769230769232,13,0
22400492,2,123,1.0,0.48780487804878053,720,597
22400492,2,41,7.0,10.24390243902439,597,556
22400492,2,13,3.0,13.846153846153847,543,530
22400492,2,79,-8.0,-6.075949367088607,530,451
22400492,2,34,-3.0,-5.294117647058824,443,409
22400492,2,77,-1.0,-0.7792207792207793,394,317
22400492,2,9,-2.0,-13.333333333333332,302,293
22400492,2,83,-4.0,-2.891566265060241,293,210
22400492,2,156,-1.0,-0.3846153846153846,210,54
22400492,2,8,0.0,0.0,54,46
22400492,2,28,-3.0,-6.428571428571428,46,18
22400492,2,160,1.0,0.375,160,0
22400492,3,272,-1.0,-0.22058823529411764,720,448
22400492,3,30,0.0,0.0,434,404
22400492,3,41,4.0,5.853658536585366,401,360
22400492,3,81,-3.0,-2.2222222222222223,337,256
22400492,3,33,2.0,3.6363636363636367,250,217
22400492,3,31,3.0,5.806451612903226,217,186
22400492,3,117,-8.0,-4.102564102564103,172,55
22400492,4,217,-3.0,-0.8294930875576038,720,503
22400492,4,94,-1.0,-0.6382978723404256,493,399
22400492,4,387,4.0,0.6201550387596899,387,0
22400493,1,285,-9.0,-1.8947368421052633,720,435
22400493,1,27,-2.0,-4.444444444444445,435,408
22400493,1,85,2.0,1.4117647058823528,391,306
22400493,1,144,0.0,0.0,300,156
22400493,2,71,-8.0,-6.76056338028169,720,649
22400493,2,70,-6.0,-5.142857142857143,631,561
22400493,2,15,0.0,0.0,544,529
22400493,2,50,5.0,6.0,525,475
22400493,2,97,5.0,3.092783505154639,454,357
22400493,2,9,0.0,0.0,351,342
22400493,2,141,5.0,2.127659574468085,335,194
22400493,2,191,-2.0,-0.6282722513089005,191,0
22400493,3,283,8.0,1.696113074204947,720,437
22400493,3,65,-3.0,-2.769230769230769,437,372
22400493,3,38,3.0,4.7368421052631575,359,321
22400493,3,50,-3.0,-3.5999999999999996,309,259
22400493,3,123,0.0,0.0,258,135
22400493,3,5,0.0,0.0,117,112
22400493,3,71,-2.0,-1.6901408450704225,110,39
22400493,4,70,0.0,0.0,720,650
22400493,4,77,-2.0,-1.5584415584415585,634,557
22400493,4,116,5.0,2.586206896551724,546,430
22400493,4,194,-1.0,-0.30927835051546393,430,236
22400493,4,163,6.0,2.208588957055215,216,53
22400493,4,38,1.0,1.5789473684210527,38,0
22400494,1,309,14.0,2.7184466019417477,720,411
22400494,1,41,-2.0,-2.926829268292683,404,363
22400494,1,101,3.0,1.782178217821782,347,246
22400494,1,66,0.0,0.0,238,172
22400494,1,172,-2.0,-0.6976744186046512,172,0
22400494,2,96,1.0,0.625,720,624
22400494,2,117,1.0,0.5128205128205129,624,507
22400494,2,26,0.0,0.0,492,466
22400494,2,114,-6.0,-3.1578947368421053,466,352
22400494,2,119,5.0,2.521008403361345,352,233
22400494,2,111,0.0,0.0,226,115
22400494,2,97,2.0,1.2371134020618557,97,0
22400494,3,330,-5.0,-0.9090909090909092,720,390
22400494,3,71,-2.0,-1.6901408450704225,390,319
22400494,3,62,-3.0,-2.903225806451613,314,252
22400494,3,8,-1.0,-7.5,252,244
22400494,3,213,2.0,0.5633802816901409,244,31
22400494,4,215,-7.0,-1.9534883720930232,720,505
22400494,4,98,0.0,0.0,488,390
22400494,4,66,0.0,0.0,390,324
22400494,4,310,1.0,0.1935483870967742,310,0
22400495,1,281,0.0,0.0,720,439
22400495,1,26,0.0,0.0,427,401
22400495,1,95,0.0,0.0,383,288
22400495,1,18,2.0,6.666666666666666,272,254
22400495,1,83,4.0,2.891566265060241,244,161
22400495,1,154,-4.0,-1.5584415584415585,154,0
22400495,2,200,-5.0,-1.5,720,520
22400495,2,79,-2.0,-1.5189873417721518,504,425
22400495,2,27,2.0,4.444444444444445,425,398
22400495,2,111,3.0,1.6216216216216217,376,265
22400495,2,134,-3.0,-1.3432835820895521,265,131
22400495,2,124,-4.0,-1.935483870967742,131,7
22400495,2,7,0.0,0.0,7,0
22400495,3,174,-7.0,-2.413793103448276,720,546
22400495,3,212,3.0,0.8490566037735849,544,332
22400495,3,23,2.0,5.217391304347826,332,309
22400495,3,56,4.0,4.285714285714286,309,253
22400495,3,33,0.0,0.0,233,200
22400495,3,81,3.0,2.2222222222222223,179,98
22400495,3,49,2.0,2.4489795918367343,98,49
22400495,3,45,2.0,2.666666666666667,45,0
22400495,4,105,-5.0,-2.8571428571428568,720,615
22400495,4,27,0.0,0.0,615,588
22400495,4,53,4.0,4.528301886792453,581,528
22400495,4,54,-3.0,-3.333333333333333,528,474
22400495,4,78,-3.0,-2.307692307692308,470,392
22400495,4,21,-2.0,-5.7142857142857135,386,365
22400495,4,75,-4.0,-3.2,362,287
22400495,4,111,6.0,3.2432432432432434,273,162
22400495,4,30,3.0,6.0,139,109
22400495,4,13,1.0,4.615384615384616,109,96
22400495,4,96,1.0,0.625,96,0
22400496,1,331,5.0,0.9063444108761329,720,389
22400496,1,115,-2.0,-1.0434782608695652,375,260
22400496,1,42,-2.0,-2.8571428571428568,247,205
22400496,1,157,1.0,0.3821656050955414,193,36
22400496,1,19,-1.0,-3.1578947368421053,36,17
22400496,1,16,2.0,7.5,17,1
22400496,1,1,0.0,0.0,1,0
22400496,2,195,-2.0,-0.6153846153846154,720,525
22400496,2,51,-1.0,-1.1764705882352942,514,463
22400496,2,118,0.0,0.0,446,328
22400496,2,75,-4.0,-3.2,318,243
22400496,2,20,0.0,0.0,236,216
22400496,2,202,4.0,1.188118811881188,205,3
22400496,2,1,0.0,0.0,1,0
22400496,3,274,-5.0,-1.094890510948905,720,446
22400496,3,97,2.0,1.2371134020618557,432,335
22400496,3,64,2.0,1.875,329,265
22400496,3,14,0.0,0.0,239,225
22400496,3,98,1.0,0.6122448979591836,215,117
22400496,4,193,1.0,0.31088082901554404,720,527
22400496,4,141,-5.0,-2.127659574468085,527,386
22400496,4,121,1.0,0.49586776859504134,380,259
22400496,4,130,-4.0,-1.8461538461538463,259,129
22400496,4,64,1.0,0.9375,129,65
22400496,4,65,1.0,0.9230769230769231,65,0
22400497,1,318,0.0,0.0,720,402
22400497,1,137,-5.0,-2.18978102189781,402,265
22400497,1,118,-6.0,-3.050847457627119,246,128
22400497,1,66,1.0,0.9090909090909092,111,45
22400497,1,16,2.0,7.5,34,18
22400497,1,3,0.0,0.0,3,0
22400497,2,182,-1.0,-0.3296703296703297,720,538
22400497,2,10,-1.0,-6.0,538,528
22400497,2,62,2.0,1.935483870967742,528,466
22400497,2,27,0.0,0.0,453,426
22400497,2,32,-3.0,-5.625,424,392
22400497,2,86,-1.0,-0.6976744186046512,387,301
22400497,2,29,0.0,0.0,301,272
22400497,2,94,-1.0,-0.6382978723404256,272,178
22400497,2,178,-6.0,-2.0224719101123596,178,0
22400497,3,435,-10.0,-1.3793103448275863,720,285
22400497,3,28,0.0,0.0,275,247
22400497,3,23,0.0,0.0,241,218
22400497,3,81,-3.0,-2.2222222222222223,214,133
22400497,3,39,2.0,3.0769230769230766,133,94
22400497,4,324,-5.0,-0.9259259259259258,720,396
22400497,4,15,0.0,0.0,391,376
22400497,4,52,-2.0,-2.307692307692308,373,321
22400497,4,79,-1.0,-0.7594936708860759,315,236
22400497,4,232,5.0,1.293103448275862,232,0
22400498,1,257,-3.0,-0.7003891050583657,720,463
22400498,1,95,-2.0,-1.263157894736842,458,363
22400498,1,153,-1.0,-0.39215686274509803,351,198
22400498,1,56,1.0,1.0714285714285714,192,136
22400498,1,129,-2.0,-0.9302325581395349,129,0
22400498,2,129,-5.0,-2.3255813953488373,720,591
22400498,2,30,-3.0,-6.0,584,554
22400498,2,54,1.0,1.1111111111111112,542,488
22400498,2,100,1.0,0.6,475,375
22400498,2,4,0.0,0.0,367,363
22400498,2,110,-2.0,-1.0909090909090908,354,244
22400498,2,64,3.0,2.8125,236,172
22400498,2,144,-4.0,-1.6666666666666665,172,28
22400498,2,8,0.0,0.0,8,0
22400498,3,328,3.0,0.548780487804878,720,392
22400498,3,68,3.0,2.647058823529412,376,308
22400498,3,59,-3.0,-3.050847457627119,308,249
22400498,3,31,0.0,0.0,239,208
22400498,3,97,-2.0,-1.2371134020618557,198,101
22400498,3,94,0.0,0.0,94,0
22400498,4,40,0.0,0.0,720,680
22400498,4,99,4.0,2.4242424242424243,664,565
22400498,4,97,2.0,1.2371134020618557,565,468
22400498,4,28,-1.0,-2.142857142857143,468,440
22400498,4,48,3.0,3.75,440,392
22400498,4,23,0.0,0.0,392,369
22400498,4,10,0.0,0.0,369,359
22400498,4,30,1.0,2.0,349,319
22400498,4,120,-5.0,-2.5,319,199
22400498,4,173,7.0,2.4277456647398843,188,15
22400498,4,4,1.0,15.0,8,4
22400499,1,170,1.0,0.3529411764705882,720,550
22400499,1,82,-4.0,-2.926829268292683,545,463
22400499,1,58,-3.0,-3.103448275862069,460,402
22400499,1,101,-3.0,-1.782178217821782,395,294
22400499,1,138,1.0,0.43478260869565216,294,156
22400499,1,100,0.0,0.0,156,56
22400499,1,40,-3.0,-4.5,49,9
22400499,1,8,1.0,7.5,9,1
22400499,1,1,0.0,0.0,1,0
22400499,2,146,-1.0,-0.410958904109589,720,574
22400499,2,15,-1.0,-4.0,574,559
22400499,2,22,0.0,0.0,559,537
22400499,2,15,2.0,8.0,537,522
22400499,2,16,0.0,0.0,522,506
22400499,2,81,0.0,0.0,492,411
22400499,2,41,1.0,1.4634146341463414,398,357
22400499,2,161,4.0,1.4906832298136645,357,196
22400499,2,140,2.0,0.8571428571428571,183,43
22400499,2,29,2.0,4.137931034482759,43,14
22400499,2,2,0.0,0.0,2,0
22400499,3,146,4.0,1.643835616438356,720,574
22400499,3,26,0.0,0.0,574,548
22400499,3,24,0.0,0.0,548,524
22400499,3,60,2.0,2.0,524,464
22400499,3,67,2.0,1.791044776119403,450,383
22400499,3,60,-3.0,-3.0,373,313
22400499,3,107,-1.0,-0.5607476635514018,303,196
22400499,3,58,0.0,0.0,183,125
22400499,3,35,-2.0,-3.4285714285714284,119,84
22400499,3,77,1.0,0.7792207792207793,81,4
22400499,4,143,-1.0,-0.4195804195804196,720,577
22400499,4,44,2.0,2.7272727272727275,556,512
22400499,4,1,0.0,0.0,494,493
22400499,4,175,1.0,0.34285714285714286,493,318
22400499,4,51,1.0,1.1764705882352942,318,267
22400499,4,61,0.0,0.0,267,206
22400499,4,122,2.0,0.9836065573770493,197,75
22400499,4,6,0.0,0.0,54,48
22400499,4,48,3.0,3.75,48,0
22400500,1,372,-7.0,-1.1290322580645162,720,348
22400500,1,123,-2.0,-0.9756097560975611,336,213
22400500,1,109,-1.0,-0.5504587155963303,200,91
22400500,1,55,1.0,1.0909090909090908,77,22
22400500,1,22,0.0,0.0,22,0
22400500,2,105,2.0,1.142857142857143,720,615
22400500,2,149,-6.0,-2.4161073825503356,615,466
22400500,2,17,-3.0,-10.588235294117649,466,449
22400500,2,90,1.0,0.6666666666666667,427,337
22400500,2,299,11.0,2.207357859531773,337,38
22400500,2,30,0.0,0.0,38,8
22400500,3,285,13.0,2.736842105263158,720,435
22400500,3,138,-4.0,-1.7391304347826086,424,286
22400500,3,42,-2.0,-2.8571428571428568,276,234
22400500,3,178,0.0,0.0,230,52
22400500,3,26,0.0,0.0,52,26
22400500,3,7,-3.0,-25.71428571428571,7,0
22400500,4,191,5.0,1.5706806282722514,720,529
22400500,4,14,1.0,4.285714285714286,516,502
22400500,4,77,-5.0,-3.8961038961038956,492,415
22400500,4,177,-8.0,-2.711864406779661,398,221
22400500,4,178,7.0,2.359550561797753,202,24
22400500,4,7,-1.0,-8.571428571428571,18,11
22400500,4,1,0.0,0.0,10,9
22400500,4,2,-2.0,-60.0,5,3
22400500,4,3,0.0,0.0,3,0
22400501,1,310,-2.0,-0.3870967741935484,720,410
22400501,1,166,-6.0,-2.1686746987951806,391,225
22400501,1,30,1.0,2.0,199,169
22400501,1,62,4.0,3.870967741935484,169,107
22400501,1,107,-2.0,-1.1214953271028036,107,0
22400501,2,144,3.0,1.25,720,576
22400501,2,30,2.0,4.0,576,546
22400501,2,81,2.0,1.4814814814814814,546,465
22400501,2,41,-3.0,-4.390243902439024,448,407
22400501,2,68,1.0,0.8823529411764706,393,325
22400501,2,74,-1.0,-0.8108108108108109,325,251
22400501,2,79,3.0,2.278481012658228,239,160
22400501,2,86,3.0,2.0930232558139537,136,50
22400501,2,50,0.0,0.0,50,0
22400501,3,319,2.0,0.37617554858934166,720,401
22400501,3,126,-4.0,-1.9047619047619047,391,265
22400501,3,97,-3.0,-1.8556701030927836,265,168
22400501,3,57,-1.0,-1.0526315789473684,168,111
22400501,3,45,0.0,0.0,111,66
22400501,3,66,-2.0,-1.8181818181818183,66,0
22400501,4,32,-4.0,-7.5,720,688
22400501,4,164,0.0,0.0,679,515
22400501,4,105,4.0,2.285714285714286,515,410
22400501,4,2,0.0,0.0,389,387
22400501,4,105,0.0,0.0,378,273
22400501,4,253,7.0,1.6600790513833992,266,13
22400501,4,3,0.0,0.0,3,0
22400501,5,300,1.0,0.2,300,0
22400501,6,288,3.0,0.625,300,12
22400502,1,307,-4.0,-0.7817589576547231,720,413
22400502,1,44,-1.0,-1.3636363636363638,413,369
22400502,1,43,1.0,1.3953488372093024,369,326
22400502,1,152,-5.0,-1.9736842105263157,326,174
22400502,1,40,2.0,3.0,174,134
22400502,1,134,-1.0,-0.44776119402985076,134,0
22400502,2,81,3.0,2.2222222222222223,720,639
22400502,2,11,0.0,0.0,631,620
22400502,2,79,1.0,0.7594936708860759,609,530
22400502,2,103,-5.0,-2.912621359223301,530,427
22400502,2,43,2.0,2.7906976744186047,408,365
22400502,2,96,7.0,4.375,365,269
22400502,2,139,2.0,0.8633093525179857,260,121
22400502,2,27,1.0,2.2222222222222223,107,80
22400502,2,74,5.0,4.054054054054054,74,0
22400502,3,122,-6.0,-2.9508196721311473,720,598
22400502,3,174,-4.0,-1.3793103448275863,598,424
22400502,3,26,0.0,0.0,409,383
22400502,3,16,2.0,7.5,383,367
22400502,3,29,-2.0,-4.137931034482759,339,310
22400502,3,45,0.0,0.0,310,265
22400502,3,135,0.0,0.0,265,130
22400502,3,68,2.0,1.7647058823529411,130,62
22400502,3,49,0.0,0.0,49,0
22400502,4,75,5.0,4.0,720,645
22400502,4,70,-2.0,-1.7142857142857142,629,559
22400502,4,172,2.0,0.6976744186046512,547,375
22400502,4,89,0.0,0.0,306,217
22400502,4,137,-5.0,-2.18978102189781,206,69
22400502,4,69,0.0,0.0,69,0
22400503,1,324,1.0,0.18518518518518517,720,396
22400503,1,48,-1.0,-1.25,388,340
22400503,1,16,0.0,0.0,340,324
22400503,1,92,-1.0,-0.6521739130434783,315,223
22400503,1,313,3.0,0.5750798722044728,588,275
22400503,1,68,3.0,2.647058823529412,134,66
22400503,2,186,-6.0,-1.935483870967742,720,534
22400503,2,21,-2.0,-5.7142857142857135,534,513
22400503,2,176,1.0,0.34090909090909094,496,320
22400503,2,38,-3.0,-4.7368421052631575,320,282
22400503,2,115,-4.0,-2.0869565217391304,277,162
22400503,2,82,6.0,4.390243902439024,146,64
22400503,2,64,-7.0,-6.5625,64,0
22400503,3,63,1.0,0.9523809523809523,720,657
22400503,3,266,-5.0,-1.1278195488721803,657,391
22400503,3,33,-5.0,-9.090909090909092,384,351
22400503,3,84,-3.0,-2.142857142857143,333,249
22400503,3,87,0.0,0.0,236,149
22400503,3,146,-2.0,-0.821917808219178,146,0
22400503,4,161,-8.0,-2.981366459627329,720,559
22400503,4,108,5.0,2.7777777777777777,545,437
22400503,4,62,3.0,2.903225806451613,437,375
22400503,4,103,-4.0,-2.3300970873786406,360,257
22400503,4,119,0.0,0.0,302,183
22400503,4,171,-3.0,-1.0526315789473684,171,0
22400504,1,289,5.0,1.0380622837370244,720,431
22400504,1,60,0.0,0.0,408,348
22400504,1,79,0.0,0.0,332,253
22400504,1,18,-1.0,-3.333333333333333,253,235
22400504,1,33,0.0,0.0,235,202
22400504,1,134,1.0,0.44776119402985076,134,0
22400504,2,113,2.0,1.0619469026548671,720,607
22400504,2,56,4.0,4.285714285714286,607,551
22400504,2,47,1.0,1.2765957446808511,551,504
22400504,2,36,-2.0,-3.333333333333333,504,468
22400504,2,30,1.0,2.0,468,438
22400504,2,63,0.0,0.0,438,375
22400504,2,41,0.0,0.0,375,334
22400504,2,40,-3.0,-4.5,317,277
22400504,2,86,-2.0,-1.3953488372093024,277,191
22400504,2,36,1.0,1.6666666666666665,186,150
22400504,2,138,8.0,3.4782608695652173,138,0
22400504,3,204,2.0,0.5882352941176471,720,516
22400504,3,68,2.0,1.7647058823529411,516,448
22400504,3,85,-5.0,-3.5294117647058822,427,342
22400504,3,100,7.0,4.2,327,227
22400504,3,116,1.0,0.5172413793103449,209,93
22400504,3,83,-1.0,-0.7228915662650602,83,0
22400504,4,213,-2.0,-0.5633802816901409,720,507
22400504,4,91,-1.0,-0.6593406593406594,507,416
22400504,4,84,3.0,2.142857142857143,416,332
22400504,4,112,2.0,1.0714285714285714,318,206
22400504,4,103,3.0,1.7475728155339807,189,86
22400504,4,75,4.0,3.2,75,0
22400505,1,292,-6.0,-1.2328767123287672,720,428
22400505,1,103,-2.0,-1.1650485436893203,416,313
22400505,1,13,2.0,9.230769230769232,307,294
22400505,1,95,5.0,3.1578947368421053,294,199
22400505,1,21,-1.0,-2.8571428571428568,177,156
22400505,2,166,-6.0,-2.1686746987951806,720,554
22400505,2,140,1.0,0.42857142857142855,547,407
22400505,2,115,2.0,1.0434782608695652,393,278
22400505,2,24,0.0,0.0,278,254
22400505,2,47,4.0,5.1063829787234045,249,202
22400505,2,71,-1.0,-0.8450704225352113,187,116
22400505,2,8,0.0,0.0,116,108
22400505,2,86,-2.0,-1.3953488372093024,97,11
22400505,3,228,5.0,1.3157894736842104,720,492
22400505,3,136,-11.0,-4.852941176470589,492,356
22400505,3,178,0.0,0.0,339,161
22400505,3,53,-3.0,-3.3962264150943398,151,98
22400505,3,88,-1.0,-0.6818181818181819,88,0
22400505,4,129,-4.0,-1.8604651162790697,720,591
22400505,4,63,1.0,0.9523809523809523,582,519
22400505,4,13,-2.0,-9.230769230769232,506,493
22400505,4,57,2.0,2.1052631578947367,493,436
22400505,4,80,2.0,1.5,423,343
22400505,4,316,6.0,1.139240506329114,335,19
22400505,4,14,0.0,0.0,14,0
22400506,1,348,-5.0,-0.8620689655172413,720,372
22400506,1,27,-2.0,-4.444444444444445,367,340
22400506,1,102,-4.0,-2.3529411764705883,336,234
22400506,1,43,6.0,8.372093023255815,223,180
22400506,2,172,-5.0,-1.744186046511628,720,548
22400506,2,28,-2.0,-4.285714285714286,533,505
22400506,2,18,-2.0,-6.666666666666666,496,478
22400506,2,70,-1.0,-0.8571428571428571,461,391
22400506,2,33,2.0,3.6363636363636367,378,345
22400506,2,149,-3.0,-1.2080536912751678,345,196
22400506,2,18,1.0,3.333333333333333,196,178
22400506,2,13,1.0,4.615384615384616,178,165
22400506,2,165,4.0,1.4545454545454546,165,0
22400506,3,236,0.0,0.0,720,484
22400506,3,71,-2.0,-1.6901408450704225,484,413
22400506,3,19,1.0,3.1578947368421053,405,386
22400506,3,74,-1.0,-0.8108108108108109,386,312
22400506,3,40,4.0,6.0,303,263
22400506,3,33,-2.0,-3.6363636363636367,249,216
22400506,3,66,1.0,0.9090909090909092,204,138
22400506,3,138,-2.0,-0.8695652173913043,138,0
22400506,4,195,2.0,0.6153846153846154,720,525
22400506,4,18,-3.0,-10.0,513,495
22400506,4,17,2.0,7.0588235294117645,475,458
22400506,4,92,-1.0,-0.6521739130434783,458,366
22400506,4,69,1.0,0.8695652173913043,356,287
22400506,4,68,4.0,3.5294117647058822,280,212
22400506,4,195,0.0,0.0,204,9
22400506,4,8,0.0,0.0,8,0
22400507,1,444,-2.0,-0.2702702702702703,720,276
22400507,1,102,-5.0,-2.941176470588235,270,168
22400507,1,48,1.0,1.25,168,120
22400507,1,35,-1.0,-1.7142857142857142,120,85
22400507,1,85,-2.0,-1.4117647058823528,85,0
22400507,2,131,-3.0,-1.3740458015267176,720,589
22400507,2,53,5.0,5.660377358490567,589,536
22400507,2,94,2.0,1.2765957446808511,520,426
22400507,2,27,0.0,0.0,402,375
22400507,2,19,-2.0,-6.315789473684211,358,339
22400507,2,206,5.0,1.4563106796116505,322,116
22400507,2,116,1.0,0.5172413793103449,116,0
22400507,3,376,-8.0,-1.2765957446808511,720,344
22400507,3,31,-1.0,-1.935483870967742,328,297
22400507,3,92,3.0,1.9565217391304348,281,189
22400507,3,2,0.0,0.0,179,177
22400507,3,159,-1.0,-0.37735849056603776,160,1
22400507,3,1,0.0,0.0,1,0
22400507,4,196,2.0,0.6122448979591836,720,524
22400507,4,48,1.0,1.25,512,464
22400507,4,58,-5.0,-5.172413793103448,458,400
22400507,4,47,-3.0,-3.829787234042553,381,334
22400507,4,34,-2.0,-3.5294117647058822,328,294
22400507,4,77,3.0,2.3376623376623376,283,206
22400507,4,183,-4.0,-1.3114754098360655,206,23
22400507,4,19,0.0,0.0,19,0
22400508,1,324,1.0,0.18518518518518517,720,396
22400508,1,2,0.0,0.0,396,394
22400508,1,60,7.0,7.0,394,334
22400508,1,49,-5.0,-6.122448979591837,319,270
22400508,1,57,0.0,0.0,270,213
22400508,1,50,-2.0,-2.4,213,163
22400508,1,33,1.0,1.8181818181818183,150,117
22400508,1,35,2.0,3.4285714285714284,117,82
22400508,1,82,-5.0,-3.6585365853658534,82,0
22400508,2,159,0.0,0.0,720,561
22400508,2,24,-2.0,-5.0,553,529
22400508,2,54,-5.0,-5.555555555555555,515,461
22400508,2,96,2.0,1.25,449,353
22400508,2,154,-1.0,-0.38961038961038963,342,188
22400508,2,186,-1.0,-0.32258064516129037,186,0
22400508,3,24,0.0,0.0,720,696
22400508,3,266,-1.0,-0.22556390977443608,683,417
22400508,3,82,0.0,0.0,397,315
22400508,3,113,2.0,1.0619469026548671,296,183
22400508,3,211,1.0,0.28436018957345977,211,0
22400508,4,224,-4.0,-1.0714285714285714,720,496
22400508,4,101,-2.0,-1.188118811881188,482,381
22400508,4,70,-3.0,-2.5714285714285716,379,309
22400508,4,83,0.0,0.0,309,226
22400508,4,33,-2.0,-3.6363636363636367,218,185
22400508,4,131,0.0,0.0,167,36
22400509,1,275,-4.0,-0.8727272727272727,720,445
22400509,1,52,-3.0,-3.4615384615384617,445,393
22400509,1,60,4.0,4.0,383,323
22400509,1,58,-3.0,-3.103448275862069,316,258
22400509,1,121,-2.0,-0.9917355371900827,258,137
22400509,1,63,-1.0,-0.9523809523809523,137,74
22400509,1,74,-2.0,-1.6216216216216217,74,0
22400509,2,112,5.0,2.678571428571429,720,608
22400509,2,83,-3.0,-2.1686746987951806,608,525
22400509,2,74,0.0,0.0,512,438
22400509,2,7,1.0,8.571428571428571,438,431
22400509,2,127,1.0,0.47244094488188976,431,304
22400509,2,39,0.0,0.0,289,250
22400509,2,27,2.0,4.444444444444445,235,208
22400509,2,120,2.0,1.0,198,78
22400509,2,61,2.0,1.9672131147540985,61,0
22400509,3,278,-4.0,-0.8633093525179857,720,442
22400509,3,64,2.0,1.875,437,373
22400509,3,55,3.0,3.2727272727272725,411,356
22400509,3,102,-1.0,-0.5882352941176471,344,242
22400509,3,96,-2.0,-1.25,242,146
22400509,3,146,2.0,0.821917808219178,146,0
22400509,4,59,-3.0,-3.050847457627119,720,661
22400509,4,64,0.0,0.0,654,590
22400509,4,84,2.0,1.4285714285714284,572,488
22400509,4,11,0.0,0.0,485,474
22400509,4,15,2.0,8.0,465,450
22400509,4,149,-2.0,-0.8053691275167785,445,296
22400509,4,72,0.0,0.0,296,224
22400509,4,197,4.0,1.2182741116751268,224,27
22400509,4,7,0.0,0.0,20,13
22400510,1,250,7.0,1.68,720,470
22400510,1,102,1.0,0.5882352941176471,470,368
22400510,1,70,-4.0,-3.4285714285714284,361,291
22400510,1,64,-2.0,-1.875,269,205
22400510,1,82,2.0,1.4634146341463414,181,99
22400510,1,84,6.0,4.285714285714286,84,0
22400510,2,110,7.0,3.818181818181818,720,610
22400510,2,2,0.0,0.0,588,586
22400510,2,112,-3.0,-1.607142857142857,581,469
22400510,2,35,2.0,3.4285714285714284,451,416
22400510,2,69,1.0,0.8695652173913043,405,336
22400510,2,98,1.0,0.6122448979591836,250,152
22400510,2,152,-2.0,-0.7894736842105263,152,0
22400510,3,151,8.0,3.1788079470198674,720,569
22400510,3,88,0.0,0.0,556,468
22400510,3,106,2.0,1.1320754716981132,459,353
22400510,3,72,2.0,1.6666666666666665,344,272
22400510,3,15,0.0,0.0,258,243
22400510,3,43,3.0,4.186046511627907,237,194
22400510,3,52,1.0,1.153846153846154,194,142
22400510,3,136,-6.0,-2.647058823529412,136,0
22400510,4,67,-3.0,-2.6865671641791042,720,653
22400510,4,72,1.0,0.8333333333333333,653,581
22400510,4,91,-6.0,-3.956043956043956,581,490
22400510,4,6,-3.0,-30.0,490,484
22400510,4,135,5.0,2.2222222222222223,471,336
22400510,4,43,1.0,1.3953488372093024,336,293
22400510,4,40,-2.0,-3.0,293,253
22400510,4,28,-1.0,-2.142857142857143,246,218
22400510,4,132,0.0,0.0,218,86
22400510,4,47,1.0,1.2765957446808511,76,29
22400510,4,28,-1.0,-2.142857142857143,28,0
22400511,1,304,2.0,0.39473684210526316,720,416
22400511,1,9,0.0,0.0,400,391
22400511,1,124,3.0,1.4516129032258065,391,267
22400511,1,53,2.0,2.2641509433962264,267,214
22400511,1,149,4.0,1.610738255033557,214,65
22400511,1,36,-4.0,-6.666666666666666,65,29
22400511,1,29,0.0,0.0,29,0
22400511,2,42,5.0,7.142857142857142,720,678
22400511,2,44,-5.0,-6.818181818181818,678,634
22400511,2,3,0.0,0.0,621,618
22400511,2,87,6.0,4.137931034482759,608,521
22400511,2,39,-2.0,-3.0769230769230766,509,470
22400511,2,30,-1.0,-2.0,467,437
22400511,2,8,0.0,0.0,437,429
22400511,2,50,0.0,0.0,418,368
22400511,2,35,2.0,3.4285714285714284,365,330
22400511,2,194,-2.0,-0.6185567010309279,321,127
22400511,2,101,0.0,0.0,107,6
22400511,3,321,2.0,0.37383177570093457,720,399
22400511,3,40,3.0,4.5,394,354
22400511,3,21,3.0,8.571428571428571,342,321
22400511,3,8,0.0,0.0,321,313
22400511,3,30,1.0,2.0,301,271
22400511,3,95,-2.0,-1.263157894736842,271,176
22400511,3,92,-1.0,-0.6521739130434783,176,84
22400511,3,65,-3.0,-2.769230769230769,84,19
22400511,4,146,2.0,0.821917808219178,720,574
22400511,4,141,8.0,3.404255319148936,562,421
22400511,4,63,5.0,4.761904761904762,384,321
22400511,4,74,0.0,0.0,321,247
22400511,4,4,1.0,15.0,242,238
22400511,4,77,4.0,3.116883116883117,224,147
22400511,4,407,-12.0,-1.769041769041769,407,0
22400512,1,323,4.0,0.7430340557275542,720,397
22400512,1,59,4.0,4.067796610169491,382,323
22400512,1,58,2.0,2.0689655172413794,323,265
22400512,1,56,1.0,1.0714285714285714,259,203
22400512,1,9,0.0,0.0,189,180
22400512,1,13,2.0,9.230769230769232,168,155
22400512,1,80,-5.0,-3.75,155,75
22400512,1,34,-2.0,-3.5294117647058822,75,41
22400512,1,41,-2.0,-2.926829268292683,41,0
22400512,2,195,1.0,0.3076923076923077,720,525
22400512,2,115,-2.0,-1.0434782608695652,516,401
22400512,2,178,1.0,0.33707865168539325,392,214
22400512,2,71,2.0,1.6901408450704225,207,136
22400512,2,15,1.0,4.0,136,121
22400512,2,78,0.0,0.0,110,32
22400512,3,431,-1.0,-0.13921113689095127,720,289
22400512,3,18,3.0,10.0,281,263
22400512,3,48,-2.0,-2.5,238,190
22400512,3,68,5.0,4.411764705882353,164,96
22400512,3,79,-1.0,-0.7594936708860759,79,0
22400512,4,186,-3.0,-0.967741935483871,720,534
22400512,4,99,-4.0,-2.4242424242424243,534,435
22400512,4,46,-3.0,-3.9130434782608696,421,375
22400512,4,38,-2.0,-3.1578947368421053,362,324
22400512,4,229,-5.0,-1.3100436681222707,307,78
22400512,4,6,1.0,10.0,75,69
22400512,4,46,3.0,3.9130434782608696,69,23
22400512,4,7,3.0,25.71428571428571,14,7
22400513,1,256,-5.0,-1.171875,720,464
22400513,1,100,0.0,0.0,464,364
22400513,1,115,5.0,2.608695652173913,364,249
22400513,1,63,1.0,0.9523809523809523,249,186
22400513,1,186,2.0,0.6451612903225807,186,0
22400513,2,99,0.0,0.0,720,621
22400513,2,95,-3.0,-1.8947368421052633,621,526
22400513,2,13,0.0,0.0,521,508
22400513,2,17,-2.0,-7.0588235294117645,502,485
22400513,2,48,-3.0,-3.75,472,424
22400513,2,84,4.0,2.8571428571428568,402,318
22400513,2,17,-3.0,-10.588235294117649,311,294
22400513,2,206,-9.0,-2.621359223300971,277,71
22400513,2,68,4.0,3.5294117647058822,68,0
22400513,3,413,2.0,0.2905569007263923,720,307
22400513,3,76,-4.0,-3.1578947368421053,292,216
22400513,3,52,-5.0,-5.769230769230769,191,139
22400513,3,128,-3.0,-1.40625,128,0
22400513,4,268,2.0,0.44776119402985076,720,452
22400513,4,45,0.0,0.0,435,390
22400513,4,16,1.0,3.75,389,373
22400513,4,60,0.0,0.0,373,313
22400513,4,56,-2.0,-2.142857142857143,313,257
22400513,4,76,-2.0,-1.5789473684210527,257,181
22400513,4,389,9.0,1.3881748071979434,389,0
22400514,1,272,-7.0,-1.5441176470588234,720,448
22400514,1,162,-2.0,-0.7407407407407407,428,266
22400514,1,111,-5.0,-2.7027027027027026,266,155
22400514,1,139,0.0,0.0,139,0
22400514,2,175,-2.0,-0.6857142857142857,720,545
22400514,2,27,-2.0,-4.444444444444445,537,510
22400514,2,80,-4.0,-3.0,503,423
22400514,2,56,0.0,0.0,419,363
22400514,2,171,-5.0,-1.7543859649122806,345,174
22400514,2,155,-2.0,-0.7741935483870968,160,5
22400514,3,126,3.0,1.4285714285714284,720,594
22400514,3,123,1.0,0.48780487804878053,594,471
22400514,3,63,-2.0,-1.9047619047619047,471,408
22400514,3,102,3.0,1.7647058823529411,395,293
22400514,3,34,2.0,3.5294117647058822,287,253
22400514,3,91,-1.0,-0.6593406593406594,253,162
22400514,3,162,6.0,2.2222222222222223,162,0
22400514,4,222,1.0,0.2702702702702703,720,498
22400514,4,27,0.0,0.0,480,453
22400514,4,92,-7.0,-4.565217391304348,453,361
22400514,4,48,2.0,2.5,352,304
22400514,4,13,-1.0,-4.615384615384616,298,285
22400514,4,129,3.0,1.3953488372093024,352,223
22400514,4,216,5.0,1.3888888888888888,216,0
22400515,1,187,1.0,0.32085561497326204,720,533
22400515,1,254,3.0,0.7086614173228346,518,264
22400515,1,25,5.0,12.0,264,239
22400515,1,8,1.0,7.5,222,214
22400515,1,85,3.0,2.1176470588235294,214,129
22400515,1,28,0.0,0.0,129,101
22400515,1,78,-1.0,-0.7692307692307692,95,17
22400515,1,4,0.0,0.0,4,0
22400515,2,170,5.0,1.7647058823529411,720,550
22400515,2,77,7.0,5.454545454545455,534,457
22400515,2,88,-2.0,-1.3636363636363638,457,369
22400515,2,21,-2.0,-5.7142857142857135,369,348
22400515,2,23,-1.0,-2.608695652173913,335,312
22400515,2,286,0.0,0.0,312,26
22400515,2,8,1.0,7.5,8,0
22400515,3,177,1.0,0.3389830508474576,720,543
22400515,3,195,8.0,2.4615384615384617,543,348
22400515,3,94,0.0,0.0,348,254
22400515,3,7,0.0,0.0,204,197
22400515,3,25,0.0,0.0,197,172
22400515,3,81,-5.0,-3.7037037037037033,160,79
22400515,3,57,2.0,2.1052631578947367,57,0
22400515,4,160,7.0,2.625,720,560
22400515,4,103,1.0,0.5825242718446602,540,437
22400515,4,159,1.0,0.37735849056603776,426,267
22400515,4,264,-3.0,-0.6818181818181819,264,0
22400516,1,344,-2.0,-0.3488372093023256,720,376
22400516,1,89,-2.0,-1.348314606741573,364,275
22400516,1,49,0.0,0.0,268,219
22400516,1,91,8.0,5.2747252747252755,217,126
22400516,1,109,-1.0,-0.5504587155963303,109,0
22400516,2,192,-1.0,-0.3125,720,528
22400516,2,64,-2.0,-1.875,522,458
22400516,2,84,2.0,1.4285714285714284,446,362
22400516,2,99,7.0,4.242424242424242,318,219
22400516,2,29,1.0,2.0689655172413794,205,176
22400516,2,168,8.0,2.8571428571428568,168,0
22400516,3,235,-7.0,-1.7872340425531916,720,485
22400516,3,64,2.0,1.875,482,418
22400516,3,62,0.0,0.0,418,356
22400516,3,27,-3.0,-6.666666666666666,341,314
22400516,3,103,5.0,2.912621359223301,300,197
22400516,3,133,-1.0,-0.45112781954887216,174,41
22400516,3,10,1.0,6.0,41,31
22400516,3,31,0.0,0.0,31,0
22400516,4,250,4.0,0.96,720,470
22400516,4,58,5.0,5.172413793103448,470,412
22400516,4,122,1.0,0.49180327868852464,397,275
22400516,4,100,-2.0,-1.2,268,168
22400516,4,110,-1.0,-0.5454545454545454,168,58
22400516,4,58,-4.0,-4.137931034482759,58,0
22400517,1,296,1.0,0.20270270270270271,720,424
22400517,1,38,2.0,3.1578947368421053,424,386
22400517,1,27,2.0,4.444444444444445,367,340
22400517,1,12,0.0,0.0,328,316
22400517,1,29,-5.0,-10.344827586206897,316,287
22400517,1,85,-4.0,-2.8235294117647056,267,182
22400517,1,67,1.0,0.8955223880597015,170,103
22400517,1,103,-1.0,-0.5825242718446602,103,0
22400517,2,122,-5.0,-2.4590163934426226,720,598
22400517,2,35,0.0,0.0,583,548
22400517,2,85,5.0,3.5294117647058822,546,461
22400517,2,40,1.0,1.5,461,421
22400517,2,153,4.0,1.5686274509803921,421,268
22400517,2,16,1.0,3.75,252,236
22400517,2,145,4.0,1.6551724137931034,236,91
22400517,3,249,-1.0,-0.24096385542168672,720,471
22400517,3,98,-3.0,-1.836734693877551,466,368
22400517,3,137,-1.0,-0.437956204379562,368,231
22400517,3,186,0.0,0.0,216,30
22400517,3,24,-1.0,-2.5,24,0
22400517,4,140,3.0,1.2857142857142858,720,580
22400517,4,40,0.0,0.0,580,540
22400517,4,8,0.0,0.0,525,517
22400517,4,181,-3.0,-0.9944751381215469,514,333
22400517,4,103,2.0,1.1650485436893203,321,218
22400517,4,24,3.0,7.5,218,194
22400517,4,151,0.0,0.0,170,19
22400517,4,19,-1.0,-3.1578947368421053,19,0
22400518,1,304,4.0,0.7894736842105263,720,416
22400518,1,167,1.0,0.3592814371257485,401,234
22400518,1,67,-5.0,-4.477611940298507,216,149
22400518,2,232,-2.0,-0.5172413793103449,720,488
22400518,2,38,-3.0,-4.7368421052631575,481,443
22400518,2,35,-2.0,-3.4285714285714284,434,399
22400518,2,9,0.0,0.0,384,375
22400518,2,68,-6.0,-5.294117647058824,366,298
22400518,2,103,-2.0,-1.1650485436893203,289,186
22400518,2,18,1.0,3.333333333333333,178,160
22400518,3,247,-7.0,-1.7004048582995952,720,473
22400518,3,86,3.0,2.0930232558139537,455,369
22400518,3,243,0.0,0.0,314,71
22400518,3,27,-1.0,-2.2222222222222223,46,19
22400518,4,142,1.0,0.4225352112676056,720,578
22400518,4,15,0.0,0.0,561,546
22400518,4,70,-2.0,-1.7142857142857142,542,472
22400518,4,2,0.0,0.0,455,453
22400518,4,57,2.0,2.1052631578947367,445,388
22400518,4,150,2.0,0.8,377,227
22400518,4,122,4.0,1.9672131147540985,220,98
22400518,4,45,0.0,0.0,81,36
22400518,4,5,0.0,0.0,14,9
22400518,4,5,1.0,12.0,9,4
22400518,4,4,0.0,0.0,4,0
22400519,1,398,-6.0,-0.9045226130653266,720,322
22400519,1,48,0.0,0.0,312,264
22400519,1,156,-3.0,-1.153846153846154,156,0
22400519,2,113,5.0,2.6548672566371683,720,607
22400519,2,106,1.0,0.5660377358490566,598,492
22400519,2,59,0.0,0.0,492,433
22400519,2,80,3.0,2.25,433,353
22400519,2,148,-2.0,-0.8108108108108109,341,193
22400519,2,18,-2.0,-6.666666666666666,174,156
22400519,2,140,-3.0,-1.2857142857142858,140,0
22400519,3,253,8.0,1.8972332015810276,720,467
22400519,3,208,-3.0,-0.8653846153846154,450,242
22400519,3,4,0.0,0.0,227,223
22400519,3,54,-2.0,-2.2222222222222223,212,158
22400519,3,101,-2.0,-1.188118811881188,158,57
22400519,4,133,-4.0,-1.8045112781954886,720,587
22400519,4,102,2.0,1.1764705882352942,587,485
22400519,4,33,0.0,0.0,463,430
22400519,4,58,0.0,0.0,408,350
22400519,4,57,4.0,4.2105263157894735,342,285
22400519,4,84,-2.0,-1.4285714285714284,272,188
22400520,1,208,-2.0,-0.576923076923077,720,512
22400520,1,108,-3.0,-1.6666666666666665,512,404
22400520,1,33,-4.0,-7.272727272727273,404,371
22400520,1,30,0.0,0.0,358,328
22400520,1,47,-2.0,-2.5531914893617023,328,281
22400520,1,79,5.0,3.79746835443038,281,202
22400520,1,32,1.0,1.875,202,170
22400520,1,11,0.0,0.0,170,159
22400520,1,48,1.0,1.25,151,103
22400520,1,59,0.0,0.0,96,37
22400520,1,13,-3.0,-13.846153846153847,29,16
22400520,1,16,-1.0,-3.75,16,0
22400520,2,289,-3.0,-0.6228373702422145,720,431
22400520,2,46,-3.0,-3.9130434782608696,417,371
22400520,2,8,0.0,0.0,357,349
22400520,2,38,2.0,3.1578947368421053,327,289
22400520,2,39,-1.0,-1.5384615384615383,279,240
22400520,2,57,3.0,3.1578947368421053,240,183
22400520,2,118,2.0,1.0169491525423728,169,51
22400520,2,1,2.0,120.0,51,50
22400520,2,10,1.0,6.0,33,23
22400520,2,23,0.0,0.0,23,0
22400520,3,211,6.0,1.7061611374407581,720,509
22400520,3,115,-2.0,-1.0434782608695652,509,394
22400520,3,59,-2.0,-2.0338983050847457,394,335
22400520,3,80,-2.0,-1.5,335,255
22400520,3,92,-3.0,-1.9565217391304348,255,163
22400520,3,91,-4.0,-2.6373626373626378,155,64
22400520,3,37,2.0,3.2432432432432434,64,27
22400520,3,27,-1.0,-2.2222222222222223,27,0
22400520,4,108,-1.0,-0.5555555555555556,720,612
22400520,4,66,1.0,0.9090909090909092,612,546
22400520,4,40,3.0,4.5,546,506
22400520,4,71,1.0,0.8450704225352113,506,435
22400520,4,27,2.0,4.444444444444445,435,408
22400520,4,18,2.0,6.666666666666666,408,390
22400520,4,157,-1.0,-0.3821656050955414,366,209
22400520,4,203,3.0,0.8866995073891625,206,3
22400520,4,2,-1.0,-30.0,2,0
22400521,1,227,-2.0,-0.5286343612334802,720,493
22400521,1,45,1.0,1.3333333333333335,485,440
22400521,1,82,-4.0,-2.926829268292683,440,358
22400521,1,48,-1.0,-1.25,346,298
22400521,1,41,3.0,4.390243902439024,289,248
22400521,1,141,-3.0,-1.2765957446808511,248,107
22400521,1,95,-2.0,-1.263157894736842,95,0
22400521,2,162,6.0,2.2222222222222223,720,558
22400521,2,42,0.0,0.0,554,512
22400521,2,76,3.0,2.3684210526315788,512,436
22400521,2,73,-2.0,-1.643835616438356,436,363
22400521,2,6,0.0,0.0,352,346
22400521,2,86,4.0,2.7906976744186047,322,236
22400521,2,94,-1.0,-0.6382978723404256,231,137
22400521,2,49,-4.0,-4.897959183673469,137,88
22400521,2,88,2.0,1.3636363636363638,88,0
22400521,3,287,-3.0,-0.6271777003484321,720,433
22400521,3,34,0.0,0.0,433,399
22400521,3,83,5.0,3.6144578313253013,399,316
22400521,3,34,-1.0,-1.7647058823529411,298,264
22400521,3,53,-4.0,-4.528301886792453,264,211
22400521,3,8,-1.0,-7.5,199,191
22400521,3,77,-2.0,-1.5584415584415585,191,114
22400521,3,114,2.0,1.0526315789473684,114,0
22400521,4,115,5.0,2.608695652173913,720,605
22400521,4,37,-6.0,-9.72972972972973,581,544
22400521,4,140,0.0,0.0,541,401
22400521,4,60,0.0,0.0,401,341
22400521,4,77,0.0,0.0,341,264
22400521,4,99,4.0,2.4242424242424243,264,165
22400521,4,165,8.0,2.909090909090909,165,0
22400522,1,186,0.0,0.0,720,534
22400522,1,115,1.0,0.5217391304347826,534,419
22400522,1,59,5.0,5.084745762711864,403,344
22400522,1,91,0.0,0.0,334,243
22400522,1,27,-3.0,-6.666666666666666,230,203
22400522,1,55,1.0,1.0909090909090908,189,134
22400522,1,134,-5.0,-2.2388059701492535,134,0
22400522,2,86,0.0,0.0,720,634
22400522,2,96,1.0,0.625,621,525
22400522,2,59,1.0,1.0169491525423728,525,466
22400522,2,22,1.0,2.7272727272727275,466,444
22400522,2,137,-3.0,-1.3138686131386863,444,307
22400522,2,107,-7.0,-3.9252336448598126,300,193
22400522,2,48,2.0,2.5,178,130
22400522,2,62,-2.0,-1.935483870967742,130,68
22400522,2,59,-1.0,-1.0169491525423728,59,0
22400522,3,315,6.0,1.142857142857143,720,405
22400522,3,102,-4.0,-2.3529411764705883,392,290
22400522,3,136,3.0,1.323529411764706,290,154
22400522,3,132,2.0,0.9090909090909092,140,8
22400522,3,2,0.0,0.0,8,6
22400522,4,14,-1.0,-4.285714285714286,720,706
22400522,4,133,2.0,0.9022556390977443,706,573
22400522,4,38,0.0,0.0,562,524
22400522,4,41,0.0,0.0,518,477
22400522,4,28,0.0,0.0,462,434
22400522,4,42,-1.0,-1.4285714285714284,413,371
22400522,4,4,0.0,0.0,362,358
22400522,4,1,0.0,0.0,340,339
22400522,4,79,5.0,3.79746835443038,322,243
22400522,4,35,1.0,1.7142857142857142,226,191
22400522,4,24,-2.0,-5.0,168,144
22400522,4,99,-4.0,-2.4242424242424243,134,35
22400522,4,25,1.0,2.4,25,0
22400523,1,247,10.0,2.42914979757085,720,473
22400523,1,14,0.0,0.0,386,372
22400523,1,45,2.0,2.666666666666667,372,327
22400523,1,152,-6.0,-2.3684210526315788,326,174
22400523,1,23,0.0,0.0,156,133
22400523,1,51,5.0,5.88235294117647,129,78
22400523,1,68,-2.0,-1.7647058823529411,68,0
22400523,2,237,-4.0,-1.0126582278481011,720,483
22400523,2,57,-1.0,-1.0526315789473684,483,426
22400523,2,20,0.0,0.0,426,406
22400523,2,221,-5.0,-1.3574660633484164,404,183
22400523,2,172,-7.0,-2.4418604651162794,172,0
22400523,3,509,2.0,0.23575638506876226,720,211
22400523,3,210,5.0,1.4285714285714284,210,0
22400523,4,221,-1.0,-0.2714932126696833,720,499
22400523,4,24,2.0,5.0,498,474
22400523,4,119,-6.0,-3.0252100840336134,458,339
22400523,4,318,0.0,0.0,331,13
22400523,4,11,0.0,0.0,11,0
22400524,1,274,8.0,1.751824817518248,720,446
22400524,1,88,-2.0,-1.3636363636363638,437,349
22400524,1,28,0.0,0.0,332,304
22400524,1,45,-1.0,-1.3333333333333335,294,249
22400524,1,77,0.0,0.0,249,172
22400524,1,69,4.0,3.4782608695652173,159,90
22400524,1,82,-2.0,-1.4634146341463414,82,0
22400524,2,81,-1.0,-0.7407407407407407,720,639
22400524,2,172,-3.0,-1.0465116279069768,634,462
22400524,2,40,3.0,4.5,462,422
22400524,2,123,-2.0,-0.9756097560975611,413,290
22400524,2,117,5.0,2.5641025641025643,285,168
22400524,2,25,0.0,0.0,159,134
22400524,2,130,2.0,0.9230769230769231,130,0
22400524,3,242,-3.0,-0.743801652892562,720,478
22400524,3,52,1.0,1.153846153846154,384,332
22400524,3,101,4.0,2.376237623762376,332,231
22400524,3,34,-4.0,-7.0588235294117645,231,197
22400524,3,9,0.0,0.0,193,184
22400524,3,57,-5.0,-5.263157894736842,184,127
22400524,3,57,-3.0,-3.1578947368421053,123,66
22400524,3,66,-2.0,-1.8181818181818183,66,0
22400524,4,159,-3.0,-1.1320754716981132,720,561
22400524,4,24,2.0,5.0,548,524
22400524,4,160,1.0,0.375,524,364
22400524,4,24,-1.0,-2.5,357,333
22400524,4,50,2.0,2.4,333,283
22400524,4,187,-4.0,-1.2834224598930482,269,82
22400524,4,32,-1.0,-1.875,69,37
22400524,4,23,-2.0,-5.217391304347826,37,14
22400524,4,5,0.0,0.0,5,0
22400525,1,293,4.0,0.8191126279863481,720,427
22400525,1,105,-1.0,-0.5714285714285715,427,322
22400525,1,67,-7.0,-6.26865671641791,311,244
22400525,1,75,4.0,3.2,225,150
22400525,1,38,0.0,0.0,148,110
22400525,1,62,-1.0,-0.967741935483871,97,35
22400525,2,115,-1.0,-0.5217391304347826,720,605
22400525,2,75,0.0,0.0,605,530
22400525,2,77,2.0,1.5584415584415585,523,446
22400525,2,52,6.0,6.923076923076923,442,390
22400525,2,49,1.0,1.2244897959183672,366,317
22400525,2,50,3.0,3.5999999999999996,317,267
22400525,2,251,-7.0,-1.6733067729083666,254,3
22400525,2,3,0.0,0.0,3,0
22400525,3,240,4.0,1.0,720,480
22400525,3,117,0.0,0.0,472,355
22400525,3,27,0.0,0.0,355,328
22400525,3,14,0.0,0.0,328,314
22400525,3,11,0.0,0.0,304,293
22400525,3,116,0.0,0.0,281,165
22400525,3,94,-1.0,-0.6382978723404256,165,71
22400525,3,49,0.0,0.0,49,0
22400525,4,21,0.0,0.0,720,699
22400525,4,116,0.0,0.0,683,567
22400525,4,14,0.0,0.0,553,539
22400525,4,122,6.0,2.9508196721311473,539,417
22400525,4,289,4.0,0.8304498269896194,400,111
22400525,4,20,-3.0,-9.0,93,73
22400526,1,284,8.0,1.6901408450704225,720,436
22400526,1,91,-2.0,-1.3186813186813189,436,345
22400526,1,36,2.0,3.333333333333333,329,293
22400526,1,94,-6.0,-3.829787234042553,284,190
22400526,1,29,-2.0,-4.137931034482759,190,161
22400526,1,145,1.0,0.41379310344827586,145,0
22400526,2,147,3.0,1.2244897959183672,720,573
22400526,2,56,0.0,0.0,559,503
22400526,2,125,-3.0,-1.44,493,368
22400526,2,138,0.0,0.0,362,224
22400526,2,31,0.0,0.0,211,180
22400526,2,172,-1.0,-0.3488372093023256,172,0
22400526,3,302,1.0,0.1986754966887417,720,418
22400526,3,84,0.0,0.0,403,319
22400526,3,9,0.0,0.0,300,291
22400526,3,30,0.0,0.0,290,260
22400526,3,104,3.0,1.7307692307692308,260,156
22400526,3,156,-1.0,-0.3846153846153846,156,0
22400526,4,104,-4.0,-2.307692307692308,720,616
22400526,4,81,0.0,0.0,602,521
22400526,4,137,-3.0,-1.3138686131386863,521,384
22400526,4,89,-2.0,-1.348314606741573,364,275
22400526,4,130,3.0,1.3846153846153846,275,145
22400526,4,24,0.0,0.0,145,121
22400526,4,14,0.0,0.0,110,96
22400526,4,16,1.0,3.75,96,80
22400526,4,19,0.0,0.0,80,61
22400526,4,7,3.0,25.71428571428571,29,22
22400526,4,8,-2.0,-15.0,17,9
22400527,1,408,-3.0,-0.4411764705882353,720,312
22400527,1,14,0.0,0.0,312,298
22400527,1,95,4.0,2.526315789473684,273,178
22400527,1,30,-3.0,-6.0,163,133
22400527,1,128,-6.0,-2.8125,133,5
22400527,1,5,0.0,0.0,5,0
22400527,2,227,2.0,0.5286343612334802,720,493
22400527,2,36,-1.0,-1.6666666666666665,493,457
22400527,2,52,-3.0,-3.4615384615384617,457,405
22400527,2,57,0.0,0.0,394,337
22400527,2,25,-2.0,-4.8,337,312
22400527,2,113,6.0,3.185840707964602,301,188
22400527,2,183,-7.0,-2.2950819672131146,188,5
22400527,2,5,0.0,0.0,5,0
22400527,3,436,3.0,0.41284403669724773,720,284
22400527,3,80,-6.0,-4.5,270,190
22400527,3,11,0.0,0.0,184,173
22400527,3,34,3.0,5.294117647058824,161,127
22400527,3,117,-3.0,-1.5384615384615383,117,0
22400527,4,140,-2.0,-0.8571428571428571,720,580
22400527,4,140,0.0,0.0,563,423
22400527,4,10,0.0,0.0,414,404
22400527,4,49,-4.0,-4.897959183673469,390,341
22400527,4,30,3.0,6.0,341,311
22400527,4,79,5.0,3.79746835443038,307,228
22400527,4,215,0.0,0.0,215,0
22400528,1,328,-6.0,-1.097560975609756,720,392
22400528,1,79,-2.0,-1.5189873417721518,373,294
22400528,1,123,-1.0,-0.48780487804878053,291,168
22400528,2,198,6.0,1.8181818181818183,720,522
22400528,2,83,4.0,2.891566265060241,522,439
22400528,2,38,0.0,0.0,439,401
22400528,2,33,-2.0,-3.6363636363636367,389,356
22400528,2,136,5.0,2.2058823529411766,356,220
22400528,2,14,0.0,0.0,205,191
22400528,2,104,-1.0,-0.576923076923077,181,77
22400528,2,77,1.0,0.7792207792207793,77,0
22400528,3,368,2.0,0.32608695652173914,720,352
22400528,3,22,0.0,0.0,326,304
22400528,3,60,-2.0,-2.0,288,228
22400528,3,113,0.0,0.0,204,91
22400528,3,99,-2.0,-1.2121212121212122,114,15
22400528,3,2,0.0,0.0,2,0
22400528,4,103,-3.0,-1.7475728155339807,720,617
22400528,4,84,-3.0,-2.142857142857143,617,533
22400528,4,73,-3.0,-2.4657534246575343,518,445
22400528,4,39,-3.0,-4.615384615384616,429,390
22400528,4,126,0.0,0.0,379,253
22400528,4,39,-1.0,-1.5384615384615383,243,204
22400528,4,76,-2.0,-1.5789473684210527,204,128
22400528,4,118,-6.0,-3.050847457627119,118,0
22400529,1,454,-4.0,-0.5286343612334802,720,266
22400529,1,78,0.0,0.0,255,177
22400529,1,177,-10.0,-3.389830508474576,177,0
22400529,2,171,-5.0,-1.7543859649122806,720,549
22400529,2,80,1.0,0.75,549,469
22400529,2,62,0.0,0.0,450,388
22400529,2,58,-2.0,-2.0689655172413794,380,322
22400529,2,39,-2.0,-3.0769230769230766,308,269
22400529,2,96,-3.0,-1.875,257,161
22400529,2,39,0.0,0.0,161,122
22400529,2,54,-1.0,-1.1111111111111112,122,68
22400529,2,55,-1.0,-1.0909090909090908,55,0
22400529,3,140,-1.0,-0.42857142857142855,720,580
22400529,3,204,-2.0,-0.5882352941176471,573,369
22400529,3,87,3.0,2.0689655172413794,359,272
22400529,3,40,-1.0,-1.5,250,210
22400529,3,23,0.0,0.0,210,187
22400529,3,130,-3.0,-1.3846153846153846,173,43
22400529,4,156,0.0,0.0,720,564
22400529,4,147,6.0,2.4489795918367343,544,397
22400529,4,21,0.0,0.0,382,361
22400529,4,107,-2.0,-1.1214953271028036,351,244
22400529,4,96,-2.0,-1.25,234,138
22400529,4,122,3.0,1.4754098360655736,122,0
22400530,1,370,8.0,1.2972972972972974,720,350
22400530,1,23,0.0,0.0,296,273
22400530,1,143,0.0,0.0,266,123
22400530,1,104,2.0,1.153846153846154,104,0
22400530,2,101,-6.0,-3.564356435643564,720,619
22400530,2,64,2.0,1.875,619,555
22400530,2,21,0.0,0.0,546,525
22400530,2,75,-3.0,-2.4,525,450
22400530,2,87,4.0,2.7586206896551726,437,350
22400530,2,103,1.0,0.5825242718446602,330,227
22400530,2,215,1.0,0.27906976744186046,218,3
22400530,2,1,2.0,120.0,1,0
22400530,3,211,-1.0,-0.28436018957345977,720,509
22400530,3,114,5.0,2.631578947368421,488,374
22400530,3,75,2.0,1.6,374,299
22400530,3,43,-1.0,-1.3953488372093024,290,247
22400530,3,92,4.0,2.608695652173913,233,141
22400530,3,114,1.0,0.5263157894736842,122,8
22400530,4,139,-5.0,-2.158273381294964,720,581
22400530,4,18,0.0,0.0,566,548
22400530,4,30,3.0,6.0,533,503
22400530,4,123,0.0,0.0,493,370
22400530,4,25,1.0,2.4,360,335
22400530,4,81,-6.0,-4.444444444444445,320,239
22400530,4,18,2.0,6.666666666666666,223,205
22400530,4,188,3.0,0.9574468085106382,188,0
22400531,1,309,-3.0,-0.5825242718446602,720,411
22400531,1,52,3.0,3.4615384615384617,405,353
22400531,1,58,0.0,0.0,335,277
22400531,1,13,-1.0,-4.615384615384616,277,264
22400531,1,7,1.0,8.571428571428571,264,257
22400531,1,49,0.0,0.0,257,208
22400531,1,99,5.0,3.0303030303030303,208,109
22400531,1,65,-6.0,-5.538461538461538,91,26
22400531,1,19,0.0,0.0,26,7
22400531,1,7,0.0,0.0,7,0
22400531,2,85,-1.0,-0.7058823529411764,720,635
22400531,2,157,3.0,1.1464968152866242,618,461
22400531,2,35,0.0,0.0,461,426
22400531,2,52,0.0,0.0,424,372
22400531,2,60,1.0,1.0,372,312
22400531,2,20,2.0,6.0,312,292
22400531,2,56,4.0,4.285714285714286,271,215
22400531,2,78,-2.0,-1.5384615384615383,215,137
22400531,2,137,3.0,1.3138686131386863,137,0
22400531,3,287,8.0,1.6724738675958188,720,433
22400531,3,14,2.0,8.571428571428571,427,413
22400531,3,106,2.0,1.1320754716981132,393,287
22400531,3,89,-3.0,-2.0224719101123596,287,198
22400531,3,40,2.0,3.0,187,147
22400531,3,40,-3.0,-4.5,145,105
22400531,3,36,-2.0,-3.333333333333333,87,51
22400531,3,18,0.0,0.0,51,33
22400531,4,116,-6.0,-3.103448275862069,720,604
22400531,4,91,-4.0,-2.6373626373626378,588,497
22400531,4,48,4.0,5.0,481,433
22400531,4,57,-2.0,-2.1052631578947367,414,357
22400531,4,64,3.0,2.8125,348,284
22400531,4,116,5.0,2.586206896551724,284,168
22400531,4,152,2.0,0.7894736842105263,152,0
22400532,1,306,11.0,2.156862745098039,720,414
22400532,1,27,-1.0,-2.2222222222222223,398,371
22400532,1,189,0.0,0.0,189,0
22400532,2,137,-3.0,-1.3138686131386863,720,583
22400532,2,42,0.0,0.0,578,536
22400532,2,103,-4.0,-2.3300970873786406,514,411
22400532,2,59,1.0,1.0169491525423728,395,336
22400532,2,68,-1.0,-0.8823529411764706,317,249
22400532,2,95,0.0,0.0,242,147
22400532,3,117,2.0,1.0256410256410258,720,603
22400532,3,54,-2.0,-2.2222222222222223,594,540
22400532,3,89,-4.0,-2.696629213483146,518,429
22400532,3,23,3.0,7.826086956521739,429,406
22400532,3,29,-1.0,-2.0689655172413794,397,368
22400532,3,132,-1.0,-0.4545454545454546,368,236
22400532,3,75,-1.0,-0.8,236,161
22400532,3,81,-3.0,-2.2222222222222223,161,80
22400532,3,66,0.0,0.0,80,14
22400532,3,14,2.0,8.571428571428571,14,0
22400532,4,93,-2.0,-1.2903225806451615,720,627
22400532,4,25,0.0,0.0,610,585
22400532,4,98,-3.0,-1.836734693877551,574,476
22400532,4,68,-2.0,-1.7647058823529411,440,372
22400532,4,24,0.0,0.0,360,336
22400532,4,72,2.0,1.6666666666666665,319,247
22400532,4,46,4.0,5.217391304347826,247,201
22400532,4,93,1.0,0.6451612903225807,191,98
22400532,4,52,4.0,4.615384615384616,98,46
22400532,4,21,0.0,0.0,46,25
22400532,4,2,0.0,0.0,12,10
22400532,4,2,0.0,0.0,2,0
22400533,1,263,8.0,1.8250950570342206,720,457
22400533,1,62,0.0,0.0,457,395
22400533,1,117,-1.0,-0.5128205128205129,395,278
22400533,1,68,-1.0,-0.8823529411764706,278,210
22400533,1,141,-2.0,-0.851063829787234,195,54
22400533,1,24,2.0,5.0,54,30
22400533,2,166,-2.0,-0.7228915662650602,720,554
22400533,2,91,2.0,1.3186813186813189,552,461
22400533,2,23,1.0,2.608695652173913,461,438
22400533,2,129,5.0,2.3255813953488373,438,309
22400533,2,65,0.0,0.0,299,234
22400533,2,33,0.0,0.0,225,192
22400533,2,187,1.0,0.32085561497326204,187,0
22400533,3,275,-5.0,-1.0909090909090908,720,445
22400533,3,19,3.0,9.473684210526315,441,422
22400533,3,70,0.0,0.0,401,331
22400533,3,18,0.0,0.0,314,296
22400533,3,45,-2.0,-2.666666666666667,296,251
22400533,3,16,2.0,7.5,238,222
22400533,3,154,-1.0,-0.38961038961038963,212,58
22400533,3,47,0.0,0.0,47,0
22400533,4,162,-3.0,-1.1111111111111112,720,558
22400533,4,117,1.0,0.5128205128205129,558,441
22400533,4,16,0.0,0.0,428,412
22400533,4,178,3.0,1.0112359550561798,401,223
22400533,4,153,0.0,0.0,222,69
22400533,4,40,-5.0,-7.5,69,29
22400534,1,341,11.0,1.935483870967742,720,379
22400534,1,15,1.0,4.0,379,364
22400534,1,51,-5.0,-5.88235294117647,364,313
22400534,1,43,-1.0,-1.3953488372093024,296,253
22400534,1,105,-4.0,-2.285714285714286,242,137
22400534,1,24,0.0,0.0,30,6
22400534,1,2,0.0,0.0,2,0
22400534,2,119,0.0,0.0,720,601
22400534,2,89,0.0,0.0,601,512
22400534,2,66,2.0,1.8181818181818183,512,446
22400534,2,32,0.0,0.0,436,404
22400534,2,17,0.0,0.0,387,370
22400534,2,201,-2.0,-0.5970149253731343,370,169
22400534,2,135,0.0,0.0,169,34
22400534,2,28,-2.0,-4.285714285714286,28,0
22400534,3,272,3.0,0.661764705882353,720,448
22400534,3,106,0.0,0.0,435,329
22400534,3,26,0.0,0.0,315,289
22400534,3,4,1.0,15.0,278,274
22400534,3,45,-1.0,-1.3333333333333335,274,229
22400534,3,74,0.0,0.0,229,155
22400534,3,76,2.0,1.5789473684210527,155,79
22400534,3,62,3.0,2.903225806451613,67,5
22400534,3,2,-2.0,-60.0,2,0
22400534,4,79,-5.0,-3.79746835443038,720,641
22400534,4,56,-2.0,-2.142857142857143,637,581
22400534,4,60,2.0,2.0,569,509
22400534,4,105,1.0,0.5714285714285715,479,374
22400534,4,89,-3.0,-2.0224719101123596,353,264
22400534,4,36,2.0,3.333333333333333,264,228
22400534,4,72,1.0,0.8333333333333333,207,135
22400534,4,31,3.0,5.806451612903226,135,104
22400534,4,91,2.0,1.3186813186813189,91,0
22400535,1,235,-5.0,-1.2765957446808511,720,485
22400535,1,71,4.0,3.380281690140845,477,406
22400535,1,43,0.0,0.0,394,351
22400535,1,32,5.0,9.375,306,274
22400535,1,127,-4.0,-1.889763779527559,248,121
22400535,1,82,0.0,0.0,121,39
22400535,1,39,-1.0,-1.5384615384615383,39,0
22400535,2,139,1.0,0.43165467625899284,720,581
22400535,2,97,0.0,0.0,581,484
22400535,2,67,-2.0,-1.791044776119403,470,403
22400535,2,54,4.0,4.444444444444445,393,339
22400535,2,93,3.0,1.935483870967742,403,310
22400535,2,116,1.0,0.5172413793103449,310,194
22400535,2,52,-2.0,-2.307692307692308,180,128
22400535,2,16,-1.0,-3.75,119,103
22400535,2,103,-2.0,-1.1650485436893203,103,0
22400535,3,266,-3.0,-0.6766917293233082,720,454
22400535,3,49,1.0,1.2244897959183672,444,395
22400535,3,85,-2.0,-1.4117647058823528,395,310
22400535,3,33,-2.0,-3.6363636363636367,310,277
22400535,3,37,4.0,6.486486486486487,265,228
22400535,3,83,-4.0,-2.891566265060241,228,145
22400535,3,40,5.0,7.5,126,86
22400535,3,66,1.0,0.9090909090909092,70,4
22400535,3,2,0.0,0.0,2,0
22400535,4,102,-2.0,-1.1764705882352942,720,618
22400535,4,16,0.0,0.0,604,588
22400535,4,42,1.0,1.4285714285714284,578,536
22400535,4,161,3.0,1.1180124223602486,521,360
22400535,4,54,-2.0,-2.2222222222222223,360,306
22400535,4,24,2.0,5.0,306,282
22400535,4,51,-2.0,-2.3529411764705883,274,223
22400535,4,53,3.0,3.3962264150943398,212,159
22400535,4,126,-6.0,-2.8571428571428568,144,18
22400535,4,7,0.0,0.0,7,0
22400536,1,268,3.0,0.6716417910447761,720,452
22400536,1,125,-3.0,-1.44,445,320
22400536,1,195,-1.0,-0.3076923076923077,320,125
22400536,1,48,1.0,1.25,112,64
22400536,1,25,-1.0,-2.4,64,39
22400536,1,39,0.0,0.0,39,0
22400536,2,207,-4.0,-1.1594202898550725,720,513
22400536,2,97,-2.0,-1.2371134020618557,513,416
22400536,2,33,2.0,3.6363636363636367,409,376
22400536,2,46,-1.0,-1.3043478260869565,362,316
22400536,2,14,0.0,0.0,312,298
22400536,2,84,-2.0,-1.4285714285714284,288,204
22400536,2,17,-3.0,-10.588235294117649,201,184
22400536,2,88,1.0,0.6818181818181819,173,85
22400536,2,75,-4.0,-3.2,75,0
22400536,3,340,12.0,2.1176470588235294,720,380
22400536,3,28,1.0,2.142857142857143,376,348
22400536,3,125,0.0,0.0,348,223
22400536,3,106,2.0,1.1320754716981132,207,101
22400536,3,12,-1.0,-5.0,91,79
22400536,3,79,-3.0,-2.278481012658228,79,0
22400536,4,135,-6.0,-2.666666666666667,720,585
22400536,4,132,2.0,0.9090909090909092,560,428
22400536,4,16,0.0,0.0,426,410
22400536,4,88,3.0,2.0454545454545454,404,316
22400536,4,101,-4.0,-2.376237623762376,316,215
22400536,4,92,-5.0,-3.260869565217391,215,123
22400536,4,98,-3.0,-1.836734693877551,98,0
22400537,1,312,5.0,0.9615384615384615,720,408
22400537,1,80,-3.0,-2.25,408,328
22400537,1,33,1.0,1.8181818181818183,316,283
22400537,1,36,0.0,0.0,283,247
22400537,1,14,0.0,0.0,243,229
22400537,1,18,0.0,0.0,216,198
22400537,1,73,-3.0,-2.4657534246575343,176,103
22400537,1,95,6.0,3.7894736842105265,95,0
22400537,2,54,0.0,0.0,720,666
22400537,2,50,0.0,0.0,663,613
22400537,2,141,0.0,0.0,603,462
22400537,2,93,4.0,2.580645161290323,462,369
22400537,2,19,1.0,3.1578947368421053,351,332
22400537,2,27,-2.0,-4.444444444444445,332,305
22400537,2,116,2.0,1.0344827586206897,305,189
22400537,2,182,0.0,0.0,182,0
22400537,3,159,1.0,0.37735849056603776,720,561
22400537,3,143,2.0,0.8391608391608392,548,405
22400537,3,90,2.0,1.3333333333333335,390,300
22400537,3,87,1.0,0.6896551724137931,287,200
22400537,3,112,-4.0,-2.142857142857143,186,74
22400537,3,67,-2.0,-1.791044776119403,67,0
22400537,4,115,-1.0,-0.5217391304347826,720,605
22400537,4,83,2.0,1.4457831325301205,605,522
22400537,4,41,0.0,0.0,508,467
22400537,4,73,-5.0,-4.10958904109589,460,387
22400537,4,222,4.0,1.0810810810810811,372,150
22400537,4,138,-2.0,-0.8695652173913043,138,0
22400538,1,333,-3.0,-0.5405405405405406,720,387
22400538,1,110,5.0,2.7272727272727275,373,263
22400538,1,44,0.0,0.0,251,207
22400538,1,93,6.0,3.870967741935484,196,103
22400538,1,103,0.0,0.0,103,0
22400538,2,86,0.0,0.0,720,634
22400538,2,72,0.0,0.0,622,550
22400538,2,93,-1.0,-0.6451612903225807,537,444
22400538,2,97,2.0,1.2371134020618557,440,343
22400538,2,101,5.0,2.9702970297029703,343,242
22400538,2,29,2.0,4.137931034482759,242,213
22400538,2,213,4.0,1.1267605633802817,213,0
22400538,3,348,7.0,1.206896551724138,720,372
22400538,3,58,0.0,0.0,372,314
22400538,3,157,-1.0,-0.3821656050955414,287,130
22400538,3,125,0.0,0.0,130,5
22400538,4,141,0.0,0.0,720,579
22400538,4,137,2.0,0.875912408759124,579,442
22400538,4,420,0.0,0.0,420,0
22400539,1,211,6.0,1.7061611374407581,720,509
22400539,1,67,-7.0,-6.26865671641791,509,442
22400539,1,148,1.0,0.40540540540540543,431,283
22400539,1,65,2.0,1.8461538461538463,283,218
22400539,1,54,0.0,0.0,218,164
22400539,2,309,2.0,0.3883495145631068,720,411
22400539,2,112,2.0,1.0714285714285714,395,283
22400539,2,53,4.0,4.528301886792453,269,216
22400539,2,59,3.0,3.050847457627119,203,144
22400539,2,79,1.0,0.7594936708860759,144,65
22400539,2,40,2.0,3.0,40,0
22400539,3,102,10.0,5.88235294117647,720,618
22400539,3,24,0.0,0.0,606,582
22400539,3,71,2.0,1.6901408450704225,556,485
22400539,3,159,-4.0,-1.509433962264151,485,326
22400539,3,91,-2.0,-1.3186813186813189,305,214
22400539,3,132,-1.0,-0.4545454545454546,200,68
22400539,3,56,-2.0,-2.142857142857143,59,3
22400539,3,3,0.0,0.0,3,0
22400539,4,183,0.0,0.0,720,537
22400539,4,34,2.0,3.5294117647058822,537,503
22400539,4,16,0.0,0.0,493,477
22400539,4,55,2.0,2.1818181818181817,467,412
22400539,4,34,2.0,3.5294117647058822,404,370
22400539,4,12,0.0,0.0,360,348
22400539,4,15,1.0,4.0,337,322
22400539,4,1,0.0,0.0,322,321
22400539,4,111,-1.0,-0.5405405405405406,302,191
22400539,4,187,5.0,1.6042780748663101,187,0
22400540,1,369,14.0,2.2764227642276422,720,351
22400540,1,47,0.0,0.0,351,304
22400540,1,55,-1.0,-1.0909090909090908,301,246
22400540,1,34,-1.0,-1.7647058823529411,246,212
22400540,1,79,4.0,3.0379746835443036,204,125
22400540,1,87,1.0,0.6896551724137931,122,35
22400540,1,33,-2.0,-3.6363636363636367,33,0
22400540,2,83,0.0,0.0,720,637
22400540,2,67,-5.0,-4.477611940298507,637,570
22400540,2,49,-2.0,-2.4489795918367343,560,511
22400540,2,28,1.0,2.142857142857143,500,472
22400540,2,34,-1.0,-1.7647058823529411,463,429
22400540,2,12,-1.0,-5.0,429,417
22400540,2,36,0.0,0.0,417,381
22400540,2,44,-2.0,-2.7272727272727275,363,319
22400540,2,25,0.0,0.0,305,280
22400540,2,7,0.0,0.0,280,273
22400540,2,142,-2.0,-0.8450704225352113,273,131
22400540,2,123,-7.0,-3.4146341463414633,131,8
22400540,2,1,0.0,0.0,1,0
22400540,3,281,4.0,0.8540925266903914,720,439
22400540,3,31,5.0,9.67741935483871,429,398
22400540,3,66,4.0,3.6363636363636367,384,318
22400540,3,73,2.0,1.643835616438356,312,239
22400540,3,51,0.0,0.0,239,188
22400540,3,77,-5.0,-3.8961038961038956,174,97
22400540,3,69,1.0,0.8695652173913043,97,28
22400540,3,28,0.0,0.0,28,0
22400540,4,246,-8.0,-1.9512195121951221,720,474
22400540,4,55,2.0,2.1818181818181817,474,419
22400540,4,55,-1.0,-1.0909090909090908,406,351
22400540,4,41,-2.0,-2.926829268292683,329,288
22400540,4,73,-3.0,-2.4657534246575343,278,205
22400540,4,183,-9.0,-2.9508196721311473,183,0
22400541,1,223,4.0,1.0762331838565022,720,497
22400541,1,68,2.0,1.7647058823529411,497,429
22400541,1,86,2.0,1.3953488372093024,420,334
22400541,1,76,1.0,0.7894736842105263,325,249
22400541,1,29,-2.0,-4.137931034482759,249,220
22400541,1,83,0.0,0.0,208,125
22400541,2,59,3.0,3.050847457627119,720,661
22400541,2,94,-4.0,-2.5531914893617023,648,554
22400541,2,13,0.0,0.0,544,531
22400541,2,38,0.0,0.0,531,493
22400541,2,114,3.0,1.5789473684210527,493,379
22400541,2,113,1.0,0.5309734513274336,379,266
22400541,2,98,0.0,0.0,248,150
22400541,2,127,-1.0,-0.47244094488188976,145,18
22400541,2,18,1.0,3.333333333333333,18,0
22400541,3,220,3.0,0.8181818181818181,720,500
22400541,3,53,0.0,0.0,492,439
22400541,3,17,-3.0,-10.588235294117649,434,417
22400541,3,145,4.0,1.6551724137931034,402,257
22400541,3,37,1.0,1.6216216216216217,249,212
22400541,3,39,-2.0,-3.0769230769230766,212,173
22400541,3,141,-8.0,-3.404255319148936,141,0
22400541,4,150,3.0,1.2,720,570
22400541,4,13,0.0,0.0,563,550
22400541,4,111,2.0,1.0810810810810811,550,439
22400541,4,98,0.0,0.0,424,326
22400541,4,6,-2.0,-20.0,317,311
22400541,4,69,0.0,0.0,311,242
22400541,4,143,1.0,0.4195804195804196,232,89
22400541,4,76,-1.0,-0.7894736842105263,89,13
22400542,1,262,-2.0,-0.4580152671755725,720,458
22400542,1,89,-2.0,-1.348314606741573,458,369
22400542,1,55,-1.0,-1.0909090909090908,369,314
22400542,1,92,-4.0,-2.608695652173913,314,222
22400542,1,72,3.0,2.5,213,141
22400542,1,96,0.0,0.0,141,45
22400542,1,32,0.0,0.0,32,0
22400542,2,156,1.0,0.3846153846153846,720,564
22400542,2,102,4.0,2.3529411764705883,553,451
22400542,2,130,5.0,2.307692307692308,440,310
22400542,2,82,-8.0,-5.853658536585366,300,218
22400542,2,94,2.0,1.2765957446808511,207,113
22400542,2,58,-2.0,-2.0689655172413794,108,50
22400542,2,50,0.0,0.0,50,0
22400542,3,284,1.0,0.2112676056338028,720,436
22400542,3,74,-3.0,-2.4324324324324325,429,355
22400542,3,55,-1.0,-1.0909090909090908,343,288
22400542,3,93,0.0,0.0,288,195
22400542,3,131,2.0,0.916030534351145,195,64
22400542,3,48,-1.0,-1.25,55,7
22400542,4,182,-1.0,-0.3296703296703297,720,538
22400542,4,44,-2.0,-2.7272727272727275,538,494
22400542,4,70,3.0,2.5714285714285716,494,424
22400542,4,79,-1.0,-0.7594936708860759,414,335
22400542,4,62,-2.0,-1.935483870967742,327,265
22400542,4,243,2.0,0.4938271604938272,265,22
22400542,4,16,-3.0,-11.25,22,6
22400542,4,1,0.0,0.0,1,0
22400543,1,308,6.0,1.1688311688311688,720,412
22400543,1,43,-1.0,-1.3953488372093024,399,356
22400543,1,34,0.0,0.0,351,317
22400543,1,86,-3.0,-2.0930232558139537,312,226
22400543,1,93,-4.0,-2.580645161290323,206,113
22400543,1,97,-4.0,-2.4742268041237114,97,0
22400543,2,86,5.0,3.488372093023256,720,634
22400543,2,79,-2.0,-1.5189873417721518,619,540
22400543,2,15,0.0,0.0,518,503
22400543,2,108,0.0,0.0,495,387
22400543,2,22,0.0,0.0,362,340
22400543,2,102,4.0,2.3529411764705883,340,238
22400543,2,69,0.0,0.0,238,169
22400543,2,169,9.0,3.195266272189349,169,0
22400543,3,285,-7.0,-1.4736842105263157,720,435
22400543,3,73,-3.0,-2.4657534246575343,424,351
22400543,3,55,-1.0,-1.0909090909090908,351,296
22400543,3,25,1.0,2.4,296,271
22400543,3,76,-2.0,-1.5789473684210527,271,195
22400543,3,76,-10.0,-7.894736842105263,195,119
22400543,3,92,0.0,0.0,105,13
22400543,3,13,0.0,0.0,13,0
22400543,4,122,-2.0,-0.9836065573770493,720,598
22400543,4,52,1.0,1.153846153846154,598,546
22400543,4,23,-1.0,-2.608695652173913,546,523
22400543,4,16,-1.0,-3.75,515,499
22400543,4,23,0.0,0.0,499,476
22400543,4,35,-3.0,-5.142857142857143,461,426
22400543,4,46,1.0,1.3043478260869565,426,380
22400543,4,103,-7.0,-4.077669902912621,380,277
22400543,4,113,1.0,0.5309734513274336,277,164
22400543,4,148,0.0,0.0,148,0
22400544,1,61,0.0,0.0,720,659
22400544,1,251,5.0,1.1952191235059761,649,398
22400544,1,74,-2.0,-1.6216216216216217,398,324
22400544,1,56,-1.0,-1.0714285714285714,303,247
22400544,1,46,-2.0,-2.608695652173913,241,195
22400544,1,13,0.0,0.0,195,182
22400544,1,14,0.0,0.0,177,163
22400544,1,65,0.0,0.0,144,79
22400544,1,79,2.0,1.5189873417721518,79,0
22400544,2,152,1.0,0.39473684210526316,720,568
22400544,2,151,4.0,1.5894039735099337,559,408
22400544,2,19,0.0,0.0,397,378
22400544,2,87,3.0,2.0689655172413794,361,274
22400544,2,65,-1.0,-0.9230769230769231,274,209
22400544,2,51,0.0,0.0,209,158
22400544,2,27,-2.0,-4.444444444444445,158,131
22400544,3,358,-2.0,-0.335195530726257,720,362
22400544,3,99,-1.0,-0.6060606060606061,333,234
22400544,3,120,-1.0,-0.5,222,102
22400544,3,82,3.0,2.195121951219512,92,10
22400544,3,10,3.0,18.0,10,0
22400544,4,110,3.0,1.6363636363636362,720,610
22400544,4,73,0.0,0.0,599,526
22400544,4,75,2.0,1.6,517,442
22400544,4,82,-1.0,-0.7317073170731707,426,344
22400544,4,175,0.0,0.0,344,169
22400544,4,160,7.0,2.625,169,9
22400545,1,401,-3.0,-0.44887780548628425,720,319
22400545,1,49,-2.0,-2.4489795918367343,315,266
22400545,1,56,2.0,2.142857142857143,256,200
22400545,1,16,0.0,0.0,200,184
22400545,1,177,-10.0,-3.389830508474576,184,7
22400545,1,1,0.0,0.0,1,0
22400545,2,197,-4.0,-1.2182741116751268,720,523
22400545,2,143,2.0,0.8391608391608392,511,368
22400545,2,104,-3.0,-1.7307692307692308,335,231
22400545,2,74,-1.0,-0.8108108108108109,208,134
22400545,2,122,-4.0,-1.9672131147540985,134,12
22400545,3,312,-5.0,-0.9615384615384615,720,408
22400545,3,62,0.0,0.0,408,346
22400545,3,13,0.0,0.0,341,328
22400545,3,67,1.0,0.8955223880597015,323,256
22400545,3,22,-1.0,-2.7272727272727275,256,234
22400545,3,70,-2.0,-1.7142857142857142,234,164
22400545,3,156,-4.0,-1.5384615384615383,164,8
22400545,3,2,0.0,0.0,2,0
22400545,4,230,-2.0,-0.5217391304347826,720,490
22400545,4,105,-2.0,-1.142857142857143,475,370
22400545,4,53,1.0,1.1320754716981132,369,316
22400545,4,316,-2.0,-0.37974683544303794,316,0
22400546,1,302,0.0,0.0,720,418
22400546,1,47,-3.0,-3.829787234042553,394,347
22400546,1,54,-2.0,-2.2222222222222223,336,282
22400546,1,40,2.0,3.0,271,231
22400546,1,32,0.0,0.0,208,176
22400546,1,158,2.0,0.7594936708860759,158,0
22400546,2,110,-2.0,-1.0909090909090908,720,610
22400546,2,104,1.0,0.576923076923077,599,495
22400546,2,85,-2.0,-1.4117647058823528,495,410
22400546,2,24,0.0,0.0,410,386
22400546,2,136,6.0,2.647058823529412,366,230
22400546,2,108,1.0,0.5555555555555556,230,122
22400546,2,71,-4.0,-3.380281690140845,105,34
22400546,3,221,0.0,0.0,720,499
22400546,3,51,0.0,0.0,494,443
22400546,3,23,0.0,0.0,443,420
22400546,3,11,3.0,16.363636363636363,406,395
22400546,3,60,-2.0,-2.0,386,326
22400546,3,40,-2.0,-3.0,326,286
22400546,3,43,-4.0,-5.5813953488372094,283,240
22400546,3,71,5.0,4.225352112676057,222,151
22400546,3,151,5.0,1.9867549668874174,151,0
22400546,4,70,0.0,0.0,720,650
22400546,4,71,-3.0,-2.535211267605634,650,579
22400546,4,47,2.0,2.5531914893617023,579,532
22400546,4,66,4.0,3.6363636363636367,517,451
22400546,4,117,-1.0,-0.5128205128205129,451,334
22400546,4,110,-3.0,-1.6363636363636362,334,224
22400546,4,217,-5.0,-1.3824884792626728,217,0
22400546,5,142,3.0,1.267605633802817,300,158
22400546,5,144,0.0,0.0,144,0
22400547,1,248,-4.0,-0.967741935483871,720,472
22400547,1,18,-2.0,-6.666666666666666,460,442
22400547,1,121,-5.0,-2.479338842975207,425,304
22400547,1,44,-3.0,-4.090909090909091,304,260
22400547,1,139,3.0,1.2949640287769786,252,113
22400547,1,103,1.0,0.5825242718446602,103,0
22400547,2,102,5.0,2.941176470588235,720,618
22400547,2,42,1.0,1.4285714285714284,614,572
22400547,2,52,2.0,2.307692307692308,572,520
22400547,2,96,-1.0,-0.625,501,405
22400547,2,22,-3.0,-8.181818181818182,394,372
22400547,2,131,1.0,0.4580152671755725,354,223
22400547,2,35,0.0,0.0,209,174
22400547,2,4,0.0,0.0,158,154
22400547,2,17,0.0,0.0,148,131
22400547,2,48,1.0,1.25,131,83
22400547,2,50,2.0,2.4,83,33
22400547,2,31,-2.0,-3.870967741935484,33,2
22400547,2,1,0.0,0.0,1,0
22400547,3,312,-3.0,-0.576923076923077,720,408
22400547,3,38,-2.0,-3.1578947368421053,402,364
22400547,3,81,-4.0,-2.962962962962963,364,283
22400547,3,87,1.0,0.6896551724137931,283,196
22400547,3,56,-3.0,-3.214285714285714,175,119
22400547,3,23,0.0,0.0,119,96
22400547,3,4,-2.0,-30.0,4,0
22400547,4,97,2.0,1.2371134020618557,720,623
22400547,4,68,-4.0,-3.5294117647058822,607,539
22400547,4,71,0.0,0.0,527,456
22400547,4,98,2.0,1.2244897959183672,447,349
22400547,4,105,2.0,1.142857142857143,339,234
22400547,4,126,1.0,0.47619047619047616,234,108
22400547,4,57,7.0,7.368421052631579,97,40
22400547,4,35,2.0,3.4285714285714284,35,0
22400548,1,451,-8.0,-1.06430155210643,720,269
22400548,1,51,2.0,2.3529411764705883,269,218
22400548,1,95,-5.0,-3.1578947368421053,201,106
22400548,1,94,3.0,1.9148936170212765,94,0
22400548,2,92,-2.0,-1.3043478260869565,720,628
22400548,2,125,1.0,0.48,617,492
22400548,2,21,-2.0,-5.7142857142857135,485,464
22400548,2,184,3.0,0.9782608695652174,454,270
22400548,2,20,0.0,0.0,255,235
22400548,2,217,-2.0,-0.5529953917050692,222,5
22400548,3,367,-1.0,-0.16348773841961853,720,353
22400548,3,19,2.0,6.315789473684211,339,320
22400548,3,60,5.0,5.0,302,242
22400548,3,13,0.0,0.0,228,215
22400548,3,71,0.0,0.0,215,144
22400548,3,130,-6.0,-2.769230769230769,130,0
22400548,4,72,2.0,1.6666666666666665,720,648
22400548,4,91,-3.0,-1.978021978021978,648,557
22400548,4,85,-3.0,-2.1176470588235294,557,472
22400548,4,52,-3.0,-3.4615384615384617,458,406
22400548,4,36,-1.0,-1.6666666666666665,406,370
22400548,4,198,1.0,0.30303030303030304,370,172
22400548,4,90,-5.0,-3.333333333333333,172,82
22400548,4,7,0.0,0.0,82,75
22400548,4,69,3.0,2.608695652173913,69,0
22400549,1,197,-5.0,-1.5228426395939085,720,523
22400549,1,213,-1.0,-0.28169014084507044,523,310
22400549,1,28,0.0,0.0,310,282
22400549,1,50,1.0,1.2,267,217
22400549,1,104,0.0,0.0,217,113
22400549,2,24,0.0,0.0,720,696
22400549,2,45,7.0,9.333333333333334,685,640
22400549,2,28,-2.0,-4.285714285714286,624,596
22400549,2,52,5.0,5.769230769230769,585,533
22400549,2,26,3.0,6.923076923076923,533,507
22400549,2,61,-2.0,-1.9672131147540985,507,446
22400549,2,54,2.0,2.2222222222222223,446,392
22400549,2,77,3.0,2.3376623376623376,392,315
22400549,2,162,3.0,1.1111111111111112,308,146
22400549,2,65,-3.0,-2.769230769230769,133,68
22400549,2,67,1.0,0.8955223880597015,68,1
22400549,3,188,-3.0,-0.9574468085106382,720,532
22400549,3,302,-5.0,-0.9933774834437087,532,230
22400549,3,8,-2.0,-15.0,230,222
22400549,3,17,0.0,0.0,222,205
22400549,3,84,3.0,2.142857142857143,205,121
22400549,3,83,-1.0,-0.7228915662650602,106,23
22400549,3,2,0.0,0.0,2,0
22400549,4,46,-1.0,-1.3043478260869565,720,674
22400549,4,95,0.0,0.0,668,573
22400549,4,26,2.0,4.615384615384616,566,540
22400549,4,93,3.0,1.935483870967742,540,447
22400549,4,23,2.0,5.217391304347826,270,247
22400549,4,139,0.0,0.0,247,108
22400549,4,40,3.0,4.5,100,60
22400549,4,33,-1.0,-1.8181818181818183,39,6
22400550,1,200,-5.0,-1.5,720,520
22400550,1,137,2.0,0.875912408759124,505,368
22400550,1,25,0.0,0.0,354,329
22400550,1,22,0.0,0.0,329,307
22400550,1,82,-2.0,-1.4634146341463414,292,210
22400550,1,18,0.0,0.0,197,179
22400550,1,83,6.0,4.337349397590361,179,96
22400550,1,39,-1.0,-1.5384615384615383,72,33
22400550,1,33,0.0,0.0,33,0
22400550,2,183,4.0,1.3114754098360655,720,537
22400550,2,96,3.0,1.875,537,441
22400550,2,151,-8.0,-3.1788079470198674,441,290
22400550,2,164,4.0,1.4634146341463414,290,126
22400550,2,107,1.0,0.5607476635514018,126,19
22400550,2,19,0.0,0.0,19,0
22400550,3,295,-8.0,-1.6271186440677965,720,425
22400550,3,92,3.0,1.9565217391304348,411,319
22400550,3,101,0.0,0.0,319,218
22400550,3,52,0.0,0.0,218,166
22400550,3,141,0.0,0.0,146,5
22400550,3,1,1.0,60.0,5,4
22400550,3,4,0.0,0.0,4,0
22400550,4,129,-3.0,-1.3953488372093024,720,591
22400550,4,36,0.0,0.0,581,545
22400550,4,28,3.0,6.428571428571428,528,500
22400550,4,25,0.0,0.0,476,451
22400550,4,44,0.0,0.0,427,383
22400550,4,96,1.0,0.625,376,280
22400550,4,52,1.0,1.153846153846154,268,216
22400550,4,152,2.0,0.7894736842105263,207,55
22400550,4,52,2.0,2.307692307692308,55,3
22400550,4,1,0.0,0.0,1,0
22400551,1,253,1.0,0.23715415019762845,720,467
22400551,1,131,5.0,2.290076335877863,456,325
22400551,1,180,-2.0,-0.6666666666666667,317,137
22400551,1,27,0.0,0.0,118,91
22400551,1,37,2.0,3.2432432432432434,74,37
22400551,1,36,-3.0,-5.0,37,1
22400551,2,171,1.0,0.3508771929824561,720,549
22400551,2,75,2.0,1.6,546,471
22400551,2,71,-4.0,-3.380281690140845,462,391
22400551,2,134,2.0,0.8955223880597015,385,251
22400551,2,66,3.0,2.7272727272727275,240,174
22400551,2,13,-1.0,-4.615384615384616,174,161
22400551,2,30,2.0,4.0,161,131
22400551,2,36,0.0,0.0,131,95
22400551,3,259,2.0,0.46332046332046334,720,461
22400551,3,141,-5.0,-2.127659574468085,461,320
22400551,3,29,0.0,0.0,320,291
22400551,3,78,-5.0,-3.846153846153846,320,242
22400551,3,16,1.0,3.75,242,226
22400551,3,113,-3.0,-1.592920353982301,226,113
22400551,3,113,8.0,4.2477876106194685,113,0
22400551,4,22,-1.0,-2.7272727272727275,720,698
22400551,4,80,-2.0,-1.5,698,618
22400551,4,126,-1.0,-0.47619047619047616,616,490
22400551,4,39,0.0,0.0,490,451
22400551,4,17,1.0,3.5294117647058822,446,429
22400551,4,48,3.0,3.75,405,357
22400551,4,41,2.0,2.926829268292683,338,297
22400551,4,44,-3.0,-4.090909090909091,272,228
22400551,4,14,0.0,0.0,228,214
22400551,4,24,-2.0,-5.0,214,190
22400551,4,163,1.0,0.36809815950920244,171,8
22400551,4,2,0.0,0.0,8,6
22400551,4,4,1.0,15.0,6,2
22400552,1,334,-3.0,-0.5389221556886228,720,386
22400552,1,196,-4.0,-1.2244897959183672,377,181
22400552,1,22,1.0,2.7272727272727275,181,159
22400552,1,42,0.0,0.0,159,117
22400552,1,105,0.0,0.0,105,0
22400552,2,133,0.0,0.0,720,587
22400552,2,136,5.0,2.2058823529411766,576,440
22400552,2,181,6.0,1.9889502762430937,440,259
22400552,2,2,2.0,60.0,247,245
22400552,2,73,-3.0,-2.4657534246575343,245,172
22400552,2,82,2.0,1.4634146341463414,172,90
22400552,2,90,-1.0,-0.6666666666666667,90,0
22400552,3,344,-5.0,-0.872093023255814,720,376
22400552,3,2,0.0,0.0,366,364
22400552,3,13,0.0,0.0,364,351
22400552,3,106,7.0,3.9622641509433962,343,237
22400552,3,40,-2.0,-3.0,220,180
22400552,3,45,-2.0,-2.666666666666667,163,118
22400552,3,104,1.0,0.576923076923077,104,0
22400552,4,82,0.0,0.0,720,638
22400552,4,36,-2.0,-3.333333333333333,638,602
22400552,4,30,-3.0,-6.0,595,565
22400552,4,89,-1.0,-0.6741573033707865,555,466
22400552,4,35,-3.0,-5.142857142857143,449,414
22400552,4,69,0.0,0.0,414,345
22400552,4,84,-3.0,-2.142857142857143,329,245
22400552,4,103,-2.0,-1.1650485436893203,229,126
22400552,4,25,-1.0,-2.4,126,101
22400553,1,433,-7.0,-0.9699769053117784,720,287
22400553,1,56,-3.0,-3.214285714285714,285,229
22400553,1,229,3.0,0.7860262008733624,229,0
22400553,2,269,1.0,0.22304832713754646,720,451
22400553,2,100,1.0,0.6,432,332
22400553,2,94,1.0,0.6382978723404256,332,238
22400553,2,224,0.0,0.0,224,0
22400553,3,252,2.0,0.47619047619047616,720,468
22400553,3,91,4.0,2.6373626373626378,451,360
22400553,3,176,6.0,2.0454545454545454,342,166
22400553,3,85,4.0,2.8235294117647056,144,59
22400553,3,50,5.0,6.0,50,0
22400553,4,100,5.0,3.0,720,620
22400553,4,83,1.0,0.7228915662650602,596,513
22400553,4,25,0.0,0.0,513,488
22400553,4,66,1.0,0.9090909090909092,479,413
22400553,4,63,2.0,1.9047619047619047,398,335
22400553,4,176,-8.0,-2.7272727272727275,176,0
22400554,1,307,-1.0,-0.19543973941368079,720,413
22400554,1,20,-1.0,-3.0,413,393
22400554,1,130,0.0,0.0,382,252
22400554,1,55,1.0,1.0909090909090908,252,197
22400554,1,33,-1.0,-1.8181818181818183,197,164
22400554,1,156,-5.0,-1.923076923076923,156,0
22400554,2,91,5.0,3.2967032967032965,720,629
22400554,2,33,4.0,7.272727272727273,617,584
22400554,2,23,-3.0,-7.826086956521739,584,561
22400554,2,16,0.0,0.0,550,534
22400554,2,14,0.0,0.0,534,520
22400554,2,160,-2.0,-0.75,496,336
22400554,2,18,-2.0,-6.666666666666666,334,316
22400554,2,64,0.0,0.0,304,240
22400554,2,76,0.0,0.0,240,164
22400554,2,87,2.0,1.3793103448275863,164,77
22400554,2,77,4.0,3.116883116883117,77,0
22400554,3,247,-1.0,-0.24291497975708504,720,473
22400554,3,157,-6.0,-2.2929936305732483,457,300
22400554,3,15,0.0,0.0,287,272
22400554,3,58,-7.0,-7.241379310344828,272,214
22400554,3,133,1.0,0.45112781954887216,194,61
22400554,3,1,0.0,0.0,24,23
22400554,4,181,2.0,0.6629834254143646,720,539
22400554,4,62,2.0,1.935483870967742,539,477
22400554,4,64,2.0,1.875,465,401
22400554,4,33,-2.0,-3.6363636363636367,391,358
22400554,4,96,-3.0,-1.875,350,254
22400554,4,16,2.0,7.5,254,238
22400554,4,110,-2.0,-1.0909090909090908,238,128
22400554,4,87,-2.0,-1.3793103448275863,176,89
22400554,4,78,4.0,3.0769230769230766,78,0
22400555,1,274,-5.0,-1.094890510948905,720,446
22400555,1,64,-2.0,-1.875,445,381
22400555,1,116,-4.0,-2.0689655172413794,381,265
22400555,1,43,-2.0,-2.7906976744186047,265,222
22400555,1,77,-3.0,-2.3376623376623376,209,132
22400555,1,127,1.0,0.47244094488188976,129,2
22400555,1,1,0.0,0.0,1,0
22400555,2,127,1.0,0.47244094488188976,720,593
22400555,2,101,3.0,1.782178217821782,578,477
22400555,2,54,-2.0,-2.2222222222222223,458,404
22400555,2,10,0.0,0.0,386,376
22400555,2,65,1.0,0.9230769230769231,374,309
22400555,2,104,-5.0,-2.8846153846153846,299,195
22400555,2,89,-1.0,-0.6741573033707865,188,99
22400555,2,99,0.0,0.0,99,0
22400555,3,95,-4.0,-2.526315789473684,720,625
22400555,3,177,-2.0,-0.6779661016949152,614,437
22400555,3,21,-1.0,-2.8571428571428568,428,407
22400555,3,149,3.0,1.2080536912751678,407,258
22400555,3,239,8.0,2.00836820083682,239,0
22400555,4,138,2.0,0.8695652173913043,720,582
22400555,4,54,-5.0,-5.555555555555555,582,528
22400555,4,58,0.0,0.0,511,453
22400555,4,48,0.0,0.0,440,392
22400555,4,18,0.0,0.0,374,356
22400555,4,49,-4.0,-4.897959183673469,356,307
22400555,4,15,0.0,0.0,307,292
22400555,4,50,-2.0,-2.4,281,231
22400555,4,81,2.0,1.4814814814814814,231,150
22400555,4,47,-2.0,-2.5531914893617023,141,94
22400555,4,94,1.0,0.6382978723404256,94,0
22400556,1,353,1.0,0.16997167138810199,720,367
22400556,1,14,2.0,8.571428571428571,352,338
22400556,1,98,-2.0,-1.2244897959183672,323,225
22400556,1,17,-1.0,-3.5294117647058822,225,208
22400556,1,208,1.0,0.2884615384615385,208,0
22400556,2,128,5.0,2.34375,720,592
22400556,2,7,0.0,0.0,574,567
22400556,2,2,0.0,0.0,555,553
22400556,2,91,-1.0,-0.6593406593406594,530,439
22400556,2,119,5.0,2.521008403361345,439,320
22400556,2,62,1.0,0.967741935483871,271,209
22400556,2,81,0.0,0.0,195,114
22400556,2,91,-1.0,-0.6593406593406594,98,7
22400556,2,7,0.0,0.0,7,0
22400556,3,224,-10.0,-2.678571428571429,720,496
22400556,3,98,-1.0,-0.6122448979591836,496,398
22400556,3,45,-2.0,-2.666666666666667,398,353
22400556,3,78,-1.0,-0.7692307692307692,345,267
22400556,3,13,2.0,9.230769230769232,267,254
22400556,3,58,0.0,0.0,254,196
22400556,3,95,3.0,1.8947368421052633,196,101
22400556,3,101,3.0,1.782178217821782,101,0
22400556,4,70,6.0,5.142857142857143,720,650
22400556,4,113,-4.0,-2.1238938053097343,639,526
22400556,4,90,-2.0,-1.3333333333333335,515,425
22400556,4,128,1.0,0.46875,410,282
22400556,4,93,7.0,4.516129032258065,272,179
22400556,4,89,-3.0,-2.0224719101123596,172,83
22400556,4,83,-1.0,-0.7228915662650602,83,0
22400557,1,226,3.0,0.7964601769911505,720,494
22400557,1,29,-2.0,-4.137931034482759,480,451
22400557,1,151,2.0,0.7947019867549668,450,299
22400557,1,43,5.0,6.976744186046512,288,245
22400557,1,44,-1.0,-1.3636363636363638,235,191
22400557,1,7,0.0,0.0,175,168
22400557,1,37,2.0,3.2432432432432434,151,114
22400557,1,20,0.0,0.0,100,80
22400557,1,69,-4.0,-3.4782608695652173,69,0
22400557,2,129,-6.0,-2.7906976744186047,720,591
22400557,2,66,-2.0,-1.8181818181818183,591,525
22400557,2,29,5.0,10.344827586206897,512,483
22400557,2,144,1.0,0.41666666666666663,483,339
22400557,2,93,2.0,1.2903225806451615,329,236
22400557,2,131,-2.0,-0.916030534351145,234,103
22400557,2,103,3.0,1.7475728155339807,103,0
22400557,3,244,-2.0,-0.49180327868852464,720,476
22400557,3,193,-6.0,-1.8652849740932642,476,283
22400557,3,34,0.0,0.0,283,249
22400557,3,73,4.0,3.287671232876712,240,167
22400557,3,165,-1.0,-0.36363636363636365,167,2
22400557,4,17,0.0,0.0,720,703
22400557,4,14,0.0,0.0,686,672
22400557,4,143,-6.0,-2.5174825174825175,672,529
22400557,4,27,0.0,0.0,502,475
22400557,4,76,-1.0,-0.7894736842105263,466,390
22400557,4,64,-5.0,-4.6875,380,316
22400557,4,66,0.0,0.0,305,239
22400557,4,126,3.0,1.4285714285714284,239,113
22400557,4,58,4.0,4.137931034482759,98,40
22400557,4,40,1.0,1.5,40,0
22400558,1,319,0.0,0.0,720,401
22400558,1,101,11.0,6.534653465346534,390,289
22400558,1,41,3.0,4.390243902439024,270,229
22400558,1,121,3.0,1.487603305785124,220,99
22400558,1,89,3.0,2.0224719101123596,89,0
22400558,2,135,5.0,2.2222222222222223,720,585
22400558,2,12,2.0,10.0,577,565
22400558,2,104,0.0,0.0,553,449
22400558,2,37,-2.0,-3.2432432432432434,441,404
22400558,2,72,-2.0,-1.6666666666666665,388,316
22400558,2,35,0.0,0.0,316,281
22400558,2,140,-1.0,-0.42857142857142855,274,134
22400558,2,10,2.0,12.0,126,116
22400558,2,22,-1.0,-2.7272727272727275,116,94
22400558,2,94,4.0,2.5531914893617023,94,0
22400558,3,231,0.0,0.0,720,489
22400558,3,77,-2.0,-1.5584415584415585,482,405
22400558,3,39,0.0,0.0,380,341
22400558,3,83,3.0,2.1686746987951806,336,253
22400558,3,52,2.0,2.307692307692308,239,187
22400558,4,138,-5.0,-2.1739130434782608,720,582
22400558,4,56,-3.0,-3.214285714285714,562,506
22400558,4,67,3.0,2.6865671641791042,487,420
22400558,4,263,5.0,1.1406844106463878,414,151
22400558,4,131,-6.0,-2.7480916030534353,131,0
22400559,1,236,-6.0,-1.5254237288135595,720,484
22400559,1,26,2.0,4.615384615384616,472,446
22400559,1,46,-5.0,-6.521739130434782,440,394
22400559,1,111,-3.0,-1.6216216216216217,375,264
22400559,1,31,-1.0,-1.935483870967742,259,228
22400559,1,50,-2.0,-2.4,228,178
22400559,1,72,-4.0,-3.333333333333333,172,100
22400559,1,67,3.0,2.6865671641791042,92,25
22400559,1,25,-2.0,-4.8,25,0
22400559,2,112,-4.0,-2.142857142857143,720,608
22400559,2,9,0.0,0.0,608,599
22400559,2,140,0.0,0.0,599,459
22400559,2,57,1.0,1.0526315789473684,459,402
22400559,2,6,-1.0,-10.0,402,396
22400559,2,156,-3.0,-1.153846153846154,385,229
22400559,2,86,-6.0,-4.186046511627907,217,131
22400559,2,122,-1.0,-0.49180327868852464,122,0
22400559,3,317,0.0,0.0,720,403
22400559,3,137,1.0,0.437956204379562,388,251
22400559,3,24,-3.0,-7.5,251,227
22400559,3,91,-2.0,-1.3186813186813189,227,136
22400559,3,118,3.0,1.5254237288135595,118,0
22400559,4,281,3.0,0.6405693950177936,720,439
22400559,4,172,2.0,0.6976744186046512,424,252
22400559,4,22,-1.0,-2.7272727272727275,230,208
22400559,4,3,0.0,0.0,208,205
22400559,4,195,2.0,0.6153846153846154,195,0
22400560,1,248,-5.0,-1.2096774193548387,720,472
22400560,1,52,0.0,0.0,456,404
22400560,1,105,-4.0,-2.285714285714286,392,287
22400560,1,67,4.0,3.582089552238806,280,213
22400560,1,59,1.0,1.0169491525423728,207,148
22400560,1,148,-9.0,-3.6486486486486487,148,0
22400560,2,64,-6.0,-5.625,720,656
22400560,2,38,2.0,3.1578947368421053,636,598
22400560,2,7,0.0,0.0,515,508
22400560,2,34,0.0,0.0,494,460
22400560,2,143,2.0,0.8391608391608392,443,300
22400560,2,38,-5.0,-7.894736842105263,285,247
22400560,2,85,4.0,2.8235294117647056,235,150
22400560,2,59,1.0,1.0169491525423728,150,91
22400560,2,70,-2.0,-1.7142857142857142,77,7
22400560,3,229,-4.0,-1.0480349344978166,720,491
22400560,3,45,1.0,1.3333333333333335,476,431
22400560,3,121,-3.0,-1.487603305785124,418,297
22400560,3,42,0.0,0.0,297,255
22400560,3,247,0.0,0.0,247,0
22400560,4,272,-1.0,-0.22058823529411764,720,448
22400560,4,209,-4.0,-1.1483253588516746,433,224
22400560,4,142,2.0,0.8450704225352113,216,74
22400560,4,3,-5.0,-100.0,57,54
22400561,1,303,-6.0,-1.188118811881188,720,417
22400561,1,76,3.0,2.3684210526315788,417,341
22400561,1,57,-1.0,-1.0526315789473684,328,271
22400561,1,175,-2.0,-0.6857142857142857,254,79
22400561,1,64,2.0,1.875,64,0
22400561,2,209,-2.0,-0.5741626794258373,720,511
22400561,2,115,-1.0,-0.5217391304347826,502,387
22400561,2,18,2.0,6.666666666666666,369,351
22400561,2,5,-1.0,-12.0,351,346
22400561,2,132,1.0,0.4545454545454546,346,214
22400561,2,94,2.0,1.2765957446808511,196,102
22400561,2,4,0.0,0.0,96,92
22400561,2,70,-1.0,-0.8571428571428571,81,11
22400561,3,451,4.0,0.532150776053215,720,269
22400561,3,153,4.0,1.5686274509803921,256,103
22400561,3,26,0.0,0.0,87,61
22400561,3,60,0.0,0.0,60,0
22400561,4,240,-2.0,-0.5,720,480
22400561,4,160,-2.0,-0.75,463,303
22400561,4,276,4.0,0.8695652173913043,289,13
22400561,4,4,0.0,0.0,11,7
22400561,5,300,-4.0,-0.8,300,0
22400562,1,192,5.0,1.5625,720,528
22400562,1,9,2.0,13.333333333333332,522,513
22400562,1,149,-7.0,-2.8187919463087248,501,352
22400562,1,59,-1.0,-1.0169491525423728,342,283
22400562,1,167,0.0,0.0,283,116
22400562,1,84,-5.0,-3.571428571428571,105,21
22400562,1,18,0.0,0.0,18,0
22400562,2,195,2.0,0.6153846153846154,720,525
22400562,2,34,0.0,0.0,508,474
22400562,2,137,-1.0,-0.437956204379562,472,335
22400562,2,68,-3.0,-2.647058823529412,322,254
22400562,2,71,2.0,1.6901408450704225,238,167
22400562,2,114,-2.0,-1.0526315789473684,157,43
22400562,2,34,-1.0,-1.7647058823529411,35,1
22400562,2,1,0.0,0.0,1,0
22400562,3,292,2.0,0.410958904109589,720,428
22400562,3,90,4.0,2.666666666666667,411,321
22400562,3,99,-3.0,-1.8181818181818183,321,222
22400562,3,39,0.0,0.0,211,172
22400562,3,164,1.0,0.36585365853658536,164,0
22400562,4,107,4.0,2.2429906542056073,720,613
22400562,4,79,2.0,1.5189873417721518,593,514
22400562,4,35,0.0,0.0,514,479
22400562,4,119,-1.0,-0.5042016806722689,476,357
22400562,4,251,0.0,0.0,333,82
22400562,4,74,-1.0,-0.8108108108108109,74,0
22400563,1,261,-3.0,-0.6896551724137931,720,459
22400563,1,89,1.0,0.6741573033707865,440,351
22400563,1,55,0.0,0.0,334,279
22400563,1,28,2.0,4.285714285714286,275,247
22400563,1,76,-1.0,-0.7894736842105263,238,162
22400563,1,148,1.0,0.40540540540540543,148,0
22400563,2,39,1.0,1.5384615384615383,720,681
22400563,2,14,0.0,0.0,681,667
22400563,2,20,-1.0,-3.0,652,632
22400563,2,58,-2.0,-2.0689655172413794,632,574
22400563,2,38,-4.0,-6.315789473684211,559,521
22400563,2,114,-3.0,-1.5789473684210527,521,407
22400563,2,21,2.0,5.7142857142857135,399,378
22400563,2,10,0.0,0.0,358,348
22400563,2,105,0.0,0.0,342,237
22400563,2,36,2.0,3.333333333333333,237,201
22400563,2,81,-9.0,-6.666666666666666,193,112
22400563,2,103,1.0,0.5825242718446602,103,0
22400563,3,252,1.0,0.23809523809523808,720,468
22400563,3,18,2.0,6.666666666666666,456,438
22400563,3,39,-1.0,-1.5384615384615383,415,376
22400563,3,50,2.0,2.4,376,326
22400563,3,38,1.0,1.5789473684210527,320,282
22400563,3,21,0.0,0.0,282,261
22400563,3,108,-2.0,-1.1111111111111112,261,153
22400563,3,59,0.0,0.0,138,79
22400563,3,48,1.0,1.25,79,31
22400563,4,124,-6.0,-2.903225806451613,720,596
22400563,4,62,2.0,1.935483870967742,579,517
22400563,4,13,0.0,0.0,503,490
22400563,4,55,0.0,0.0,420,365
22400563,4,81,0.0,0.0,356,275
22400563,4,174,-3.0,-1.0344827586206897,260,86
22400563,4,69,-2.0,-1.7391304347826086,69,0
22400564,1,277,0.0,0.0,720,443
22400564,1,60,5.0,5.0,443,383
22400564,1,23,2.0,5.217391304347826,375,352
22400564,1,25,0.0,0.0,352,327
22400564,1,27,0.0,0.0,320,293
22400564,1,32,2.0,3.75,280,248
22400564,1,51,5.0,5.88235294117647,219,168
22400564,1,168,0.0,0.0,168,0
22400564,2,167,3.0,1.0778443113772456,720,553
22400564,2,35,4.0,6.857142857142857,553,518
22400564,2,146,-8.0,-3.287671232876712,518,372
22400564,2,92,0.0,0.0,362,270
22400564,2,29,-2.0,-4.137931034482759,258,229
22400564,2,110,2.0,1.0909090909090908,229,119
22400564,2,43,0.0,0.0,112,69
22400564,2,56,0.0,0.0,62,6
22400564,2,1,0.0,0.0,1,0
22400564,3,201,2.0,0.5970149253731343,720,519
22400564,3,75,3.0,2.4,515,440
22400564,3,166,2.0,0.7228915662650602,423,257
22400564,3,56,1.0,1.0714285714285714,257,201
22400564,3,148,-2.0,-0.8108108108108109,188,40
22400564,3,19,0.0,0.0,40,21
22400564,3,21,-1.0,-2.8571428571428568,21,0
22400564,4,261,5.0,1.1494252873563218,720,459
22400564,4,24,0.0,0.0,435,411
22400564,4,59,-2.0,-2.0338983050847457,398,339
22400564,4,9,-2.0,-13.333333333333332,339,330
22400564,4,33,-3.0,-5.454545454545455,330,297
22400564,4,42,2.0,2.8571428571428568,287,245
22400564,4,111,3.0,1.6216216216216217,245,134
22400564,4,134,-1.0,-0.44776119402985076,134,0
22400565,1,290,-9.0,-1.8620689655172413,720,430
22400565,1,19,0.0,0.0,430,411
22400565,1,26,0.0,0.0,400,374
22400565,1,46,-3.0,-3.9130434782608696,365,319
22400565,1,39,-2.0,-3.0769230769230766,319,280
22400565,1,117,-4.0,-2.0512820512820515,272,155
22400565,1,148,-3.0,-1.2162162162162162,148,0
22400565,2,112,7.0,3.75,720,608
22400565,2,78,0.0,0.0,599,521
22400565,2,3,0.0,0.0,510,507
22400565,2,42,0.0,0.0,497,455
22400565,2,57,1.0,1.0526315789473684,443,386
22400565,2,59,4.0,4.067796610169491,373,314
22400565,2,38,0.0,0.0,314,276
22400565,2,58,4.0,4.137931034482759,263,205
22400565,2,133,-3.0,-1.3533834586466165,183,50
22400565,2,45,3.0,4.0,45,0
22400565,3,183,0.0,0.0,720,537
22400565,3,108,4.0,2.2222222222222223,537,429
22400565,3,50,1.0,1.2,429,379
22400565,3,68,-4.0,-3.5294117647058822,379,311
22400565,3,93,1.0,0.6451612903225807,295,202
22400565,3,19,0.0,0.0,202,183
22400565,3,22,0.0,0.0,183,161
22400565,3,103,-2.0,-1.1650485436893203,161,58
22400565,3,51,2.0,2.3529411764705883,58,7
22400565,4,167,3.0,1.0778443113772456,720,553
22400565,4,99,1.0,0.6060606060606061,548,449
22400565,4,141,-1.0,-0.425531914893617,431,290
22400565,4,2,0.0,0.0,278,276
22400565,4,15,2.0,8.0,265,250
22400565,4,30,-1.0,-2.0,250,220
22400565,4,151,2.0,0.7947019867549668,198,47
22400565,4,4,-1.0,-15.0,36,32
22400565,4,5,0.0,0.0,21,16
22400565,4,11,0.0,0.0,12,1
22400566,1,300,8.0,1.6,720,420
22400566,1,16,0.0,0.0,408,392
22400566,1,44,4.0,5.454545454545455,378,334
22400566,1,51,-3.0,-3.5294117647058822,329,278
22400566,1,13,-1.0,-4.615384615384616,278,265
22400566,1,56,1.0,1.0714285714285714,265,209
22400566,1,81,0.0,0.0,200,119
22400566,1,119,1.0,0.5042016806722689,119,0
22400566,2,192,0.0,0.0,720,528
22400566,2,3,2.0,40.0,525,522
22400566,2,104,-2.0,-1.153846153846154,507,403
22400566,2,9,1.0,6.666666666666666,403,394
22400566,2,22,-3.0,-8.181818181818182,394,372
22400566,2,213,-1.0,-0.28169014084507044,362,149
22400566,2,101,-2.0,-1.188118811881188,149,48
22400566,2,17,1.0,3.5294117647058822,48,31
22400566,2,31,-1.0,-1.935483870967742,31,0
22400566,3,230,8.0,2.0869565217391304,720,490
22400566,3,93,2.0,1.2903225806451615,476,383
22400566,3,134,-5.0,-2.2388059701492535,375,241
22400566,3,58,0.0,0.0,218,160
22400566,3,79,-1.0,-0.7594936708860759,150,71
22400566,3,64,-3.0,-2.8125,64,0
22400566,4,131,2.0,0.916030534351145,720,589
22400566,4,43,1.0,1.3953488372093024,570,527
22400566,4,54,-4.0,-4.444444444444445,527,473
22400566,4,16,0.0,0.0,464,448
22400566,4,51,0.0,0.0,439,388
22400566,4,45,3.0,4.0,375,330
22400566,4,252,7.0,1.6666666666666665,473,221
22400566,4,162,3.0,1.1111111111111112,195,33
22400566,4,6,1.0,10.0,7,1
22400566,4,1,0.0,0.0,1,0
22400567,1,261,1.0,0.22988505747126436,720,459
22400567,1,25,-2.0,-4.8,459,434
22400567,1,62,0.0,0.0,425,363
22400567,1,98,0.0,0.0,349,251
22400567,1,95,-1.0,-0.631578947368421,251,156
22400567,1,114,5.0,2.631578947368421,147,33
22400567,1,25,-3.0,-7.199999999999999,33,8
22400567,2,244,2.0,0.49180327868852464,720,476
22400567,2,39,2.0,3.0769230769230766,465,426
22400567,2,35,0.0,0.0,413,378
22400567,2,47,-2.0,-2.5531914893617023,378,331
22400567,2,148,1.0,0.40540540540540543,331,183
22400567,2,73,2.0,1.643835616438356,144,71
22400567,2,71,8.0,6.76056338028169,71,0
22400567,3,169,-7.0,-2.4852071005917162,720,551
22400567,3,133,1.0,0.45112781954887216,551,418
22400567,3,4,0.0,0.0,403,399
22400567,3,160,-1.0,-0.375,388,228
22400567,3,36,-6.0,-10.0,228,192
22400567,3,115,-1.0,-0.5217391304347826,165,50
22400567,3,38,-2.0,-3.1578947368421053,38,0
22400567,4,207,0.0,0.0,720,513
22400567,4,49,4.0,4.897959183673469,496,447
22400567,4,143,2.0,0.8391608391608392,433,290
22400567,4,245,-12.0,-2.9387755102040813,274,29
22400567,4,29,2.0,4.137931034482759,29,0
22400568,1,370,-2.0,-0.32432432432432434,720,350
22400568,1,21,-1.0,-2.8571428571428568,339,318
22400568,2,164,-6.0,-2.195121951219512,720,556
22400568,2,72,0.0,0.0,536,464
22400568,2,15,-2.0,-8.0,464,449
22400568,2,101,-3.0,-1.782178217821782,437,336
22400568,2,189,-3.0,-0.9523809523809523,324,135
22400568,2,99,-5.0,-3.0303030303030303,135,36
22400568,2,36,2.0,3.333333333333333,36,0
22400568,3,417,-1.0,-0.14388489208633093,720,303
22400568,3,38,-3.0,-4.7368421052631575,292,254
22400568,3,36,3.0,5.0,254,218
22400568,3,19,0.0,0.0,208,189
22400568,3,74,-2.0,-1.6216216216216217,149,75
22400568,3,61,-1.0,-0.9836065573770493,61,0
22400568,4,270,-1.0,-0.22222222222222224,720,450
22400568,4,97,0.0,0.0,447,350
22400568,4,24,-4.0,-10.0,337,313
22400568,4,145,2.0,0.8275862068965517,145,0
22400569,1,309,-8.0,-1.5533980582524272,720,411
22400569,1,52,0.0,0.0,407,355
22400569,1,149,10.0,4.026845637583893,343,194
22400569,1,22,3.0,8.181818181818182,194,172
22400569,1,172,5.0,1.744186046511628,172,0
22400569,2,101,2.0,1.188118811881188,720,619
22400569,2,104,-8.0,-4.615384615384616,609,505
22400569,2,186,3.0,0.967741935483871,505,319
22400569,2,58,0.0,0.0,319,261
22400569,2,27,-1.0,-2.2222222222222223,244,217
22400569,2,56,0.0,0.0,217,161
22400569,2,12,0.0,0.0,167,155
22400569,2,145,3.0,1.2413793103448276,155,10
22400569,3,296,4.0,0.8108108108108109,720,424
22400569,3,100,-4.0,-2.4,401,301
22400569,3,2,0.0,0.0,285,283
22400569,3,141,-1.0,-0.425531914893617,266,125
22400569,3,14,0.0,0.0,125,111
22400569,3,31,0.0,0.0,111,80
22400569,4,203,-5.0,-1.477832512315271,720,517
22400569,4,35,1.0,1.7142857142857142,517,482
22400569,4,6,-1.0,-10.0,473,467
22400569,4,83,-3.0,-2.1686746987951806,457,374
22400569,4,145,0.0,0.0,368,223
22400569,4,203,-4.0,-1.1822660098522169,215,12
22400569,4,6,0.0,0.0,6,0
22400570,1,333,0.0,0.0,720,387
22400570,1,135,-1.0,-0.4444444444444445,369,234
22400570,1,9,2.0,13.333333333333332,234,225
22400570,1,55,3.0,3.2727272727272725,196,141
22400570,1,43,-3.0,-4.186046511627907,135,92
22400570,1,91,-5.0,-3.2967032967032965,91,0
22400570,2,200,-2.0,-0.6,720,520
22400570,2,14,-2.0,-8.571428571428571,509,495
22400570,2,80,-2.0,-1.5,484,404
22400570,2,65,-2.0,-1.8461538461538463,404,339
22400570,2,99,0.0,0.0,335,236
22400570,2,25,-3.0,-7.199999999999999,236,211
22400570,2,166,0.0,0.0,197,31
22400570,2,31,2.0,3.870967741935484,31,0
22400570,3,321,11.0,2.05607476635514,720,399
22400570,3,27,0.0,0.0,380,353
22400570,3,90,-5.0,-3.333333333333333,339,249
22400570,3,53,0.0,0.0,245,192
22400570,3,104,2.0,1.153846153846154,184,80
22400570,3,61,2.0,1.9672131147540985,63,2
22400570,4,269,5.0,1.1152416356877324,720,451
22400570,4,24,1.0,2.5,439,415
22400570,4,86,-1.0,-0.6976744186046512,415,329
22400570,4,105,3.0,1.7142857142857142,319,214
22400570,4,57,2.0,2.1052631578947367,169,112
22400570,4,95,0.0,0.0,111,16
22400571,1,285,1.0,0.2105263157894737,720,435
22400571,1,22,2.0,5.454545454545455,424,402
22400571,1,104,-1.0,-0.576923076923077,453,349
22400571,1,87,5.0,3.4482758620689653,341,254
22400571,1,51,1.0,1.1764705882352942,232,181
22400571,1,22,0.0,0.0,152,130
22400571,1,230,-5.0,-1.3043478260869565,230,0
22400571,2,248,9.0,2.17741935483871,720,472
22400571,2,65,2.0,1.8461538461538463,472,407
22400571,2,48,0.0,0.0,396,348
22400571,2,5,2.0,24.0,341,336
22400571,2,23,0.0,0.0,336,313
22400571,2,125,4.0,1.92,313,188
22400571,2,165,4.0,1.4545454545454546,165,0
22400571,3,194,17.0,5.257731958762887,720,526
22400571,3,76,3.0,2.3684210526315788,526,450
22400571,3,42,2.0,2.8571428571428568,450,408
22400571,3,75,6.0,4.8,410,335
22400571,3,137,-1.0,-0.437956204379562,310,173
22400571,3,32,-1.0,-1.875,173,141
22400571,3,129,2.0,0.9302325581395349,129,0
22400571,4,125,4.0,1.92,720,595
22400571,4,8,0.0,0.0,576,568
22400571,4,39,3.0,4.615384615384616,556,517
22400571,4,220,3.0,0.8181818181818181,509,289
22400571,4,274,0.0,0.0,275,1
22400572,1,335,1.0,0.1791044776119403,720,385
22400572,1,33,-3.0,-5.454545454545455,368,335
22400572,1,28,2.0,4.285714285714286,329,301
22400572,1,46,-3.0,-3.9130434782608696,274,228
22400572,1,29,3.0,6.206896551724138,209,180
22400572,1,40,-2.0,-3.0,180,140
22400572,1,19,0.0,0.0,121,102
22400572,1,81,4.0,2.962962962962963,90,9
22400572,1,1,0.0,0.0,1,0
22400572,2,194,-1.0,-0.30927835051546393,720,526
22400572,2,26,-1.0,-2.307692307692308,523,497
22400572,2,66,-3.0,-2.7272727272727275,497,431
22400572,2,82,3.0,2.195121951219512,424,342
22400572,2,62,0.0,0.0,337,275
22400572,2,23,3.0,7.826086956521739,275,252
22400572,2,80,0.0,0.0,252,172
22400572,2,172,-6.0,-2.0930232558139537,172,0
22400572,3,241,-2.0,-0.4979253112033195,720,479
22400572,3,62,0.0,0.0,456,394
22400572,3,135,5.0,2.2222222222222223,394,259
22400572,3,12,2.0,10.0,253,241
22400572,3,69,-1.0,-0.8695652173913043,241,172
22400572,3,66,0.0,0.0,161,95
22400572,3,25,0.0,0.0,89,64
22400572,3,64,0.0,0.0,64,0
22400572,4,142,5.0,2.1126760563380285,720,578
22400572,4,88,-4.0,-2.7272727272727275,555,467
22400572,4,77,2.0,1.5584415584415585,449,372
22400572,4,23,-2.0,-5.217391304347826,361,338
22400572,4,36,-2.0,-3.333333333333333,338,302
22400572,4,72,-2.0,-1.6666666666666665,302,230
22400572,4,212,1.0,0.2830188679245283,212,0
22400573,1,267,-13.0,-2.9213483146067416,720,453
22400573,1,106,5.0,2.8301886792452833,444,338
22400573,1,37,-3.0,-4.864864864864865,324,287
22400573,1,24,0.0,0.0,285,261
22400573,1,93,3.0,1.935483870967742,261,168
22400573,1,90,1.0,0.6666666666666667,157,67
22400573,1,67,-1.0,-0.8955223880597015,67,0
22400573,2,214,2.0,0.5607476635514018,720,506
22400573,2,30,-2.0,-4.0,493,463
22400573,2,69,-2.0,-1.7391304347826086,463,394
22400573,2,58,-1.0,-1.0344827586206897,380,322
22400573,2,109,-5.0,-2.7522935779816518,315,206
22400573,2,118,7.0,3.5593220338983054,194,76
22400573,2,62,-3.0,-2.903225806451613,62,0
22400573,3,36,-2.0,-3.333333333333333,720,684
22400573,3,131,-1.0,-0.4580152671755725,673,542
22400573,3,172,-2.0,-0.6976744186046512,542,370
22400573,3,35,2.0,3.4285714285714284,369,334
22400573,3,43,-2.0,-2.7906976744186047,334,291
22400573,3,41,-1.0,-1.4634146341463414,291,250
22400573,3,115,-2.0,-1.0434782608695652,250,135
22400573,3,59,0.0,0.0,135,76
22400573,3,71,1.0,0.8450704225352113,76,5
22400573,3,5,0.0,0.0,5,0
22400573,4,133,3.0,1.3533834586466165,720,587
22400573,4,62,2.0,1.935483870967742,587,525
22400573,4,136,0.0,0.0,509,373
22400573,4,159,5.0,1.8867924528301887,357,198
22400573,4,70,4.0,3.4285714285714284,178,108
22400573,4,63,0.0,0.0,108,45
22400573,4,11,-1.0,-5.454545454545455,42,31
22400573,4,5,1.0,12.0,30,25
22400573,4,1,-1.0,-60.0,25,24
22400573,4,8,2.0,15.0,24,16
22400574,1,285,0.0,0.0,720,435
22400574,1,26,0.0,0.0,420,394
22400574,1,49,-3.0,-3.673469387755102,386,337
22400574,1,66,5.0,4.545454545454546,327,261
22400574,1,120,5.0,2.5,245,125
22400574,1,111,11.0,5.945945945945946,111,0
22400574,2,90,6.0,4.0,720,630
22400574,2,101,-3.0,-1.782178217821782,630,529
22400574,2,54,0.0,0.0,528,474
22400574,2,148,4.0,1.6216216216216217,462,314
22400574,2,79,-4.0,-3.0379746835443036,301,222
22400574,2,144,3.0,1.25,222,78
22400574,2,48,3.0,3.75,78,30
22400574,3,282,8.0,1.702127659574468,720,438
22400574,3,26,3.0,6.923076923076923,438,412
22400574,3,44,0.0,0.0,400,356
22400574,3,86,-2.0,-1.3953488372093024,356,270
22400574,3,52,2.0,2.307692307692308,257,205
22400574,3,205,1.0,0.2926829268292683,205,0
22400574,4,166,-9.0,-3.253012048192771,720,554
22400574,4,123,3.0,1.4634146341463414,546,423
22400574,4,419,-12.0,-1.7183770883054894,419,0
22400575,1,301,-2.0,-0.39867109634551495,720,419
22400575,1,125,3.0,1.44,419,294
22400575,1,64,0.0,0.0,294,230
22400575,1,43,-1.0,-1.3953488372093024,209,166
22400575,1,65,-2.0,-1.8461538461538463,148,83
22400575,1,34,0.0,0.0,83,49
22400575,2,141,-6.0,-2.5531914893617023,720,579
22400575,2,109,2.0,1.1009174311926606,573,464
22400575,2,102,-4.0,-2.3529411764705883,445,343
22400575,2,204,1.0,0.29411764705882354,343,139
22400575,2,139,2.0,0.8633093525179857,139,0
22400575,3,196,-11.0,-3.36734693877551,720,524
22400575,3,65,-6.0,-5.538461538461538,511,446
22400575,3,122,2.0,0.9836065573770493,438,316
22400575,3,16,1.0,3.75,294,278
22400575,3,60,1.0,1.0,278,218
22400575,3,84,1.0,0.7142857142857142,218,134
22400575,3,134,8.0,3.582089552238806,134,0
22400575,4,168,-6.0,-2.142857142857143,720,552
22400575,4,62,-3.0,-2.903225806451613,552,490
22400575,4,80,-2.0,-1.5,474,394
22400575,4,117,-2.0,-1.0256410256410258,376,259
22400575,4,55,-2.0,-2.1818181818181817,238,183
22400575,4,160,2.0,0.75,160,0
22400576,1,407,-3.0,-0.44226044226044225,720,313
22400576,1,110,2.0,1.0909090909090908,300,190
22400576,1,27,3.0,6.666666666666666,176,149
22400576,2,146,-3.0,-1.2328767123287672,720,574
22400576,2,99,1.0,0.6060606060606061,554,455
22400576,2,139,5.0,2.158273381294964,455,316
22400576,2,19,0.0,0.0,316,297
22400576,2,144,2.0,0.8333333333333333,288,144
22400576,3,289,2.0,0.4152249134948097,720,431
22400576,3,16,0.0,0.0,431,415
22400576,3,121,1.0,0.49586776859504134,415,294
22400576,3,35,-1.0,-1.7142857142857142,294,259
22400576,3,34,-4.0,-7.0588235294117645,259,225
22400576,3,28,0.0,0.0,225,197
22400576,3,8,0.0,0.0,182,174
22400576,3,66,-2.0,-1.8181818181818183,174,108
22400576,3,85,0.0,0.0,85,0
22400576,4,57,-6.0,-6.315789473684211,720,663
22400576,4,190,-3.0,-0.9473684210526316,650,460
22400576,4,42,4.0,5.7142857142857135,451,409
22400576,4,326,3.0,0.5521472392638037,405,79
22400576,4,71,-3.0,-2.535211267605634,79,8
22400576,4,4,2.0,30.0,4,0
22400577,1,405,4.0,0.5925925925925926,720,315
22400577,1,96,-1.0,-0.625,307,211
22400577,1,23,-2.0,-5.217391304347826,196,173
22400577,1,103,3.0,1.7475728155339807,137,34
22400577,1,34,-3.0,-5.294117647058824,34,0
22400577,2,157,0.0,0.0,720,563
22400577,2,61,2.0,1.9672131147540985,546,485
22400577,2,71,-2.0,-1.6901408450704225,485,414
22400577,2,88,2.0,1.3636363636363638,414,326
22400577,2,43,0.0,0.0,319,276
22400577,2,180,2.0,0.6666666666666667,276,96
22400577,2,19,0.0,0.0,96,77
22400577,2,77,3.0,2.3376623376623376,77,0
22400577,3,324,6.0,1.1111111111111112,720,396
22400577,3,38,-1.0,-1.5789473684210527,429,391
22400577,3,20,0.0,0.0,381,361
22400577,3,36,-2.0,-3.333333333333333,361,325
22400577,3,48,1.0,1.25,325,277
22400577,3,129,1.0,0.46511627906976744,277,148
22400577,3,148,0.0,0.0,148,0
22400577,4,65,-2.0,-1.8461538461538463,720,655
22400577,4,201,3.0,0.8955223880597015,650,449
22400577,4,191,5.0,1.5706806282722514,432,241
22400577,4,94,-2.0,-1.2765957446808511,226,132
22400577,4,132,4.0,1.8181818181818183,132,0
22400578,1,364,-1.0,-0.16483516483516486,720,356
22400578,1,52,-3.0,-3.4615384615384617,330,278
22400578,1,55,0.0,0.0,263,208
22400578,1,100,-5.0,-3.0,176,76
22400578,2,162,2.0,0.7407407407407407,720,558
22400578,2,98,7.0,4.285714285714286,547,449
22400578,2,65,-5.0,-4.615384615384616,442,377
22400578,3,215,-4.0,-1.1162790697674418,720,505
22400578,3,144,3.0,1.25,486,342
22400578,3,78,-1.0,-0.7692307692307692,342,264
22400578,3,90,-2.0,-1.3333333333333335,242,152
22400578,3,25,2.0,4.8,143,118
22400578,3,38,0.0,0.0,100,62
22400578,3,57,-1.0,-1.0526315789473684,57,0
22400578,4,136,-4.0,-1.7647058823529411,720,584
22400578,4,6,0.0,0.0,584,578
22400578,4,71,0.0,0.0,578,507
22400578,4,93,-2.0,-1.2903225806451615,507,414
22400578,4,82,-5.0,-3.6585365853658534,396,314
22400578,4,235,-3.0,-0.7659574468085106,306,71
22400578,4,71,-2.0,-1.6901408450704225,71,0
22400579,1,331,-11.0,-1.9939577039274925,720,389
22400579,1,87,1.0,0.6896551724137931,376,289
22400579,1,5,1.0,12.0,278,273
22400579,1,197,-5.0,-1.5228426395939085,273,76
22400579,1,62,5.0,4.838709677419355,62,0
22400579,2,191,-1.0,-0.31413612565445026,720,529
22400579,2,130,-4.0,-1.8461538461538463,529,399
22400579,2,117,4.0,2.0512820512820515,399,282
22400579,2,42,-2.0,-2.8571428571428568,265,223
22400579,2,204,-4.0,-1.1764705882352942,206,2
22400579,2,1,0.0,0.0,1,0
22400579,3,377,3.0,0.47745358090185674,720,343
22400579,3,44,-2.0,-2.7272727272727275,329,285
22400579,3,29,-5.0,-10.344827586206897,279,250
22400579,3,50,1.0,1.2,237,187
22400579,3,13,0.0,0.0,187,174
22400579,3,156,4.0,1.5384615384615383,173,17
22400579,3,4,0.0,0.0,4,0
22400579,4,325,-7.0,-1.2923076923076922,720,395
22400579,4,54,-3.0,-3.333333333333333,395,341
22400579,4,195,1.0,0.3076923076923077,341,146
22400579,4,139,1.0,0.43165467625899284,139,0
22400580,1,307,10.0,1.9543973941368078,720,413
22400580,1,72,1.0,0.8333333333333333,402,330
22400580,1,44,-1.0,-1.3636363636363638,319,275
22400580,1,49,2.0,2.4489795918367343,275,226
22400580,1,226,4.0,1.0619469026548671,226,0
22400580,2,274,2.0,0.437956204379562,720,446
22400580,2,79,1.0,0.7594936708860759,446,367
22400580,2,23,-2.0,-5.217391304347826,367,344
22400580,2,50,0.0,0.0,322,272
22400580,2,55,2.0,2.1818181818181817,260,205
22400580,2,137,0.0,0.0,205,68
22400580,2,65,-2.0,-1.8461538461538463,68,3
22400580,3,139,4.0,1.7266187050359714,720,581
22400580,3,181,-2.0,-0.6629834254143646,566,385
22400580,3,66,-1.0,-0.9090909090909092,385,319
22400580,3,29,0.0,0.0,319,290
22400580,3,40,-2.0,-3.0,290,250
22400580,3,68,1.0,0.8823529411764706,239,171
22400580,3,70,5.0,4.285714285714286,171,101
22400580,3,75,0.0,0.0,101,26
22400580,3,26,-2.0,-4.615384615384616,26,0
22400580,4,179,-3.0,-1.005586592178771,720,541
22400580,4,118,3.0,1.5254237288135595,523,405
22400580,4,103,1.0,0.5825242718446602,387,284
22400580,4,48,0.0,0.0,284,236
22400580,4,57,-2.0,-2.1052631578947367,227,170
22400580,4,12,0.0,0.0,155,143
22400580,4,30,0.0,0.0,141,111
22400580,4,46,2.0,2.608695652173913,111,65
22400581,1,237,8.0,2.0253164556962022,720,483
22400581,1,20,3.0,9.0,483,463
22400581,1,64,7.0,6.5625,452,388
22400581,1,19,0.0,0.0,388,369
22400581,1,139,4.0,1.7266187050359714,361,222
22400581,1,53,3.0,3.3962264150943398,216,163
22400581,1,47,-3.0,-3.829787234042553,163,116
22400581,1,113,3.0,1.592920353982301,115,2
22400581,1,2,0.0,0.0,2,0
22400581,2,43,3.0,4.186046511627907,720,677
22400581,2,118,3.0,1.5254237288135595,677,559
22400581,2,98,-7.0,-4.285714285714286,541,443
22400581,2,66,-2.0,-1.8181818181818183,430,364
22400581,2,4,0.0,0.0,364,360
22400581,2,8,1.0,7.5,354,346
22400581,2,68,-6.0,-5.294117647058824,346,278
22400581,2,80,-1.0,-0.75,274,194
22400581,2,18,0.0,0.0,194,176
22400581,2,96,2.0,1.25,157,61
22400581,3,239,3.0,0.7531380753138075,720,481
22400581,3,79,2.0,1.5189873417721518,481,402
22400581,3,67,3.0,2.6865671641791042,393,326
22400581,3,15,0.0,0.0,268,253
22400581,3,34,-5.0,-8.823529411764707,253,219
22400581,3,74,1.0,0.8108108108108109,206,132
22400581,3,114,4.0,2.1052631578947367,132,18
22400581,4,242,3.0,0.743801652892562,720,478
22400581,4,105,-1.0,-0.5714285714285715,472,367
22400581,4,264,-1.0,-0.2272727272727273,358,94
22400582,1,245,4.0,0.979591836734694,720,475
22400582,1,62,0.0,0.0,463,401
22400582,1,14,0.0,0.0,387,373
22400582,1,49,-2.0,-2.4489795918367343,360,311
22400582,1,172,-5.0,-1.744186046511628,311,139
22400582,1,20,1.0,3.0,118,98
22400582,1,98,3.0,1.836734693877551,98,0
22400582,2,122,5.0,2.4590163934426226,720,598
22400582,2,48,0.0,0.0,575,527
22400582,2,105,2.0,1.142857142857143,527,422
22400582,2,13,1.0,4.615384615384616,409,396
22400582,2,40,-3.0,-4.5,396,356
22400582,2,89,-6.0,-4.044943820224719,356,267
22400582,2,66,5.0,4.545454545454546,256,190
22400582,2,39,-1.0,-1.5384615384615383,172,133
22400582,2,117,0.0,0.0,117,0
22400582,3,229,-3.0,-0.7860262008733624,720,491
22400582,3,93,-5.0,-3.2258064516129035,491,398
22400582,3,53,0.0,0.0,380,327
22400582,3,88,1.0,0.6818181818181819,321,233
22400582,3,52,-2.0,-2.307692307692308,214,162
22400582,3,136,-10.0,-4.411764705882353,152,16
22400582,4,91,1.0,0.6593406593406594,720,629
22400582,4,99,-8.0,-4.848484848484849,620,521
22400582,4,49,2.0,2.4489795918367343,504,455
22400582,4,22,0.0,0.0,446,424
22400582,4,59,-1.0,-1.0169491525423728,279,220
22400582,4,79,-7.0,-5.3164556962025316,206,127
22400582,4,112,0.0,0.0,112,0
22400583,1,221,7.0,1.9004524886877827,720,499
22400583,1,55,-4.0,-4.363636363636363,495,440
22400583,1,45,-1.0,-1.3333333333333335,440,395
22400583,1,24,-3.0,-7.5,395,371
22400583,1,105,-2.0,-1.142857142857143,364,259
22400583,1,81,2.0,1.4814814814814814,246,165
22400583,1,9,0.0,0.0,151,142
22400583,2,79,-3.0,-2.278481012658228,720,641
22400583,2,51,2.0,2.3529411764705883,625,574
22400583,2,33,3.0,5.454545454545455,574,541
22400583,2,30,0.0,0.0,523,493
22400583,2,34,2.0,3.5294117647058822,487,453
22400583,2,24,4.0,10.0,450,426
22400583,2,58,-1.0,-1.0344827586206897,421,363
22400583,2,65,0.0,0.0,363,298
22400583,2,34,2.0,3.5294117647058822,294,260
22400583,2,97,10.0,6.185567010309278,253,156
22400583,2,146,6.0,2.4657534246575343,147,1
22400583,2,1,0.0,0.0,1,0
22400583,3,93,-6.0,-3.870967741935484,720,627
22400583,3,117,-6.0,-3.0769230769230766,606,489
22400583,3,25,0.0,0.0,473,448
22400583,3,42,2.0,2.8571428571428568,438,396
22400583,3,55,-5.0,-5.454545454545455,378,323
22400583,3,11,0.0,0.0,308,297
22400583,3,148,-3.0,-1.2162162162162162,297,149
22400583,3,62,-5.0,-4.838709677419355,140,78
22400583,3,22,0.0,0.0,62,40
22400583,3,9,0.0,0.0,32,23
22400583,3,23,0.0,0.0,23,0
22400583,4,83,6.0,4.337349397590361,720,637
22400583,4,80,-5.0,-3.75,616,536
22400583,4,42,0.0,0.0,528,486
22400583,4,86,-1.0,-0.6976744186046512,468,382
22400583,4,106,-1.0,-0.5660377358490566,362,256
22400583,4,176,1.0,0.34090909090909094,256,80
22400583,4,24,2.0,5.0,67,43
22400583,4,43,2.0,2.7906976744186047,43,0
22400584,1,294,-1.0,-0.20408163265306123,720,426
22400584,1,6,5.0,50.0,415,409
22400584,1,119,-4.0,-2.0168067226890756,392,273
22400584,1,226,-5.0,-1.3274336283185841,263,37
22400584,1,37,-1.0,-1.6216216216216217,37,0
22400584,2,133,-4.0,-1.8045112781954886,720,587
22400584,2,109,7.0,3.853211009174312,587,478
22400584,2,127,-4.0,-1.889763779527559,464,337
22400584,2,51,6.0,7.0588235294117645,325,274
22400584,2,103,0.0,0.0,249,146
22400584,2,99,3.0,1.8181818181818183,134,35
22400584,2,35,-3.0,-5.142857142857143,35,0
22400584,3,197,-6.0,-1.8274111675126905,720,523
22400584,3,26,1.0,2.307692307692308,523,497
22400584,3,40,-1.0,-1.5,497,457
22400584,3,64,3.0,2.8125,444,380
22400584,3,23,0.0,0.0,363,340
22400584,3,162,7.0,2.5925925925925926,387,225
22400584,3,26,0.0,0.0,209,183
22400584,3,55,1.0,1.0909090909090908,183,128
22400584,3,122,2.0,0.9836065573770493,128,6
22400584,4,125,-8.0,-3.84,720,595
22400584,4,47,-2.0,-2.5531914893617023,583,536
22400584,4,63,-2.0,-1.9047619047619047,526,463
22400584,4,68,-4.0,-3.5294117647058822,454,386
22400584,4,16,-1.0,-3.75,386,370
22400584,4,98,3.0,1.836734693877551,355,257
22400584,4,41,3.0,4.390243902439024,236,195
22400584,4,179,2.0,0.670391061452514,195,16
22400584,4,4,-1.0,-15.0,16,12
22400584,4,5,0.0,0.0,5,0
22400585,1,318,-5.0,-0.9433962264150944,720,402
22400585,1,61,0.0,0.0,380,319
22400585,1,123,5.0,2.4390243902439024,298,175
22400585,1,41,-4.0,-5.853658536585366,161,120
22400585,1,110,6.0,3.2727272727272725,110,0
22400585,2,195,-3.0,-0.9230769230769231,720,525
22400585,2,21,1.0,2.8571428571428568,504,483
22400585,2,89,2.0,1.348314606741573,483,394
22400585,2,69,3.0,2.608695652173913,374,305
22400585,2,44,-1.0,-1.3636363636363638,278,234
22400585,2,217,0.0,0.0,234,17
22400585,2,2,0.0,0.0,2,0
22400585,3,133,-1.0,-0.45112781954887216,720,587
22400585,3,43,-4.0,-5.5813953488372094,579,536
22400585,3,169,-3.0,-1.0650887573964498,523,354
22400585,3,22,4.0,10.90909090909091,351,329
22400585,3,23,0.0,0.0,306,283
22400585,3,46,-3.0,-3.9130434782608696,271,225
22400585,3,76,0.0,0.0,225,149
22400585,3,28,0.0,0.0,149,121
22400585,3,101,0.0,0.0,115,14
22400585,3,2,0.0,0.0,2,0
22400585,4,82,-1.0,-0.7317073170731707,720,638
22400585,4,109,-3.0,-1.651376146788991,613,504
22400585,4,51,2.0,2.3529411764705883,498,447
22400585,4,72,1.0,0.8333333333333333,447,375
22400585,4,81,2.0,1.4814814814814814,367,286
22400585,4,74,3.0,2.4324324324324325,286,212
22400585,4,150,-4.0,-1.6,212,62
22400585,4,49,-3.0,-3.673469387755102,49,0
22400586,1,255,4.0,0.9411764705882353,720,465
22400586,1,50,1.0,1.2,465,415
22400586,1,57,-3.0,-3.1578947368421053,415,358
22400586,1,20,2.0,6.0,354,334
22400586,1,34,-3.0,-5.294117647058824,327,293
22400586,1,123,1.0,0.48780487804878053,283,160
22400586,1,68,1.0,0.8823529411764706,160,92
22400586,1,61,1.0,0.9836065573770493,92,31
22400586,2,95,3.0,1.8947368421052633,720,625
22400586,2,31,1.0,1.935483870967742,625,594
22400586,2,104,4.0,2.307692307692308,594,490
22400586,2,25,-2.0,-4.8,485,460
22400586,2,87,-2.0,-1.3793103448275863,460,373
22400586,2,48,-3.0,-3.75,363,315
22400586,2,25,0.0,0.0,315,290
22400586,2,98,-1.0,-0.6122448979591836,275,177
22400586,2,70,-1.0,-0.8571428571428571,171,101
22400586,2,101,4.0,2.376237623762376,101,0
22400586,3,235,3.0,0.7659574468085106,720,485
22400586,3,120,1.0,0.5,477,357
22400586,3,75,0.0,0.0,416,341
22400586,3,9,1.0,6.666666666666666,341,332
22400586,3,73,-3.0,-2.4657534246575343,322,249
22400586,3,68,1.0,0.8823529411764706,249,181
22400586,3,77,-4.0,-3.116883116883117,170,93
22400586,3,23,0.0,0.0,35,12
22400586,3,8,0.0,0.0,12,4
22400586,4,15,1.0,4.0,720,705
22400586,4,183,2.0,0.6557377049180327,705,522
22400586,4,52,2.0,2.307692307692308,522,470
22400586,4,98,-2.0,-1.2244897959183672,464,366
22400586,4,6,0.0,0.0,355,349
22400586,4,205,-5.0,-1.4634146341463414,349,144
22400586,4,32,1.0,1.875,133,101
22400586,4,79,-2.0,-1.5189873417721518,101,22
22400586,4,6,0.0,0.0,21,15
22400587,1,315,5.0,0.9523809523809523,720,405
22400587,1,69,0.0,0.0,398,329
22400587,1,83,2.0,1.4457831325301205,320,237
22400587,1,19,-1.0,-3.1578947368421053,226,207
22400587,1,197,3.0,0.9137055837563453,197,0
22400587,2,107,-4.0,-2.2429906542056073,720,613
22400587,2,65,2.0,1.8461538461538463,598,533
22400587,2,26,1.0,2.307692307692308,533,507
22400587,2,108,-4.0,-2.2222222222222223,507,399
22400587,2,27,-1.0,-2.2222222222222223,386,359
22400587,2,59,-2.0,-2.0338983050847457,359,300
22400587,2,88,-4.0,-2.7272727272727275,291,203
22400587,3,323,-2.0,-0.3715170278637771,720,397
22400587,3,97,5.0,3.092783505154639,397,300
22400587,3,59,2.0,2.0338983050847457,290,231
22400587,3,195,8.0,2.4615384615384617,224,29
22400587,3,29,-3.0,-6.206896551724138,29,0
22400587,4,120,5.0,2.5,720,600
22400587,4,112,-5.0,-2.678571428571429,586,474
22400587,4,17,0.0,0.0,438,421
22400587,4,202,3.0,0.891089108910891,421,219
22400587,4,156,-5.0,-1.923076923076923,208,52
22400587,4,19,0.0,0.0,52,33
22400587,4,1,0.0,0.0,29,28
22400587,4,9,1.0,6.666666666666666,20,11
22400587,4,2,1.0,30.0,9,7
22400587,4,4,-1.0,-15.0,7,3
22400587,4,1,0.0,0.0,1,0
22400587,5,74,1.0,0.8108108108108109,300,226
22400587,5,103,-3.0,-1.7475728155339807,135,32
22400587,5,8,0.0,0.0,27,19
22400587,5,3,-2.0,-40.0,12,9
22400587,5,2,-1.0,-30.0,6,4
22400587,5,4,0.0,0.0,4,0
22400588,1,286,0.0,0.0,720,434
22400588,1,23,0.0,0.0,426,403
22400588,1,55,0.0,0.0,382,327
22400588,1,33,0.0,0.0,327,294
22400588,1,56,5.0,5.357142857142858,287,231
22400588,1,103,-2.0,-1.1650485436893203,217,114
22400588,1,14,0.0,0.0,100,86
22400588,1,86,6.0,4.186046511627907,86,0
22400588,2,290,1.0,0.20689655172413793,720,430
22400588,2,94,0.0,0.0,416,322
22400588,2,91,2.0,1.3186813186813189,316,225
22400588,2,12,0.0,0.0,208,196
22400588,2,76,3.0,2.3684210526315788,186,110
22400588,2,2,-2.0,-60.0,102,100
22400588,2,82,-6.0,-4.390243902439024,82,0
22400588,3,239,0.0,0.0,720,481
22400588,3,109,3.0,1.651376146788991,467,358
22400588,3,30,1.0,2.0,358,328
22400588,3,64,0.0,0.0,328,264
22400588,3,48,-3.0,-3.75,246,198
22400588,3,2,0.0,0.0,187,185
22400588,3,168,4.0,1.4285714285714284,168,0
22400588,4,147,1.0,0.40816326530612246,720,573
22400588,4,45,3.0,4.0,573,528
22400588,4,75,-1.0,-0.8,518,443
22400588,4,100,-5.0,-3.0,436,336
22400588,4,76,0.0,0.0,321,245
22400588,4,32,0.0,0.0,225,193
22400588,4,121,6.0,2.975206611570248,191,70
22400588,4,65,2.0,1.8461538461538463,65,0
22400589,1,180,1.0,0.33333333333333337,720,540
22400589,1,124,1.0,0.4838709677419355,523,399
22400589,1,25,-1.0,-2.4,399,374
22400589,1,36,0.0,0.0,364,328
22400589,1,57,0.0,0.0,282,225
22400589,1,34,0.0,0.0,206,172
22400589,1,154,-2.0,-0.7792207792207793,160,6
22400589,1,1,0.0,0.0,1,0
22400589,2,188,3.0,0.9574468085106382,720,532
22400589,2,66,0.0,0.0,519,453
22400589,2,70,0.0,0.0,446,376
22400589,2,61,0.0,0.0,376,315
22400589,2,134,-9.0,-4.029850746268656,315,181
22400589,2,90,3.0,2.0,181,91
22400589,3,194,4.0,1.2371134020618557,720,526
22400589,3,160,0.0,0.0,508,348
22400589,3,104,-2.0,-1.153846153846154,337,233
22400589,3,54,1.0,1.1111111111111112,227,173
22400589,3,152,3.0,1.1842105263157894,173,21
22400589,3,2,0.0,0.0,2,0
22400589,4,225,0.0,0.0,720,495
22400589,4,109,1.0,0.5504587155963303,373,264
22400589,4,23,2.0,5.217391304347826,253,230
22400589,4,14,0.0,0.0,230,216
22400589,4,113,0.0,0.0,212,99
22400589,4,34,2.0,3.5294117647058822,99,65
22400589,4,26,-3.0,-6.923076923076923,47,21
22400589,4,1,0.0,0.0,19,18
22400589,4,3,1.0,20.0,16,13
22400589,4,7,0.0,0.0,7,0
22400590,1,229,6.0,1.5720524017467248,720,491
22400590,1,42,0.0,0.0,434,392
22400590,1,41,0.0,0.0,390,349
22400590,1,69,1.0,0.8695652173913043,339,270
22400590,1,34,1.0,1.7647058823529411,260,226
22400590,1,58,-5.0,-5.172413793103448,226,168
22400590,1,168,0.0,0.0,168,0
22400590,2,46,4.0,5.217391304347826,720,674
22400590,2,1,0.0,0.0,653,652
22400590,2,67,-2.0,-1.791044776119403,639,572
22400590,2,73,-5.0,-4.10958904109589,546,473
22400590,2,102,1.0,0.5882352941176471,458,356
22400590,2,30,-1.0,-2.0,356,326
22400590,2,114,5.0,2.631578947368421,318,204
22400590,2,107,0.0,0.0,192,85
22400590,2,85,-3.0,-2.1176470588235294,85,0
22400590,3,320,-2.0,-0.375,720,400
22400590,3,57,2.0,2.1052631578947367,400,343
22400590,3,53,2.0,2.2641509433962264,343,290
22400590,3,89,-6.0,-4.044943820224719,274,185
22400590,3,55,5.0,5.454545454545455,173,118
22400590,3,78,-5.0,-3.846153846153846,111,33
22400590,3,23,-3.0,-7.826086956521739,23,0
22400590,4,72,-8.0,-6.666666666666666,720,648
22400590,4,47,-2.0,-2.5531914893617023,632,585
22400590,4,84,5.0,3.571428571428571,574,490
22400590,4,119,-1.0,-0.5042016806722689,481,362
22400590,4,65,-3.0,-2.769230769230769,341,276
22400590,4,228,11.0,2.894736842105263,269,41
22400590,4,19,2.0,6.315789473684211,29,10
22400590,4,10,-1.0,-6.0,10,0
22400591,1,188,-10.0,-3.1914893617021276,720,532
22400591,1,105,-1.0,-0.5714285714285715,510,405
22400591,1,32,2.0,3.75,405,373
22400591,1,106,1.0,0.5660377358490566,364,258
22400591,1,89,0.0,0.0,249,160
22400591,1,140,0.0,0.0,145,5
22400591,1,5,-3.0,-36.0,5,0
22400591,2,180,-2.0,-0.6666666666666667,720,540
22400591,2,91,6.0,3.956043956043956,537,446
22400591,2,6,0.0,0.0,436,430
22400591,2,136,1.0,0.4411764705882353,419,283
22400591,2,22,-2.0,-5.454545454545455,245,223
22400591,2,62,0.0,0.0,212,150
22400591,3,254,-8.0,-1.889763779527559,720,466
22400591,3,127,-3.0,-1.4173228346456692,450,323
22400591,3,90,4.0,2.666666666666667,315,225
22400591,3,1,0.0,0.0,225,224
22400591,3,66,-4.0,-3.6363636363636367,208,142
22400591,3,25,0.0,0.0,142,117
22400591,3,113,-4.0,-2.1238938053097343,117,4
22400591,4,70,-1.0,-0.8571428571428571,720,650
22400591,4,105,-2.0,-1.142857142857143,647,542
22400591,4,118,-6.0,-3.050847457627119,522,404
22400591,4,49,2.0,2.4489795918367343,404,355
22400591,4,62,-2.0,-1.935483870967742,355,293
22400591,4,173,5.0,1.7341040462427746,293,120
22400591,4,107,-4.0,-2.2429906542056073,107,0
22400592,1,509,-6.0,-0.7072691552062869,720,211
22400592,1,88,-3.0,-2.0454545454545454,193,105
22400592,1,105,0.0,0.0,105,0
22400592,2,281,3.0,0.6405693950177936,720,439
22400592,2,34,0.0,0.0,415,381
22400592,2,151,6.0,2.384105960264901,376,225
22400592,2,210,6.0,1.7142857142857142,210,0
22400592,3,359,11.0,1.8384401114206128,720,361
22400592,3,46,3.0,3.9130434782608696,353,307
22400592,3,12,0.0,0.0,298,286
22400592,3,130,-1.0,-0.46153846153846156,285,155
22400592,3,84,-1.0,-0.7142857142857142,133,49
22400592,3,39,2.0,3.0769230769230766,39,0
22400592,4,311,-6.0,-1.157556270096463,720,409
22400592,4,13,-1.0,-4.615384615384616,409,396
22400592,4,78,4.0,3.0769230769230766,396,318
22400592,4,157,4.0,1.5286624203821657,298,141
22400592,4,132,0.0,0.0,132,0
22400593,1,419,0.0,0.0,720,301
22400593,1,141,5.0,2.127659574468085,288,147
22400593,2,119,4.0,2.0168067226890756,720,601
22400593,2,94,4.0,2.5531914893617023,584,490
22400593,2,123,-4.0,-1.9512195121951221,490,367
22400593,2,83,-2.0,-1.4457831325301205,367,284
22400593,2,72,0.0,0.0,284,212
22400593,2,5,0.0,0.0,208,203
22400593,2,111,-3.0,-1.6216216216216217,187,76
22400593,3,301,-2.0,-0.39867109634551495,720,419
22400593,3,96,-7.0,-4.375,400,304
22400593,3,75,-1.0,-0.8,291,216
22400593,3,19,-2.0,-6.315789473684211,216,197
22400593,3,28,0.0,0.0,185,157
22400593,3,26,1.0,2.307692307692308,157,131
22400593,3,131,-7.0,-3.2061068702290076,131,0
22400593,4,226,-5.0,-1.3274336283185841,720,494
22400593,4,195,0.0,0.0,476,281
22400593,4,114,4.0,2.1052631578947367,267,153
22400593,4,12,0.0,0.0,141,129
22400594,1,397,4.0,0.6045340050377833,720,323
22400594,1,55,0.0,0.0,323,268
22400594,1,78,1.0,0.7692307692307692,268,190
22400594,1,45,4.0,5.333333333333334,190,145
22400594,1,114,1.0,0.5263157894736842,122,8
22400594,1,2,0.0,0.0,2,0
22400594,2,200,-13.0,-3.9000000000000004,720,520
22400594,2,109,2.0,1.1009174311926606,505,396
22400594,2,10,1.0,6.0,382,372
22400594,2,148,3.0,1.2162162162162162,372,224
22400594,2,44,0.0,0.0,208,164
22400594,2,33,1.0,1.8181818181818183,164,131
22400594,2,131,7.0,3.2061068702290076,131,0
22400594,3,262,-2.0,-0.4580152671755725,720,458
22400594,3,132,0.0,0.0,458,326
22400594,3,112,-2.0,-1.0714285714285714,317,205
22400594,3,84,0.0,0.0,195,111
22400594,3,111,4.0,2.1621621621621623,111,0
22400594,4,209,2.0,0.5741626794258373,720,511
22400594,4,44,2.0,2.7272727272727275,501,457
22400594,4,27,0.0,0.0,449,422
22400594,4,96,2.0,1.25,408,312
22400594,4,91,1.0,0.6593406593406594,312,221
22400594,4,131,0.0,0.0,221,90
22400594,4,6,0.0,0.0,90,84
22400594,4,80,-1.0,-0.75,80,0
22400595,1,335,8.0,1.4328358208955223,720,385
22400595,1,44,3.0,4.090909090909091,377,333
22400595,1,21,3.0,8.571428571428571,321,300
22400595,1,13,0.0,0.0,276,263
22400595,1,41,3.0,4.390243902439024,248,207
22400595,1,200,0.0,0.0,200,0
22400595,2,100,-4.0,-2.4,720,620
22400595,2,136,2.0,0.8823529411764706,620,484
22400595,2,1,0.0,0.0,474,473
22400595,2,162,-6.0,-2.2222222222222223,455,293
22400595,2,60,2.0,2.0,278,218
22400595,2,100,1.0,0.6,218,118
22400595,2,7,1.0,8.571428571428571,110,103
22400595,2,30,-2.0,-4.0,103,73
22400595,2,72,0.0,0.0,73,1
22400595,2,1,0.0,0.0,1,0
22400595,3,281,-3.0,-0.6405693950177936,720,439
22400595,3,82,-1.0,-0.7317073170731707,439,357
22400595,3,37,3.0,4.864864864864865,334,297
22400595,3,2,1.0,30.0,289,287
22400595,3,97,-3.0,-1.8556701030927836,287,190
22400595,3,174,4.0,1.3793103448275863,185,11
22400595,3,5,0.0,0.0,5,0
22400595,4,197,6.0,1.8274111675126905,720,523
22400595,4,92,0.0,0.0,508,416
22400595,4,110,1.0,0.5454545454545454,401,291
22400595,4,282,-2.0,-0.425531914893617,282,0
22400596,1,367,7.0,1.1444141689373297,720,353
22400596,1,103,-1.0,-0.5825242718446602,353,250
22400596,1,82,0.0,0.0,234,152
22400596,1,75,2.0,1.6,148,73
22400596,1,73,-1.0,-0.821917808219178,73,0
22400596,2,41,2.0,2.926829268292683,720,679
22400596,2,69,-1.0,-0.8695652173913043,679,610
22400596,2,110,-2.0,-1.0909090909090908,602,492
22400596,2,78,2.0,1.5384615384615383,483,405
22400596,2,65,2.0,1.8461538461538463,392,327
22400596,2,92,4.0,2.608695652173913,306,214
22400596,2,68,3.0,2.647058823529412,154,86
22400596,2,86,0.0,0.0,86,0
22400596,3,207,6.0,1.7391304347826086,720,513
22400596,3,153,0.0,0.0,498,345
22400596,3,23,0.0,0.0,333,310
22400596,3,21,2.0,5.7142857142857135,301,280
22400596,3,41,2.0,2.926829268292683,280,239
22400596,3,32,-2.0,-3.75,220,188
22400596,3,140,-6.0,-2.5714285714285716,157,17
22400596,3,17,-2.0,-7.0588235294117645,17,0
22400596,4,118,-1.0,-0.5084745762711864,720,602
22400596,4,55,-2.0,-2.1818181818181817,602,547
22400596,4,6,0.0,0.0,538,532
22400596,4,150,4.0,1.6,519,369
22400596,4,31,-3.0,-5.806451612903226,353,322
22400596,4,102,0.0,0.0,322,220
22400596,4,68,-2.0,-1.7647058823529411,202,134
22400596,4,34,2.0,3.5294117647058822,134,100
22400596,4,61,0.0,0.0,88,27
22400596,4,21,-1.0,-2.8571428571428568,21,0
22400597,1,245,-4.0,-0.979591836734694,720,475
22400597,1,58,-3.0,-3.103448275862069,464,406
22400597,1,107,2.0,1.1214953271028036,399,292
22400597,1,132,-5.0,-2.272727272727273,279,147
22400597,1,129,-3.0,-1.3953488372093024,129,0
22400597,2,156,4.0,1.5384615384615383,720,564
22400597,2,58,2.0,2.0689655172413794,554,496
22400597,2,83,-3.0,-2.1686746987951806,489,406
22400597,2,89,7.0,4.719101123595506,392,303
22400597,2,88,1.0,0.6818181818181819,280,192
22400597,2,186,5.0,1.6129032258064517,186,0
22400597,3,224,2.0,0.5357142857142857,720,496
22400597,3,52,-2.0,-2.307692307692308,491,439
22400597,3,8,0.0,0.0,423,415
22400597,3,182,-4.0,-1.3186813186813189,415,233
22400597,3,22,0.0,0.0,217,195
22400597,3,59,2.0,2.0338983050847457,192,133
22400597,3,20,1.0,3.0,130,110
22400597,3,110,4.0,2.1818181818181817,110,0
22400597,4,58,0.0,0.0,720,662
22400597,4,111,-1.0,-0.5405405405405406,662,551
22400597,4,40,1.0,1.5,551,511
22400597,4,67,5.0,4.477611940298507,511,444
22400597,4,122,-3.0,-1.4754098360655736,437,315
22400597,4,55,0.0,0.0,315,260
22400597,4,8,-1.0,-7.5,260,252
22400597,4,42,-1.0,-1.4285714285714284,252,210
22400597,4,141,0.0,0.0,141,0
22400598,1,324,5.0,0.9259259259259258,720,396
22400598,1,118,-1.0,-0.5084745762711864,396,278
22400598,1,72,7.0,5.833333333333333,278,206
22400598,1,16,1.0,3.75,191,175
22400598,1,14,0.0,0.0,175,161
22400598,1,145,0.0,0.0,145,0
22400598,2,144,-2.0,-0.8333333333333333,720,576
22400598,2,90,4.0,2.666666666666667,576,486
22400598,2,79,1.0,0.7594936708860759,469,390
22400598,2,38,1.0,1.5789473684210527,390,352
22400598,2,51,0.0,0.0,352,301
22400598,2,60,0.0,0.0,301,241
22400598,2,99,4.0,2.4242424242424243,225,126
22400598,2,9,0.0,0.0,102,93
22400598,2,58,0.0,0.0,84,26
22400598,2,6,0.0,0.0,6,0
22400598,3,287,3.0,0.6271777003484321,720,433
22400598,3,76,0.0,0.0,417,341
22400598,3,24,-1.0,-2.5,333,309
22400598,3,21,-2.0,-5.7142857142857135,309,288
22400598,3,20,1.0,3.0,272,252
22400598,3,84,0.0,0.0,252,168
22400598,4,119,2.0,1.0084033613445378,720,601
22400598,4,53,-3.0,-3.3962264150943398,601,548
22400598,4,78,0.0,0.0,524,446
22400598,4,32,2.0,3.75,446,414
22400598,4,51,2.0,2.3529411764705883,399,348
22400598,4,135,6.0,2.666666666666667,338,203
22400598,4,30,1.0,2.0,191,161
22400598,4,55,4.0,4.363636363636363,161,106
22400599,1,267,2.0,0.449438202247191,720,453
22400599,1,62,2.0,1.935483870967742,453,391
22400599,1,18,0.0,0.0,383,365
22400599,1,43,-2.0,-2.7906976744186047,353,310
22400599,1,53,3.0,3.3962264150943398,298,245
22400599,1,168,-2.0,-0.7142857142857142,236,68
22400599,1,64,2.0,1.875,64,0
22400599,2,60,0.0,0.0,720,660
22400599,2,116,-2.0,-1.0344827586206897,654,538
22400599,2,59,0.0,0.0,514,455
22400599,2,59,-2.0,-2.0338983050847457,443,384
22400599,2,52,1.0,1.153846153846154,380,328
22400599,2,60,-1.0,-1.0,328,268
22400599,2,48,3.0,3.75,268,220
22400599,2,193,5.0,1.5544041450777202,193,0
22400599,3,283,-1.0,-0.21201413427561838,720,437
22400599,3,431,-2.0,-0.27842227378190254,662,231
22400599,3,72,-4.0,-3.333333333333333,219,147
22400599,3,116,0.0,0.0,137,21
22400599,3,8,0.0,0.0,8,0
22400599,4,88,2.0,1.3636363636363638,720,632
22400599,4,57,1.0,1.0526315789473684,624,567
22400599,4,81,0.0,0.0,567,486
22400599,4,185,-4.0,-1.2972972972972974,479,294
22400599,4,74,4.0,3.2432432432432434,268,194
22400599,4,128,0.0,0.0,194,66
22400599,4,18,0.0,0.0,44,26
22400599,4,2,1.0,30.0,15,13
22400599,4,13,2.0,9.230769230769232,13,0
22400600,1,244,4.0,0.9836065573770493,720,476
22400600,1,112,3.0,1.607142857142857,476,364
22400600,1,56,-11.0,-11.785714285714285,348,292
22400600,1,55,-2.0,-2.1818181818181817,272,217
22400600,1,180,0.0,0.0,217,37
22400600,1,32,-1.0,-1.875,32,0
22400600,2,24,0.0,0.0,720,696
22400600,2,152,3.0,1.1842105263157894,679,527
22400600,2,31,2.0,3.870967741935484,519,488
22400600,2,1,0.0,0.0,481,480
22400600,2,30,2.0,4.0,468,438
22400600,2,98,0.0,0.0,427,329
22400600,2,37,2.0,3.2432432432432434,320,283
22400600,2,89,1.0,0.6741573033707865,283,194
22400600,2,130,0.0,0.0,194,64
22400600,3,336,-14.0,-2.5,720,384
22400600,3,66,-1.0,-0.9090909090909092,384,318
22400600,3,90,4.0,2.666666666666667,318,228
22400600,3,44,2.0,2.7272727272727275,228,184
22400600,3,28,3.0,6.428571428571428,176,148
22400600,3,121,-1.0,-0.49586776859504134,136,15
22400600,3,15,-2.0,-8.0,15,0
22400600,4,323,-1.0,-0.18575851393188855,720,397
22400600,4,37,0.0,0.0,397,360
22400600,4,7,0.0,0.0,339,332
22400600,4,106,1.0,0.5660377358490566,262,156
22400600,4,123,1.0,0.48780487804878053,153,30
22400600,4,13,2.0,9.230769230769232,30,17
22400600,4,17,-1.0,-3.5294117647058822,17,0
22400601,1,119,2.0,1.0084033613445378,720,601
22400601,1,174,5.0,1.7241379310344827,594,420
22400601,1,12,-2.0,-10.0,420,408
22400601,1,176,-2.0,-0.6818181818181819,408,232
22400601,1,1,0.0,0.0,209,208
22400601,1,31,-1.0,-1.935483870967742,200,169
22400601,1,27,2.0,4.444444444444445,169,142
22400601,1,23,-1.0,-2.608695652173913,127,104
22400601,1,35,-3.0,-5.142857142857143,104,69
22400601,1,54,-6.0,-6.666666666666666,55,1
22400601,1,1,0.0,0.0,1,0
22400601,2,145,-2.0,-0.8275862068965517,720,575
22400601,2,47,0.0,0.0,575,528
22400601,2,25,2.0,4.8,527,502
22400601,2,57,-2.0,-2.1052631578947367,488,431
22400601,2,110,1.0,0.5454545454545454,431,321
22400601,2,121,-3.0,-1.487603305785124,304,183
22400601,2,27,0.0,0.0,183,156
22400601,2,115,1.0,0.5217391304347826,156,41
22400601,2,18,3.0,10.0,41,23
22400601,2,1,0.0,0.0,1,0
22400601,3,269,2.0,0.44609665427509293,720,451
22400601,3,62,-2.0,-1.935483870967742,451,389
22400601,3,80,4.0,3.0,389,309
22400601,3,45,1.0,1.3333333333333335,293,248
22400601,3,73,2.0,1.643835616438356,248,175
22400601,3,15,0.0,0.0,162,147
22400601,3,32,-1.0,-1.875,147,115
22400601,3,83,0.0,0.0,115,32
22400601,3,32,2.0,3.75,32,0
22400601,4,330,-2.0,-0.36363636363636365,720,390
22400601,4,11,2.0,10.90909090909091,378,367
22400601,4,98,-1.0,-0.6122448979591836,367,269
22400601,4,86,8.0,5.5813953488372094,254,168
22400601,4,28,1.0,2.142857142857143,168,140
22400601,4,108,-3.0,-1.6666666666666665,140,32
22400601,4,27,0.0,0.0,32,5
22400602,1,322,-8.0,-1.4906832298136645,720,398
22400602,1,25,0.0,0.0,391,366
22400602,1,11,0.0,0.0,350,339
22400602,1,67,-2.0,-1.791044776119403,321,254
22400602,1,12,0.0,0.0,245,233
22400602,1,41,-1.0,-1.4634146341463414,225,184
22400602,1,7,0.0,0.0,184,177
22400602,1,37,0.0,0.0,166,129
22400602,1,92,7.0,4.565217391304348,129,37
22400602,1,27,0.0,0.0,27,0
22400602,2,11,2.0,10.90909090909091,720,709
22400602,2,23,2.0,5.217391304347826,623,600
22400602,2,61,1.0,0.9836065573770493,595,534
22400602,2,126,0.0,0.0,644,518
22400602,2,77,-1.0,-0.7792207792207793,508,431
22400602,2,134,-3.0,-1.3432835820895521,416,282
22400602,2,21,-3.0,-8.571428571428571,272,251
22400602,2,69,0.0,0.0,242,173
22400602,2,45,-1.0,-1.3333333333333335,173,128
22400602,2,6,-1.0,-10.0,124,118
22400602,2,9,1.0,6.666666666666666,118,109
22400602,2,109,-5.0,-2.7522935779816518,109,0
22400602,3,346,11.0,1.9075144508670518,720,374
22400602,3,34,2.0,3.5294117647058822,358,324
22400602,3,174,2.0,0.6896551724137931,311,137
22400602,3,121,-1.0,-0.49586776859504134,126,5
22400602,3,5,0.0,0.0,5,0
22400602,4,99,-4.0,-2.4242424242424243,720,621
22400602,4,2,0.0,0.0,604,602
22400602,4,50,0.0,0.0,589,539
22400602,4,10,3.0,18.0,529,519
22400602,4,34,1.0,1.7647058823529411,508,474
22400602,4,76,-1.0,-0.7894736842105263,474,398
22400602,4,51,3.0,3.5294117647058822,379,328
22400602,4,38,-2.0,-3.1578947368421053,317,279
22400602,4,91,0.0,0.0,279,188
22400602,4,69,2.0,1.7391304347826086,145,76
22400602,4,76,-1.0,-0.7894736842105263,76,0
22400603,1,315,-1.0,-0.19047619047619047,720,405
22400603,1,51,2.0,2.3529411764705883,400,349
22400603,1,100,-5.0,-3.0,349,249
22400603,1,142,5.0,2.1126760563380285,249,107
22400603,1,86,0.0,0.0,86,0
22400603,2,166,4.0,1.4457831325301205,720,554
22400603,2,50,-5.0,-6.0,531,481
22400603,2,48,0.0,0.0,474,426
22400603,2,34,-2.0,-3.5294117647058822,414,380
22400603,2,90,-3.0,-2.0,380,290
22400603,2,151,4.0,1.5894039735099337,290,139
22400603,2,64,1.0,0.9375,136,72
22400603,2,72,3.0,2.5,72,0
22400603,3,111,6.0,3.2432432432432434,720,609
22400603,3,255,-1.0,-0.23529411764705882,601,346
22400603,3,84,-3.0,-2.142857142857143,330,246
22400603,3,54,0.0,0.0,246,192
22400603,3,60,4.0,4.0,172,112
22400603,3,108,1.0,0.5555555555555556,112,4
22400603,4,213,4.0,1.1267605633802817,720,507
22400603,4,52,1.0,1.153846153846154,507,455
22400603,4,64,3.0,2.8125,446,382
22400603,4,26,-2.0,-4.615384615384616,362,336
22400603,4,336,-4.0,-0.7142857142857142,336,0
22400604,1,252,2.0,0.47619047619047616,720,468
22400604,1,84,0.0,0.0,468,384
22400604,1,125,4.0,1.92,376,251
22400604,1,20,0.0,0.0,235,215
22400604,1,23,-2.0,-5.217391304347826,208,185
22400604,1,178,-7.0,-2.359550561797753,178,0
22400604,2,66,-2.0,-1.8181818181818183,720,654
22400604,2,130,1.0,0.46153846153846156,643,513
22400604,2,17,0.0,0.0,513,496
22400604,2,170,-4.0,-1.4117647058823528,484,314
22400604,2,5,0.0,0.0,311,306
22400604,2,244,-2.0,-0.49180327868852464,295,51
22400604,2,48,2.0,2.5,51,3
22400604,3,177,-8.0,-2.711864406779661,720,543
22400604,3,215,-7.0,-1.9534883720930232,528,313
22400604,3,208,-3.0,-0.8653846153846154,313,105
22400604,3,33,1.0,1.8181818181818183,88,55
22400604,3,55,0.0,0.0,55,0
22400604,4,236,-5.0,-1.271186440677966,720,484
22400604,4,79,-1.0,-0.7594936708860759,461,382
22400604,4,30,0.0,0.0,379,349
22400604,4,86,-1.0,-0.6976744186046512,337,251
22400604,4,251,-1.0,-0.23904382470119523,251,0
22400605,1,264,-12.0,-2.7272727272727275,720,456
22400605,1,113,0.0,0.0,456,343
22400605,1,41,-1.0,-1.4634146341463414,333,292
22400605,1,45,-1.0,-1.3333333333333335,292,247
22400605,1,11,0.0,0.0,230,219
22400605,1,126,-2.0,-0.9523809523809523,219,93
22400605,1,93,2.0,1.2903225806451615,93,0
22400605,2,125,-3.0,-1.44,720,595
22400605,2,70,1.0,0.8571428571428571,584,514
22400605,2,11,2.0,10.90909090909091,514,503
22400605,2,8,0.0,0.0,503,495
22400605,2,141,3.0,1.2765957446808511,486,345
22400605,2,148,1.0,0.40540540540540543,332,184
22400605,2,149,-4.0,-1.610738255033557,177,28
22400605,2,22,0.0,0.0,28,6
22400605,3,389,-1.0,-0.15424164524421594,720,331
22400605,3,22,0.0,0.0,322,300
22400605,3,94,7.0,4.468085106382978,295,201
22400605,3,17,0.0,0.0,201,184
22400605,3,26,1.0,2.307692307692308,184,158
22400605,3,52,0.0,0.0,141,89
22400605,4,160,4.0,1.5,720,560
22400605,4,55,-4.0,-4.363636363636363,538,483
22400605,4,90,2.0,1.3333333333333335,467,377
22400605,4,43,2.0,2.7906976744186047,365,322
22400605,4,95,1.0,0.631578947368421,324,229
22400605,4,185,-1.0,-0.32432432432432434,218,33
22400605,4,10,0.0,0.0,26,16
22400605,4,3,0.0,0.0,3,0
22400605,5,251,0.0,0.0,300,49
22400605,5,16,3.0,11.25,49,33
22400605,5,3,1.0,20.0,11,8
22400605,5,8,0.0,0.0,8,0
22400606,1,263,-8.0,-1.8250950570342206,720,457
22400606,1,133,2.0,0.9022556390977443,437,304
22400606,1,11,0.0,0.0,304,293
22400606,1,162,0.0,0.0,274,112
22400606,1,4,0.0,0.0,112,108
22400606,2,190,-10.0,-3.1578947368421053,720,530
22400606,2,2,0.0,0.0,512,510
22400606,2,38,-4.0,-6.315789473684211,502,464
22400606,2,100,-1.0,-0.6,464,364
22400606,2,34,3.0,5.294117647058824,343,309
22400606,2,75,2.0,1.6,298,223
22400606,2,9,1.0,6.666666666666666,206,197
22400606,2,86,1.0,0.6976744186046512,197,111
22400606,2,107,-3.0,-1.6822429906542056,111,4
22400606,2,4,0.0,0.0,4,0
22400606,3,324,4.0,0.7407407407407407,720,396
22400606,3,99,-8.0,-4.848484848484849,385,286
22400606,3,37,-2.0,-3.2432432432432434,269,232
22400606,3,122,2.0,0.9836065573770493,213,91
22400606,3,63,2.0,1.9047619047619047,83,20
22400606,3,1,0.0,0.0,1,0
22400606,4,45,0.0,0.0,720,675
22400606,4,64,0.0,0.0,651,587
22400606,4,30,0.0,0.0,587,557
22400606,4,49,2.0,2.4489795918367343,550,501
22400606,4,249,6.0,1.4457831325301205,501,252
22400606,4,6,0.0,0.0,209,203
22400606,4,156,-3.0,-1.153846153846154,192,36
22400606,4,9,0.0,0.0,32,23
22400606,4,3,0.0,0.0,15,12
22400606,4,7,0.0,0.0,7,0
22400607,1,281,0.0,0.0,720,439
22400607,1,78,4.0,3.0769230769230766,422,344
22400607,1,50,0.0,0.0,334,284
22400607,1,69,-3.0,-2.608695652173913,284,215
22400607,1,115,-2.0,-1.0434782608695652,207,92
22400607,1,80,1.0,0.75,80,0
22400607,2,96,-2.0,-1.25,720,624
22400607,2,173,2.0,0.6936416184971098,624,451
22400607,2,1,0.0,0.0,437,436
22400607,2,36,-3.0,-5.0,418,382
22400607,2,246,0.0,0.0,382,136
22400607,2,120,-4.0,-2.0,120,0
22400607,3,73,-1.0,-0.821917808219178,720,647
22400607,3,182,-3.0,-0.989010989010989,647,465
22400607,3,83,-4.0,-2.891566265060241,453,370
22400607,3,97,-7.0,-4.329896907216495,370,273
22400607,3,91,-3.0,-1.978021978021978,259,168
22400607,3,53,3.0,3.3962264150943398,141,88
22400607,3,71,4.0,3.380281690140845,71,0
22400607,4,296,4.0,0.8108108108108109,720,424
22400607,4,19,0.0,0.0,409,390
22400607,4,143,1.0,0.4195804195804196,387,244
22400607,4,137,8.0,3.503649635036496,235,98
22400607,4,98,-1.0,-0.6122448979591836,98,0
22400608,1,242,-10.0,-2.479338842975207,720,478
22400608,1,138,-4.0,-1.7391304347826086,478,340
22400608,1,67,-3.0,-2.6865671641791042,335,268
22400608,1,1,0.0,0.0,252,251
22400608,1,177,7.0,2.3728813559322037,239,62
22400608,1,52,1.0,1.153846153846154,52,0
22400608,2,57,-1.0,-1.0526315789473684,720,663
22400608,2,102,4.0,2.3529411764705883,663,561
22400608,2,49,2.0,2.4489795918367343,561,512
22400608,2,31,3.0,5.806451612903226,507,476
22400608,2,80,-2.0,-1.5,458,378
22400608,2,34,0.0,0.0,365,331
22400608,2,29,0.0,0.0,318,289
22400608,2,170,2.0,0.7058823529411764,289,119
22400608,2,45,2.0,2.666666666666667,109,64
22400608,2,24,3.0,7.5,64,40
22400608,2,9,-2.0,-13.333333333333332,9,0
22400608,3,283,4.0,0.8480565371024735,720,437
22400608,3,25,2.0,4.8,426,401
22400608,3,67,0.0,0.0,386,319
22400608,3,31,-2.0,-3.870967741935484,315,284
22400608,3,22,3.0,8.181818181818182,259,237
22400608,3,43,3.0,4.186046511627907,214,171
22400608,3,171,6.0,2.1052631578947367,171,0
22400608,4,73,1.0,0.821917808219178,720,647
22400608,4,85,-1.0,-0.7058823529411764,647,562
22400608,4,28,0.0,0.0,545,517
22400608,4,23,2.0,5.217391304347826,468,445
22400608,4,70,1.0,0.8571428571428571,438,368
22400608,4,13,-1.0,-4.615384615384616,357,344
22400608,4,153,-1.0,-0.39215686274509803,344,191
22400608,4,37,0.0,0.0,191,154
22400608,4,68,2.0,1.7647058823529411,154,86
22400608,4,67,-3.0,-2.6865671641791042,67,0
22400609,1,416,11.0,1.5865384615384615,720,304
22400609,1,168,0.0,0.0,294,126
22400609,2,52,2.0,2.307692307692308,720,668
22400609,2,106,3.0,1.6981132075471699,668,562
22400609,2,170,-3.0,-1.0588235294117647,551,381
22400609,2,29,-3.0,-6.206896551724138,381,352
22400609,2,94,1.0,0.6382978723404256,350,256
22400609,2,105,1.0,0.5714285714285715,256,151
22400609,2,146,-3.0,-1.2328767123287672,146,0
22400609,3,170,7.0,2.4705882352941178,720,550
22400609,3,180,3.0,1.0,536,356
22400609,3,29,2.0,4.137931034482759,347,318
22400609,3,81,2.0,1.4814814814814814,303,222
22400609,3,26,-2.0,-4.615384615384616,220,194
22400609,3,181,-1.0,-0.3314917127071823,187,6
22400609,3,6,0.0,0.0,6,0
22400609,4,231,-1.0,-0.2597402597402597,720,489
22400609,4,97,2.0,1.2371134020618557,476,379
22400609,4,46,1.0,1.3043478260869565,355,309
22400609,4,59,0.0,0.0,309,250
22400609,4,246,7.0,1.7073170731707317,246,0
22400610,1,406,3.0,0.44334975369458124,720,314
22400610,1,103,2.0,1.1650485436893203,314,211
22400610,1,47,3.0,3.829787234042553,196,149
22400610,1,34,4.0,7.0588235294117645,139,105
22400610,1,81,-1.0,-0.7407407407407407,86,5
22400610,2,185,0.0,0.0,720,535
22400610,2,26,-3.0,-6.923076923076923,524,498
22400610,2,91,2.0,1.3186813186813189,482,391
22400610,2,26,2.0,4.615384615384616,391,365
22400610,2,111,0.0,0.0,356,245
22400610,2,56,0.0,0.0,238,182
22400610,2,77,-1.0,-0.7792207792207793,182,105
22400610,2,89,1.0,0.6741573033707865,105,16
22400610,2,16,0.0,0.0,16,0
22400610,3,322,8.0,1.4906832298136645,720,398
22400610,3,133,-1.0,-0.45112781954887216,397,264
22400610,3,128,-3.0,-1.40625,264,136
22400610,3,136,0.0,0.0,136,0
22400610,4,211,5.0,1.4218009478672984,720,509
22400610,4,124,0.0,0.0,494,370
22400610,4,176,2.0,0.6818181818181819,370,194
22400610,4,12,0.0,0.0,179,167
22400610,4,43,2.0,2.7906976744186047,162,119
22400610,4,16,0.0,0.0,112,96
22400610,4,84,4.0,2.8571428571428568,84,0
22400611,1,312,-7.0,-1.3461538461538463,720,408
22400611,1,95,0.0,0.0,389,294
22400611,1,14,-2.0,-8.571428571428571,279,265
22400611,1,33,0.0,0.0,242,209
22400611,1,5,0.0,0.0,183,178
22400611,1,161,0.0,0.0,161,0
22400611,2,54,2.0,2.2222222222222223,720,666
22400611,2,16,0.0,0.0,655,639
22400611,2,200,8.0,2.4,629,429
22400611,2,13,0.0,0.0,421,408
22400611,2,242,-5.0,-1.2396694214876034,408,166
22400611,2,35,2.0,3.4285714285714284,166,131
22400611,2,97,0.0,0.0,123,26
22400611,2,26,0.0,0.0,26,0
22400611,3,272,-7.0,-1.5441176470588234,720,448
22400611,3,105,-1.0,-0.5714285714285715,435,330
22400611,3,71,-2.0,-1.6901408450704225,321,250
22400611,3,67,-3.0,-2.6865671641791042,244,177
22400611,3,165,-4.0,-1.4545454545454546,170,5
22400611,4,64,0.0,0.0,720,656
22400611,4,115,2.0,1.0434782608695652,638,523
22400611,4,23,-1.0,-2.608695652173913,509,486
22400611,4,93,3.0,1.935483870967742,486,393
22400611,4,50,0.0,0.0,388,338
22400611,4,70,-1.0,-0.8571428571428571,326,256
22400611,4,164,-1.0,-0.36585365853658536,248,84
22400611,4,76,0.0,0.0,76,0
22400612,1,199,-1.0,-0.30150753768844224,720,521
22400612,1,119,0.0,0.0,521,402
22400612,1,97,-4.0,-2.4742268041237114,402,305
22400612,1,90,2.0,1.3333333333333335,294,204
22400612,1,25,-1.0,-2.4,185,160
22400612,1,160,-3.0,-1.125,160,0
22400612,2,138,-3.0,-1.3043478260869565,720,582
22400612,2,100,1.0,0.6,566,466
22400612,2,51,2.0,2.3529411764705883,466,415
22400612,2,11,1.0,5.454545454545455,401,390
22400612,2,66,0.0,0.0,390,324
22400612,2,206,-9.0,-2.621359223300971,307,101
22400612,2,32,1.0,1.875,82,50
22400612,2,50,2.0,2.4,50,0
22400612,3,431,3.0,0.4176334106728538,720,289
22400612,3,97,-1.0,-0.6185567010309279,276,179
22400612,3,152,-5.0,-1.9736842105263157,155,3
22400612,3,3,0.0,0.0,3,0
22400612,4,155,5.0,1.935483870967742,720,565
22400612,4,14,-1.0,-4.285714285714286,565,551
22400612,4,66,1.0,0.9090909090909092,551,485
22400612,4,24,1.0,2.5,485,461
22400612,4,58,1.0,1.0344827586206897,461,403
22400612,4,45,-2.0,-2.666666666666667,392,347
22400612,4,70,-2.0,-1.7142857142857142,339,269
22400612,4,181,4.0,1.3259668508287292,262,81
22400612,4,63,2.0,1.9047619047619047,63,0
22400613,1,287,-5.0,-1.0452961672473866,720,433
22400613,1,101,-4.0,-2.376237623762376,415,314
22400613,1,43,1.0,1.3953488372093024,314,271
22400613,1,114,2.0,1.0526315789473684,260,146
22400613,1,62,-3.0,-2.903225806451613,143,81
22400613,1,81,1.0,0.7407407407407407,81,0
22400613,2,270,3.0,0.6666666666666667,720,450
22400613,2,97,0.0,0.0,445,348
22400613,2,63,1.0,0.9523809523809523,338,275
22400613,2,44,2.0,2.7272727272727275,275,231
22400613,2,81,-5.0,-3.7037037037037033,231,150
22400613,2,114,-2.0,-1.0526315789473684,150,36
22400613,2,29,-2.0,-4.137931034482759,29,0
22400613,3,338,-2.0,-0.35502958579881655,720,382
22400613,3,136,3.0,1.323529411764706,382,246
22400613,3,29,0.0,0.0,231,202
22400613,3,47,-2.0,-2.5531914893617023,188,141
22400613,3,141,0.0,0.0,141,0
22400613,4,66,0.0,0.0,720,654
22400613,4,191,-4.0,-1.256544502617801,654,463
22400613,4,33,0.0,0.0,463,430
22400613,4,55,0.0,0.0,425,370
22400613,4,17,0.0,0.0,346,329
22400613,4,38,-2.0,-3.1578947368421053,310,272
22400613,4,74,-5.0,-4.054054054054054,253,179
22400613,4,168,3.0,1.0714285714285714,168,0
22400614,1,267,-3.0,-0.6741573033707865,720,453
22400614,1,48,0.0,0.0,453,405
22400614,1,163,-1.0,-0.36809815950920244,405,242
22400614,1,69,2.0,1.7391304347826086,242,173
22400614,1,63,4.0,3.8095238095238093,154,91
22400614,1,84,3.0,2.142857142857143,84,0
22400614,2,200,0.0,0.0,720,520
22400614,2,22,1.0,2.7272727272727275,520,498
22400614,2,58,-3.0,-3.103448275862069,498,440
22400614,2,105,-6.0,-3.4285714285714284,428,323
22400614,2,4,-1.0,-15.0,307,303
22400614,2,133,1.0,0.45112781954887216,303,170
22400614,2,32,1.0,1.875,170,138
22400614,2,138,2.0,0.8695652173913043,138,0
22400614,3,213,0.0,0.0,720,507
22400614,3,85,-1.0,-0.7058823529411764,498,413
22400614,3,140,-6.0,-2.5714285714285716,413,273
22400614,3,56,2.0,2.142857142857143,273,217
22400614,3,22,2.0,5.454545454545455,211,189
22400614,3,12,0.0,0.0,178,166
22400614,3,26,-2.0,-4.615384615384616,161,135
22400614,3,81,1.0,0.7407407407407407,124,43
22400614,4,138,-5.0,-2.1739130434782608,720,582
22400614,4,8,-3.0,-22.5,574,566
22400614,4,108,2.0,1.1111111111111112,544,436
22400614,4,19,4.0,12.631578947368421,371,352
22400614,4,144,-7.0,-2.9166666666666665,345,201
22400614,4,94,3.0,1.9148936170212765,188,94
22400614,4,50,1.0,1.2,88,38
22400614,4,35,1.0,1.7142857142857142,38,3
22400614,4,3,3.0,60.0,3,0
22400615,1,477,-5.0,-0.628930817610063,720,243
22400615,1,127,6.0,2.8346456692913384,227,100
22400615,1,86,3.0,2.0930232558139537,100,14
22400615,1,2,0.0,0.0,2,0
22400615,2,190,-6.0,-1.8947368421052633,720,530
22400615,2,22,-2.0,-5.454545454545455,525,503
22400615,2,26,0.0,0.0,487,461
22400615,2,59,6.0,6.101694915254238,452,393
22400615,2,39,0.0,0.0,369,330
22400615,2,48,3.0,3.75,315,267
22400615,2,61,2.0,1.9672131147540985,261,200
22400615,3,348,0.0,0.0,720,372
22400615,3,95,-1.0,-0.631578947368421,372,277
22400615,3,37,3.0,4.864864864864865,261,224
22400615,3,84,-5.0,-3.571428571428571,224,140
22400615,3,117,7.0,3.58974358974359,117,0
22400615,4,166,-1.0,-0.3614457831325301,720,554
22400615,4,49,-2.0,-2.4489795918367343,554,505
22400615,4,26,-2.0,-4.615384615384616,490,464
22400615,4,135,-4.0,-1.777777777777778,456,321
22400615,4,163,-2.0,-0.7361963190184049,309,146
22400615,4,142,-3.0,-1.267605633802817,146,4
22400615,4,2,0.0,0.0,4,2
22400616,1,333,1.0,0.18018018018018017,720,387
22400616,1,42,1.0,1.4285714285714284,382,340
22400616,1,59,1.0,1.0169491525423728,337,278
22400616,1,38,4.0,6.315789473684211,278,240
22400616,1,107,3.0,1.6822429906542056,240,133
22400616,2,68,8.0,7.0588235294117645,720,652
22400616,2,60,2.0,2.0,641,581
22400616,2,155,-2.0,-0.7741935483870968,581,426
22400616,2,24,0.0,0.0,409,385
22400616,2,9,0.0,0.0,385,376
22400616,2,55,2.0,2.1818181818181817,354,299
22400616,2,53,2.0,2.2641509433962264,288,235
22400616,2,2,-1.0,-30.0,215,213
22400616,2,154,1.0,0.38961038961038963,213,59
22400616,2,59,5.0,5.084745762711864,59,0
22400616,3,171,-3.0,-1.0526315789473684,720,549
22400616,3,65,0.0,0.0,541,476
22400616,3,44,4.0,5.454545454545455,476,432
22400616,3,45,4.0,5.333333333333334,432,387
22400616,3,69,2.0,1.7391304347826086,374,305
22400616,3,102,-2.0,-1.1764705882352942,245,143
22400616,3,19,-1.0,-3.1578947368421053,143,124
22400616,3,26,-5.0,-11.538461538461538,108,82
22400616,3,55,-4.0,-4.363636363636363,68,13
22400616,3,3,0.0,0.0,3,0
22400616,4,127,3.0,1.4173228346456692,720,593
22400616,4,102,-2.0,-1.1764705882352942,581,479
22400616,4,16,0.0,0.0,456,440
22400616,4,75,-1.0,-0.8,433,358
22400616,4,18,0.0,0.0,358,340
22400616,4,63,-2.0,-1.9047619047619047,340,277
22400616,4,79,-1.0,-0.7594936708860759,259,180
22400616,4,122,-1.0,-0.49180327868852464,180,58
22400616,4,46,0.0,0.0,46,0
22400617,1,436,-1.0,-0.13761467889908258,720,284
22400617,1,109,1.0,0.5504587155963303,274,165
22400617,1,151,5.0,1.9867549668874174,151,0
22400617,2,135,-7.0,-3.111111111111111,720,585
22400617,2,75,-2.0,-1.6,569,494
22400617,2,34,2.0,3.5294117647058822,494,460
22400617,2,36,-2.0,-3.333333333333333,445,409
22400617,2,103,3.0,1.7475728155339807,403,300
22400617,2,188,4.0,1.2765957446808511,300,112
22400617,2,104,-6.0,-3.4615384615384617,104,0
22400617,3,317,9.0,1.7034700315457414,720,403
22400617,3,50,0.0,0.0,403,353
22400617,3,29,0.0,0.0,330,301
22400617,3,26,0.0,0.0,291,265
22400617,3,96,-6.0,-3.75,253,157
22400617,3,150,0.0,0.0,150,0
22400617,4,235,6.0,1.5319148936170213,720,485
22400617,4,57,-6.0,-6.315789473684211,472,415
22400617,4,70,-4.0,-3.4285714285714284,400,330
22400617,4,196,1.0,0.3061224489795918,330,134
22400617,4,123,4.0,1.9512195121951221,126,3
22400617,4,2,0.0,0.0,2,0
22400618,1,337,-10.0,-1.7804154302670623,720,383
22400618,1,162,1.0,0.37037037037037035,383,221
22400618,1,53,-2.0,-2.2641509433962264,211,158
22400618,1,88,3.0,2.0454545454545454,158,70
22400618,2,202,1.0,0.297029702970297,720,518
22400618,2,17,0.0,0.0,503,486
22400618,2,49,2.0,2.4489795918367343,472,423
22400618,2,53,-1.0,-1.1320754716981132,408,355
22400618,2,202,-2.0,-0.594059405940594,334,132
22400618,2,131,-3.0,-1.3740458015267176,132,1
22400618,3,256,-3.0,-0.703125,720,464
22400618,3,38,3.0,4.7368421052631575,447,409
22400618,3,10,0.0,0.0,405,395
22400618,3,70,3.0,2.5714285714285716,387,317
22400618,3,39,0.0,0.0,306,267
22400618,3,46,0.0,0.0,267,221
22400618,3,5,0.0,0.0,221,216
22400618,3,175,6.0,2.0571428571428574,216,41
22400618,3,41,0.0,0.0,41,0
22400618,4,178,-3.0,-1.0112359550561798,720,542
22400618,4,9,-2.0,-13.333333333333332,534,525
22400618,4,61,0.0,0.0,514,453
22400618,4,23,0.0,0.0,453,430
22400618,4,28,-2.0,-4.285714285714286,420,392
22400618,4,177,8.0,2.711864406779661,379,202
22400618,4,187,0.0,0.0,187,0
22400619,1,291,1.0,0.20618556701030927,720,429
22400619,1,6,0.0,0.0,423,417
22400619,1,88,-4.0,-2.7272727272727275,405,317
22400619,1,79,2.0,1.5189873417721518,317,238
22400619,1,53,0.0,0.0,229,176
22400619,1,159,0.0,0.0,159,0
22400619,2,138,1.0,0.43478260869565216,720,582
22400619,2,72,0.0,0.0,582,510
22400619,2,19,0.0,0.0,495,476
22400619,2,19,-3.0,-9.473684210526315,469,450
22400619,2,57,-5.0,-5.263157894736842,432,375
22400619,2,24,0.0,0.0,365,341
22400619,2,52,2.0,2.307692307692308,332,280
22400619,2,271,-5.0,-1.1070110701107012,280,9
22400619,3,335,4.0,0.7164179104477612,720,385
22400619,3,108,0.0,0.0,376,268
22400619,3,31,-1.0,-1.935483870967742,261,230
22400619,3,103,4.0,2.3300970873786406,204,101
22400619,3,76,6.0,4.7368421052631575,101,25
22400619,3,25,0.0,0.0,25,0
22400619,4,173,-9.0,-3.121387283236994,720,547
22400619,4,91,8.0,5.2747252747252755,556,465
22400619,4,125,-3.0,-1.44,444,319
22400619,4,31,1.0,1.935483870967742,310,279
22400619,4,144,0.0,0.0,279,135
22400619,4,68,7.0,6.1764705882352935,135,67
22400619,4,29,0.0,0.0,50,21
22400620,1,340,-2.0,-0.3529411764705882,720,380
22400620,1,113,-3.0,-1.592920353982301,368,255
22400620,1,74,1.0,0.8108108108108109,245,171
22400620,1,77,3.0,2.3376623376623376,148,71
22400620,1,55,-1.0,-1.0909090909090908,55,0
22400620,2,171,0.0,0.0,720,549
22400620,2,55,1.0,1.0909090909090908,549,494
22400620,2,26,0.0,0.0,475,449
22400620,2,74,-5.0,-4.054054054054054,430,356
22400620,2,24,-2.0,-5.0,332,308
22400620,2,55,1.0,1.0909090909090908,308,253
22400620,2,132,2.0,0.9090909090909092,238,106
22400620,2,106,0.0,0.0,106,0
22400620,3,133,2.0,0.9022556390977443,720,587
22400620,3,56,-4.0,-4.285714285714286,588,532
22400620,3,109,6.0,3.302752293577982,532,423
22400620,3,143,1.0,0.4195804195804196,401,258
22400620,3,24,1.0,2.5,258,234
22400620,3,18,0.0,0.0,234,216
22400620,3,79,-1.0,-0.7594936708860759,212,133
22400620,3,133,0.0,0.0,133,0
22400620,4,200,-4.0,-1.2,720,520
22400620,4,111,-3.0,-1.6216216216216217,502,391
22400620,4,289,3.0,0.6228373702422145,371,82
22400620,4,40,0.0,0.0,59,19
22400620,4,7,0.0,0.0,7,0
22400620,5,266,-2.0,-0.45112781954887216,300,34
22400620,5,30,-2.0,-4.0,30,0
22400621,1,277,2.0,0.4332129963898917,720,443
22400621,1,62,-7.0,-6.774193548387097,426,364
22400621,1,27,0.0,0.0,344,317
22400621,1,23,0.0,0.0,315,292
22400621,1,58,1.0,1.0344827586206897,291,233
22400621,1,90,-1.0,-0.6666666666666667,229,139
22400621,1,1,0.0,0.0,131,130
22400621,1,116,2.0,1.0344827586206897,116,0
22400621,2,17,0.0,0.0,720,703
22400621,2,132,6.0,2.7272727272727275,693,561
22400621,2,164,-2.0,-0.7317073170731707,544,380
22400621,2,42,-4.0,-5.7142857142857135,359,317
22400621,2,166,-2.0,-0.7228915662650602,301,135
22400621,2,123,0.0,0.0,123,0
22400621,3,289,-10.0,-2.0761245674740487,720,431
22400621,3,36,2.0,3.333333333333333,409,373
22400621,3,56,-5.0,-5.357142857142858,357,301
22400621,3,54,-3.0,-3.333333333333333,290,236
22400621,3,34,-3.0,-5.294117647058824,236,202
22400621,3,39,3.0,4.615384615384616,202,163
22400621,3,163,-9.0,-3.312883435582822,163,0
22400621,4,89,5.0,3.3707865168539324,720,631
22400621,4,28,-3.0,-6.428571428571428,619,591
22400621,4,66,-2.0,-1.8181818181818183,591,525
22400621,4,38,1.0,1.5789473684210527,520,482
22400621,4,127,-1.0,-0.47244094488188976,464,337
22400621,4,66,-4.0,-3.6363636363636367,337,271
22400621,4,145,-2.0,-0.8275862068965517,260,115
22400622,1,281,-6.0,-1.2811387900355873,720,439
22400622,1,58,5.0,5.172413793103448,420,362
22400622,1,24,0.0,0.0,362,338
22400622,1,116,-1.0,-0.5172413793103449,332,216
22400622,1,108,1.0,0.5555555555555556,216,108
22400622,1,9,0.0,0.0,96,87
22400622,1,87,2.0,1.3793103448275863,87,0
22400622,2,88,-1.0,-0.6818181818181819,720,632
22400622,2,54,0.0,0.0,624,570
22400622,2,79,2.0,1.5189873417721518,570,491
22400622,2,85,0.0,0.0,491,406
22400622,2,88,-4.0,-2.7272727272727275,406,318
22400622,2,62,0.0,0.0,318,256
22400622,2,13,0.0,0.0,238,225
22400622,2,83,-4.0,-2.891566265060241,211,128
22400622,2,115,0.0,0.0,115,0
22400622,3,295,-2.0,-0.4067796610169491,720,425
22400622,3,49,0.0,0.0,420,371
22400622,3,75,1.0,0.8,371,296
22400622,3,4,0.0,0.0,284,280
22400622,3,128,-2.0,-0.9375,280,152
22400622,3,36,-1.0,-1.6666666666666665,136,100
22400622,3,40,-2.0,-3.0,100,60
22400622,3,60,-2.0,-2.0,60,0
22400622,4,91,-1.0,-0.6593406593406594,720,629
22400622,4,156,5.0,1.923076923076923,609,453
22400622,4,56,-1.0,-1.0714285714285714,428,372
22400622,4,135,-4.0,-1.777777777777778,372,237
22400622,4,103,-3.0,-1.7475728155339807,221,118
22400622,4,104,0.0,0.0,104,0
22400623,1,370,-7.0,-1.135135135135135,720,350
22400623,1,50,0.0,0.0,342,292
22400623,1,51,0.0,0.0,284,233
22400623,1,26,-1.0,-2.307692307692308,233,207
22400623,1,72,4.0,3.333333333333333,202,130
22400623,1,67,-3.0,-2.6865671641791042,130,63
22400623,1,63,-1.0,-0.9523809523809523,63,0
22400623,2,70,-2.0,-1.7142857142857142,720,650
22400623,2,36,-2.0,-3.333333333333333,650,614
22400623,2,116,0.0,0.0,614,498
22400623,2,162,1.0,0.37037037037037035,498,336
22400623,2,108,3.0,1.6666666666666665,336,228
22400623,2,80,-1.0,-0.75,199,119
22400623,2,119,3.0,1.5126050420168067,119,0
22400623,3,351,-2.0,-0.3418803418803419,720,369
22400623,3,92,-1.0,-0.6521739130434783,369,277
22400623,3,22,-2.0,-5.454545454545455,265,243
22400623,3,16,1.0,3.75,243,227
22400623,3,65,0.0,0.0,227,162
22400623,3,159,2.0,0.7547169811320755,159,0
22400623,4,119,0.0,0.0,720,601
22400623,4,19,-1.0,-3.1578947368421053,601,582
22400623,4,53,2.0,2.2641509433962264,582,529
22400623,4,49,1.0,1.2244897959183672,512,463
22400623,4,152,4.0,1.5789473684210527,438,286
22400623,4,176,-3.0,-1.0227272727272727,178,2
22400623,4,2,-2.0,-60.0,2,0
22400624,1,118,-2.0,-1.0169491525423728,720,602
22400624,1,296,-8.0,-1.6216216216216217,594,298
22400624,1,103,5.0,2.912621359223301,283,180
22400624,1,140,1.0,0.42857142857142855,180,40
22400624,1,40,2.0,3.0,40,0
22400624,2,127,8.0,3.779527559055118,720,593
22400624,2,112,2.0,1.0714285714285714,574,462
22400624,2,42,-2.0,-2.8571428571428568,462,420
22400624,2,26,-2.0,-4.615384615384616,363,337
22400624,2,164,3.0,1.097560975609756,326,162
22400624,2,89,2.0,1.348314606741573,159,70
22400624,2,69,4.0,3.4782608695652173,70,1
22400624,3,447,2.0,0.2684563758389262,720,273
22400624,3,7,1.0,8.571428571428571,259,252
22400624,3,46,2.0,2.608695652173913,252,206
22400624,3,143,6.0,2.5174825174825175,196,53
22400624,3,47,-2.0,-2.5531914893617023,47,0
22400624,4,292,2.0,0.410958904109589,720,428
22400624,4,40,-1.0,-1.5,416,376
22400624,4,139,4.0,1.7266187050359714,376,237
22400624,4,218,3.0,0.8256880733944955,218,0
22400625,1,299,0.0,0.0,720,421
22400625,1,21,-1.0,-2.8571428571428568,402,381
22400625,1,119,-6.0,-3.0252100840336134,358,239
22400625,1,42,4.0,5.7142857142857135,239,197
22400625,1,161,-1.0,-0.37267080745341613,179,18
22400625,1,1,1.0,60.0,10,9
22400625,1,9,3.0,20.0,9,0
22400625,2,129,4.0,1.8604651162790697,720,591
22400625,2,8,2.0,15.0,579,571
22400625,2,126,-3.0,-1.4285714285714284,652,526
22400625,2,152,3.0,1.1842105263157894,526,374
22400625,2,58,2.0,2.0689655172413794,374,316
22400625,2,64,0.0,0.0,307,243
22400625,2,29,0.0,0.0,243,214
22400625,2,68,-2.0,-1.7647058823529411,214,146
22400625,3,310,-8.0,-1.5483870967741935,720,410
22400625,3,6,-1.0,-10.0,410,404
22400625,3,84,-1.0,-0.7142857142857142,404,320
22400625,3,102,4.0,2.3529411764705883,320,218
22400625,3,16,-1.0,-3.75,218,202
22400625,3,55,0.0,0.0,202,147
22400625,3,75,-2.0,-1.6,147,72
22400625,3,51,0.0,0.0,72,21
22400625,3,13,0.0,0.0,21,8
22400625,4,92,2.0,1.3043478260869565,720,628
22400625,4,77,-1.0,-0.7792207792207793,626,549
22400625,4,10,0.0,0.0,549,539
22400625,4,2,0.0,0.0,529,527
22400625,4,60,6.0,6.0,516,456
22400625,4,17,1.0,3.5294117647058822,437,420
22400625,4,92,-1.0,-0.6521739130434783,342,250
22400625,4,1,0.0,0.0,227,226
22400625,4,192,1.0,0.3125,201,9
22400625,4,2,0.0,0.0,2,0
22400626,1,315,1.0,0.19047619047619047,720,405
22400626,1,20,0.0,0.0,396,376
22400626,1,98,3.0,1.836734693877551,376,278
22400626,1,24,3.0,7.5,278,254
22400626,1,52,0.0,0.0,246,194
22400626,1,194,3.0,0.9278350515463918,194,0
22400626,2,199,3.0,0.9045226130653266,720,521
22400626,2,74,1.0,0.8108108108108109,510,436
22400626,2,36,3.0,5.0,436,400
22400626,2,55,0.0,0.0,400,345
22400626,2,89,-1.0,-0.6741573033707865,345,256
22400626,2,142,6.0,2.535211267605634,256,114
22400626,2,83,-1.0,-0.7228915662650602,114,31
22400626,2,25,2.0,4.8,25,0
22400626,3,399,-4.0,-0.6015037593984962,720,321
22400626,3,87,-1.0,-0.6896551724137931,315,228
22400626,3,75,0.0,0.0,228,153
22400626,4,203,-11.0,-3.251231527093596,720,517
22400626,4,107,-1.0,-0.5607476635514018,511,404
22400626,4,47,1.0,1.2765957446808511,404,357
22400626,4,94,-2.0,-1.2765957446808511,333,239
22400626,4,198,-6.0,-1.8181818181818183,239,41
22400626,4,25,0.0,0.0,41,16
22400626,4,15,0.0,0.0,15,0
22400627,1,205,-7.0,-2.048780487804878,720,515
22400627,1,77,0.0,0.0,500,423
22400627,1,109,5.0,2.7522935779816518,412,303
22400627,1,78,-4.0,-3.0769230769230766,291,213
22400627,1,121,4.0,1.9834710743801653,206,85
22400627,1,85,-2.0,-1.4117647058823528,85,0
22400627,2,210,2.0,0.5714285714285715,720,510
22400627,2,63,-2.0,-1.9047619047619047,510,447
22400627,2,123,1.0,0.48780487804878053,443,320
22400627,2,132,-2.0,-0.9090909090909092,320,188
22400627,2,188,4.0,1.2765957446808511,188,0
22400627,3,310,9.0,1.7419354838709677,720,410
22400627,3,56,-2.0,-2.142857142857143,394,338
22400627,3,49,-2.0,-2.4489795918367343,331,282
22400627,3,83,3.0,2.1686746987951806,275,192
22400627,3,179,4.0,1.340782122905028,179,0
22400627,4,141,8.0,3.404255319148936,720,579
22400627,4,93,2.0,1.2903225806451615,562,469
22400627,4,103,-7.0,-4.077669902912621,465,362
22400627,4,110,2.0,1.0909090909090908,343,233
22400627,4,149,2.0,0.8053691275167785,225,76
22400627,4,67,3.0,2.6865671641791042,67,0
22400628,1,226,-8.0,-2.1238938053097343,720,494
22400628,1,63,-3.0,-2.8571428571428568,489,426
22400628,1,22,0.0,0.0,414,392
22400628,1,84,-2.0,-1.4285714285714284,376,292
22400628,1,47,2.0,2.5531914893617023,274,227
22400628,1,18,0.0,0.0,215,197
22400628,1,25,2.0,4.8,187,162
22400628,1,134,1.0,0.44776119402985076,162,28
22400628,1,26,0.0,0.0,28,2
22400628,1,2,0.0,0.0,2,0
22400628,2,148,2.0,0.8108108108108109,720,572
22400628,2,30,0.0,0.0,559,529
22400628,2,24,1.0,2.5,492,468
22400628,2,51,5.0,5.88235294117647,468,417
22400628,2,93,3.0,1.935483870967742,401,308
22400628,2,57,0.0,0.0,297,240
22400628,2,11,-1.0,-5.454545454545455,226,215
22400628,2,86,-5.0,-3.488372093023256,215,129
22400628,2,110,3.0,1.6363636363636362,117,7
22400628,2,2,0.0,0.0,2,0
22400628,3,236,3.0,0.7627118644067797,720,484
22400628,3,55,0.0,0.0,472,417
22400628,3,110,2.0,1.0909090909090908,417,307
22400628,3,64,2.0,1.875,307,243
22400628,3,20,0.0,0.0,243,223
22400628,3,87,9.0,6.206896551724138,213,126
22400628,3,2,0.0,0.0,101,99
22400628,4,69,0.0,0.0,720,651
22400628,4,46,0.0,0.0,648,602
22400628,4,31,0.0,0.0,587,556
22400628,4,16,0.0,0.0,550,534
22400628,4,53,0.0,0.0,525,472
22400628,4,37,1.0,1.6216216216216217,472,435
22400628,4,74,2.0,1.6216216216216217,435,361
22400628,4,24,3.0,7.5,361,337
22400628,4,118,4.0,2.0338983050847457,301,183
22400628,4,150,-2.0,-0.8,150,0
22400629,1,332,-1.0,-0.18072289156626506,720,388
22400629,1,182,4.0,1.3186813186813189,373,191
22400629,1,20,0.0,0.0,178,158
22400629,1,81,3.0,2.2222222222222223,150,69
22400629,1,69,2.0,1.7391304347826086,69,0
22400629,2,149,-2.0,-0.8053691275167785,720,571
22400629,2,13,1.0,4.615384615384616,559,546
22400629,2,39,1.0,1.5384615384615383,546,507
22400629,2,34,2.0,3.5294117647058822,507,473
22400629,2,110,1.0,0.5454545454545454,451,341
22400629,2,34,0.0,0.0,333,299
22400629,2,219,4.0,1.095890410958904,281,62
22400629,2,34,0.0,0.0,42,8
22400629,2,8,0.0,0.0,8,0
22400629,3,390,-7.0,-1.0769230769230769,720,330
22400629,3,36,0.0,0.0,330,294
22400629,3,53,4.0,4.528301886792453,294,241
22400629,3,128,2.0,0.9375,234,106
22400629,3,83,-3.0,-2.1686746987951806,83,0
22400629,4,187,10.0,3.2085561497326203,720,533
22400629,4,73,-1.0,-0.821917808219178,525,452
22400629,4,48,0.0,0.0,436,388
22400629,4,64,-2.0,-1.875,380,316
22400629,4,83,0.0,0.0,309,226
22400629,4,20,3.0,9.0,226,206
22400629,4,189,-5.0,-1.5873015873015872,189,0
22400630,1,289,0.0,0.0,720,431
22400630,1,2,0.0,0.0,421,419
22400630,1,83,6.0,4.337349397590361,395,312
22400630,1,23,2.0,5.217391304347826,302,279
22400630,1,48,-2.0,-2.5,265,217
22400630,1,39,0.0,0.0,200,161
22400630,2,145,5.0,2.0689655172413794,720,575
22400630,2,91,-7.0,-4.615384615384616,558,467
22400630,2,34,2.0,3.5294117647058822,457,423
22400630,2,70,-3.0,-2.5714285714285716,423,353
22400630,2,44,-2.0,-2.7272727272727275,328,284
22400630,2,133,2.0,0.9022556390977443,284,151
22400630,2,23,0.0,0.0,137,114
22400630,2,114,3.0,1.5789473684210527,114,0
22400630,3,298,-8.0,-1.610738255033557,720,422
22400630,3,48,1.0,1.25,417,369
22400630,3,78,3.0,2.307692307692308,369,291
22400630,3,25,0.0,0.0,283,258
22400630,3,20,2.0,6.0,237,217
22400630,3,48,-1.0,-1.25,217,169
22400630,3,83,1.0,0.7228915662650602,169,86
22400630,4,173,-1.0,-0.3468208092485549,720,547
22400630,4,38,0.0,0.0,547,509
22400630,4,14,0.0,0.0,501,487
22400630,4,159,-7.0,-2.641509433962264,487,328
22400630,4,167,0.0,0.0,328,161
22400630,4,72,1.0,0.8333333333333333,161,89
22400630,4,59,0.0,0.0,89,30
22400630,4,11,1.0,5.454545454545455,28,17
22400630,4,14,2.0,8.571428571428571,14,0
22400631,1,306,-4.0,-0.7843137254901961,720,414
22400631,1,68,0.0,0.0,399,331
22400631,1,53,-3.0,-3.3962264150943398,331,278
22400631,1,16,0.0,0.0,265,249
22400631,1,24,-3.0,-7.5,249,225
22400631,1,194,10.0,3.092783505154639,221,27
22400631,1,8,1.0,7.5,8,0
22400631,2,35,-3.0,-5.142857142857143,720,685
22400631,2,145,0.0,0.0,673,528
22400631,2,11,-4.0,-21.81818181818182,511,500
22400631,2,35,3.0,5.142857142857143,500,465
22400631,2,75,2.0,1.6,445,370
22400631,2,76,-2.0,-1.5789473684210527,357,281
22400631,2,103,3.0,1.7475728155339807,281,178
22400631,2,43,0.0,0.0,178,135
22400631,2,135,-5.0,-2.2222222222222223,135,0
22400631,3,287,2.0,0.4181184668989547,720,433
22400631,3,127,2.0,0.9448818897637795,414,287
22400631,3,95,-3.0,-1.8947368421052633,287,192
22400631,3,24,1.0,2.5,180,156
22400631,3,49,-1.0,-1.2244897959183672,156,107
22400631,3,107,-1.0,-0.5607476635514018,107,0
22400631,4,179,1.0,0.335195530726257,720,541
22400631,4,114,0.0,0.0,529,415
22400631,4,19,-6.0,-18.94736842105263,409,390
22400631,4,82,7.0,5.121951219512195,377,295
22400631,4,109,5.0,2.7522935779816518,295,186
22400631,4,53,0.0,0.0,186,133
22400631,4,122,-5.0,-2.4590163934426226,133,11
22400631,4,2,1.0,30.0,9,7
22400631,4,6,-3.0,-30.0,7,1
22400631,4,1,0.0,0.0,1,0
22400632,1,242,5.0,1.2396694214876034,720,478
22400632,1,128,1.0,0.46875,478,350
22400632,1,38,0.0,0.0,336,298
22400632,1,39,2.0,3.0769230769230766,286,247
22400632,1,153,-1.0,-0.39215686274509803,247,94
22400632,1,20,0.0,0.0,85,65
22400632,1,52,2.0,2.307692307692308,52,0
22400632,2,115,-1.0,-0.5217391304347826,720,605
22400632,2,25,-2.0,-4.8,600,575
22400632,2,175,2.0,0.6857142857142857,575,400
22400632,2,74,-3.0,-2.4324324324324325,400,326
22400632,2,71,2.0,1.6901408450704225,310,239
22400632,2,59,5.0,5.084745762711864,215,156
22400632,2,155,-10.0,-3.870967741935484,156,1
22400632,2,1,0.0,0.0,1,0
22400632,3,311,14.0,2.7009646302250805,720,409
22400632,3,67,0.0,0.0,393,326
22400632,3,12,-1.0,-5.0,326,314
22400632,3,67,2.0,1.791044776119403,314,247
22400632,3,91,-3.0,-1.978021978021978,223,132
22400632,3,101,2.0,1.188118811881188,110,9
22400632,3,9,0.0,0.0,9,0
22400632,4,185,5.0,1.6216216216216217,720,535
22400632,4,50,0.0,0.0,533,483
22400632,4,59,4.0,4.067796610169491,462,403
22400632,4,38,2.0,3.1578947368421053,383,345
22400632,4,167,3.0,1.0778443113772456,326,159
22400632,4,1,0.0,0.0,138,137
22400632,4,130,-2.0,-0.9230769230769231,135,5
22400633,1,406,-2.0,-0.2955665024630542,720,314
22400633,1,98,0.0,0.0,303,205
22400633,1,60,-2.0,-2.0,192,132
22400633,1,71,1.0,0.8450704225352113,126,55
22400633,1,41,-1.0,-1.4634146341463414,41,0
22400633,2,119,-2.0,-1.0084033613445378,720,601
22400633,2,17,3.0,10.588235294117649,587,570
22400633,2,62,1.0,0.967741935483871,559,497
22400633,2,73,3.0,2.4657534246575343,497,424
22400633,2,80,-1.0,-0.75,424,344
22400633,2,24,-3.0,-7.5,344,320
22400633,2,2,0.0,0.0,314,312
22400633,2,131,-1.0,-0.4580152671755725,306,175
22400633,2,175,-9.0,-3.085714285714286,175,0
22400633,3,293,10.0,2.0477815699658706,720,427
22400633,3,75,1.0,0.8,427,352
22400633,3,25,1.0,2.4,352,327
22400633,3,125,0.0,0.0,327,202
22400633,3,146,-8.0,-3.287671232876712,173,27
22400633,4,224,-6.0,-1.607142857142857,720,496
22400633,4,47,-2.0,-2.5531914893617023,483,436
22400633,4,62,-4.0,-3.870967741935484,416,354
22400633,4,61,1.0,0.9836065573770493,334,273
22400633,4,58,-2.0,-2.0689655172413794,273,215
22400633,4,50,1.0,1.2,184,134
22400633,4,36,0.0,0.0,131,95
22400633,4,95,-6.0,-3.7894736842105265,95,0
22400634,1,392,3.0,0.45918367346938777,720,328
22400634,1,131,-1.0,-0.4580152671755725,316,185
22400634,1,149,2.0,0.8053691275167785,171,22
22400634,1,2,0.0,0.0,2,0
22400634,2,149,2.0,0.8053691275167785,720,571
22400634,2,83,-6.0,-4.337349397590361,553,470
22400634,2,14,1.0,4.285714285714286,456,442
22400634,2,71,2.0,1.6901408450704225,442,371
22400634,2,64,1.0,0.9375,357,293
22400634,2,117,2.0,1.0256410256410258,279,162
22400634,2,150,-1.0,-0.4,150,0
22400634,3,306,5.0,0.9803921568627452,720,414
22400634,3,9,0.0,0.0,399,390
22400634,3,15,0.0,0.0,377,362
22400634,3,131,3.0,1.3740458015267176,362,231
22400634,3,19,0.0,0.0,217,198
22400634,3,186,-4.0,-1.2903225806451615,186,0
22400634,4,155,1.0,0.3870967741935484,720,565
22400634,4,96,2.0,1.25,552,456
22400634,4,4,2.0,30.0,447,443
22400634,4,115,2.0,1.0434782608695652,438,323
22400634,4,35,3.0,5.142857142857143,302,267
22400634,4,259,1.0,0.23166023166023167,259,0
22400635,1,239,6.0,1.506276150627615,720,481
22400635,1,93,-1.0,-0.6451612903225807,481,388
22400635,1,76,-5.0,-3.9473684210526314,388,312
22400635,1,21,1.0,2.8571428571428568,302,281
22400635,1,17,0.0,0.0,268,251
22400635,1,19,2.0,6.315789473684211,251,232
22400635,1,131,-2.0,-0.916030534351145,220,89
22400635,1,13,0.0,0.0,89,76
22400635,1,58,2.0,2.0689655172413794,58,0
22400635,2,100,-8.0,-4.8,720,620
22400635,2,25,0.0,0.0,613,588
22400635,2,125,2.0,0.96,580,455
22400635,2,63,-3.0,-2.8571428571428568,449,386
22400635,2,86,-2.0,-1.3953488372093024,371,285
22400635,2,22,0.0,0.0,285,263
22400635,2,101,-1.0,-0.594059405940594,255,154
22400635,2,86,0.0,0.0,141,55
22400635,2,55,3.0,3.2727272727272725,55,0
22400635,3,227,1.0,0.2643171806167401,720,493
22400635,3,1,0.0,0.0,485,484
22400635,3,60,-2.0,-2.0,479,419
22400635,3,125,-3.0,-1.44,419,294
22400635,3,19,-2.0,-6.315789473684211,277,258
22400635,3,26,0.0,0.0,240,214
22400635,3,16,0.0,0.0,212,196
22400635,3,190,-1.0,-0.3157894736842105,196,6
22400635,4,276,5.0,1.0869565217391304,720,444
22400635,4,41,0.0,0.0,431,390
22400635,4,134,2.0,0.8955223880597015,381,247
22400635,4,154,0.0,0.0,247,93
22400635,4,23,0.0,0.0,93,70
22400635,4,49,0.0,0.0,49,0
22400636,1,357,-6.0,-1.0084033613445378,720,363
22400636,1,24,0.0,0.0,355,331
22400636,1,23,-1.0,-2.608695652173913,321,298
22400636,1,30,0.0,0.0,298,268
22400636,1,102,0.0,0.0,268,166
22400636,1,93,1.0,0.6451612903225807,144,51
22400636,1,51,-3.0,-3.5294117647058822,51,0
22400636,2,159,5.0,1.8867924528301887,720,561
22400636,2,60,-4.0,-4.0,549,489
22400636,2,24,1.0,2.5,470,446
22400636,2,75,0.0,0.0,446,371
22400636,2,100,-4.0,-2.4,371,271
22400636,2,23,0.0,0.0,253,230
22400636,2,26,-1.0,-2.307692307692308,227,201
22400636,2,44,-1.0,-1.3636363636363638,201,157
22400636,2,96,2.0,1.25,157,61
22400636,2,61,3.0,2.9508196721311473,61,0
22400636,3,341,2.0,0.3519061583577713,720,379
22400636,3,55,-5.0,-5.454545454545455,360,305
22400636,3,49,2.0,2.4489795918367343,283,234
22400636,3,1,0.0,0.0,203,202
22400636,3,78,-3.0,-2.307692307692308,194,116
22400636,3,43,-5.0,-6.976744186046512,98,55
22400636,3,25,0.0,0.0,47,22
22400636,3,22,-2.0,-5.454545454545455,22,0
22400636,4,171,-2.0,-0.7017543859649122,720,549
22400636,4,23,0.0,0.0,545,522
22400636,4,69,3.0,2.608695652173913,522,453
22400636,4,64,-2.0,-1.875,453,389
22400636,4,67,-1.0,-0.8955223880597015,369,302
22400636,4,258,6.0,1.3953488372093024,302,44
22400636,4,2,-1.0,-30.0,38,36
22400636,4,36,1.0,1.6666666666666665,36,0
22400637,1,157,0.0,0.0,720,563
22400637,1,81,2.0,1.4814814814814814,553,472
22400637,1,69,-4.0,-3.4782608695652173,466,397
22400637,1,94,1.0,0.6382978723404256,397,303
22400637,1,90,0.0,0.0,285,195
22400637,1,129,5.0,2.3255813953488373,195,66
22400637,1,53,6.0,6.7924528301886795,53,0
22400637,2,136,5.0,2.2058823529411766,720,584
22400637,2,116,2.0,1.0344827586206897,541,425
22400637,2,142,1.0,0.4225352112676056,411,269
22400637,2,103,5.0,2.912621359223301,269,166
22400637,2,110,0.0,0.0,155,45
22400637,2,39,3.0,4.615384615384616,39,0
22400637,3,268,3.0,0.6716417910447761,720,452
22400637,3,52,-4.0,-4.615384615384616,445,393
22400637,3,109,-1.0,-0.5504587155963303,384,275
22400637,3,59,-3.0,-3.050847457627119,275,216
22400637,3,104,8.0,4.615384615384616,210,106
22400637,3,94,4.0,2.5531914893617023,94,0
22400637,4,175,-3.0,-1.0285714285714287,720,545
22400637,4,122,-3.0,-1.4754098360655736,545,423
22400637,4,74,-4.0,-3.2432432432432434,418,344
22400637,4,20,3.0,9.0,333,313
22400637,4,125,4.0,1.92,313,188
22400637,4,174,7.0,2.413793103448276,174,0
22400638,1,319,-2.0,-0.37617554858934166,720,401
22400638,1,65,-2.0,-1.8461538461538463,392,327
22400638,1,51,-1.0,-1.1764705882352942,325,274
22400638,1,20,0.0,0.0,274,254
22400638,1,46,0.0,0.0,239,193
22400638,1,13,0.0,0.0,176,163
22400638,1,45,-1.0,-1.3333333333333335,163,118
22400638,1,28,-4.0,-8.571428571428571,118,90
22400638,2,123,4.0,1.9512195121951221,720,597
22400638,2,36,1.0,1.6666666666666665,588,552
22400638,2,53,-2.0,-2.2641509433962264,552,499
22400638,2,173,2.0,0.6936416184971098,499,326
22400638,2,17,0.0,0.0,326,309
22400638,2,232,11.0,2.8448275862068964,309,77
22400638,2,34,-5.0,-8.823529411764707,60,26
22400638,2,26,0.0,0.0,26,0
22400638,3,108,0.0,0.0,720,612
22400638,3,24,-2.0,-5.0,605,581
22400638,3,145,0.0,0.0,581,436
22400638,3,353,-3.0,-0.509915014164306,624,271
22400638,3,47,4.0,5.1063829787234045,256,209
22400638,3,1,0.0,0.0,194,193
22400638,3,83,2.0,1.4457831325301205,164,81
22400638,3,10,0.0,0.0,73,63
22400638,3,56,0.0,0.0,63,7
22400638,3,1,0.0,0.0,1,0
22400638,4,99,9.0,5.454545454545455,720,621
22400638,4,114,9.0,4.7368421052631575,607,493
22400638,4,15,0.0,0.0,475,460
22400638,4,92,1.0,0.6521739130434783,453,361
22400638,4,116,-6.0,-3.103448275862069,361,245
22400638,4,191,2.0,0.6282722513089005,232,41
22400638,4,24,0.0,0.0,41,17
22400639,1,300,5.0,1.0,720,420
22400639,1,23,2.0,5.217391304347826,415,392
22400639,1,35,0.0,0.0,383,348
22400639,1,40,2.0,3.0,344,304
22400639,1,108,3.0,1.6666666666666665,304,196
22400639,1,159,-7.0,-2.641509433962264,189,30
22400639,2,85,-2.0,-1.4117647058823528,720,635
22400639,2,67,-2.0,-1.791044776119403,635,568
22400639,2,24,0.0,0.0,559,535
22400639,2,4,-4.0,-60.0,526,522
22400639,2,169,4.0,1.4201183431952662,505,336
22400639,2,91,-2.0,-1.3186813186813189,319,228
22400639,2,55,-1.0,-1.0909090909090908,228,173
22400639,2,94,-2.0,-1.2765957446808511,173,79
22400639,2,18,0.0,0.0,40,22
22400639,3,52,0.0,0.0,720,668
22400639,3,302,-6.0,-1.1920529801324504,652,350
22400639,3,76,0.0,0.0,350,274
22400639,3,32,-1.0,-1.875,274,242
22400639,3,34,-1.0,-1.7647058823529411,235,201
22400639,3,87,0.0,0.0,180,93
22400639,3,75,-2.0,-1.6,75,0
22400639,4,116,6.0,3.103448275862069,720,604
22400639,4,68,-4.0,-3.5294117647058822,604,536
22400639,4,69,-2.0,-1.7391304347826086,536,467
22400639,4,37,0.0,0.0,443,406
22400639,4,57,1.0,1.0526315789473684,395,338
22400639,4,91,-4.0,-2.6373626373626378,326,235
22400639,4,40,-1.0,-1.5,235,195
22400639,4,34,-2.0,-3.5294117647058822,195,161
22400640,1,311,-3.0,-0.5787781350482315,720,409
22400640,1,142,-2.0,-0.8450704225352113,405,263
22400640,1,57,-2.0,-2.1052631578947367,254,197
22400640,1,88,-1.0,-0.6818181818181819,186,98
22400640,1,64,-2.0,-1.875,98,34
22400640,1,14,-2.0,-8.571428571428571,14,0
22400640,2,277,-2.0,-0.4332129963898917,720,443
22400640,2,71,-3.0,-2.535211267605634,267,196
22400640,2,58,-3.0,-3.103448275862069,184,126
22400640,2,118,-4.0,-2.0338983050847457,118,0
22400640,3,294,1.0,0.20408163265306123,720,426
22400640,3,85,4.0,2.8235294117647056,426,341
22400640,3,49,2.0,2.4489795918367343,332,283
22400640,3,94,0.0,0.0,283,189
22400640,3,9,0.0,0.0,172,163
22400640,3,36,-4.0,-6.666666666666666,152,116
22400640,3,73,-5.0,-4.10958904109589,116,43
22400640,3,19,0.0,0.0,43,24
22400640,3,8,2.0,15.0,8,0
22400640,4,131,2.0,0.916030534351145,720,589
22400640,4,6,2.0,20.0,582,576
22400640,4,91,-2.0,-1.3186813186813189,576,485
22400640,4,39,-1.0,-1.5384615384615383,473,434
22400640,4,72,5.0,4.166666666666667,434,362
22400640,4,66,-1.0,-0.9090909090909092,362,296
22400640,4,54,3.0,3.333333333333333,296,242
22400640,4,115,6.0,3.1304347826086953,226,111
22400640,4,86,-3.0,-2.0930232558139537,111,25
22400640,4,25,1.0,2.4,25,0
22400641,1,316,1.0,0.18987341772151897,720,404
22400641,1,2,1.0,30.0,378,376
22400641,1,81,-1.0,-0.7407407407407407,376,295
22400641,1,28,5.0,10.714285714285715,283,255
22400641,1,149,4.0,1.610738255033557,241,92
22400641,1,50,0.0,0.0,92,42
22400641,1,42,2.0,2.8571428571428568,42,0
22400641,2,39,2.0,3.0769230769230766,720,681
22400641,2,25,0.0,0.0,667,642
22400641,2,53,2.0,2.2641509433962264,635,582
22400641,2,54,2.0,2.2222222222222223,582,528
22400641,2,70,0.0,0.0,528,458
22400641,2,60,-2.0,-2.0,458,398
22400641,2,180,0.0,0.0,398,218
22400641,2,197,-10.0,-3.045685279187817,206,9
22400641,3,310,-1.0,-0.1935483870967742,720,410
22400641,3,164,-1.0,-0.36585365853658536,405,241
22400641,3,39,2.0,3.0769230769230766,241,202
22400641,3,74,0.0,0.0,192,118
22400641,3,106,5.0,2.8301886792452833,106,0
22400641,4,52,1.0,1.153846153846154,720,668
22400641,4,53,3.0,3.3962264150943398,668,615
22400641,4,16,0.0,0.0,603,587
22400641,4,6,0.0,0.0,579,573
22400641,4,316,9.0,1.7088607594936709,573,257
22400641,4,33,4.0,7.272727272727273,169,136
22400641,4,6,0.0,0.0,126,120
22400641,4,114,-1.0,-0.5263157894736842,114,0
22400642,1,272,3.0,0.661764705882353,720,448
22400642,1,150,4.0,1.6,439,289
22400642,1,103,-1.0,-0.5825242718446602,282,179
22400642,1,116,1.0,0.5172413793103449,168,52
22400642,1,39,0.0,0.0,39,0
22400642,2,102,3.0,1.7647058823529411,720,618
22400642,2,88,-5.0,-3.409090909090909,609,521
22400642,2,173,4.0,1.3872832369942196,521,348
22400642,2,34,0.0,0.0,340,306
22400642,2,30,0.0,0.0,293,263
22400642,2,146,-5.0,-2.054794520547945,263,117
22400642,2,117,-6.0,-3.0769230769230766,117,0
22400642,3,290,1.0,0.20689655172413793,720,430
22400642,3,79,1.0,0.7594936708860759,413,334
22400642,3,80,3.0,2.25,334,254
22400642,3,209,5.0,1.4354066985645932,235,26
22400642,3,26,0.0,0.0,26,0
22400642,4,90,-2.0,-1.3333333333333335,720,630
22400642,4,9,-2.0,-13.333333333333332,623,614
22400642,4,44,0.0,0.0,600,556
22400642,4,66,0.0,0.0,542,476
22400642,4,15,0.0,0.0,465,450
22400642,4,96,-4.0,-2.5,450,354
22400642,4,171,-2.0,-0.7017543859649122,338,167
22400642,4,167,-6.0,-2.155688622754491,167,0
22400643,1,260,9.0,2.076923076923077,720,460
22400643,1,39,1.0,1.5384615384615383,449,410
22400643,1,25,-3.0,-7.199999999999999,398,373
22400643,1,65,-4.0,-3.6923076923076925,373,308
22400643,1,36,-3.0,-5.0,302,266
22400643,1,22,0.0,0.0,254,232
22400643,1,1,0.0,0.0,215,214
22400643,1,207,0.0,0.0,207,0
22400643,2,170,7.0,2.4705882352941178,720,550
22400643,2,111,-2.0,-1.0810810810810811,545,434
22400643,2,22,0.0,0.0,418,396
22400643,2,60,-2.0,-2.0,396,336
22400643,2,187,0.0,0.0,334,147
22400643,2,73,2.0,1.643835616438356,147,74
22400643,2,44,-1.0,-1.3636363636363638,74,30
22400643,2,30,0.0,0.0,30,0
22400643,3,280,8.0,1.7142857142857142,720,440
22400643,3,43,0.0,0.0,416,373
22400643,3,38,3.0,4.7368421052631575,358,320
22400643,3,297,6.0,1.2121212121212122,523,226
22400643,3,28,-1.0,-2.142857142857143,226,198
22400643,3,54,-2.0,-2.2222222222222223,178,124
22400643,3,114,6.0,3.1578947368421053,114,0
22400643,4,337,-2.0,-0.3560830860534125,720,383
22400643,4,12,0.0,0.0,374,362
22400643,4,71,-2.0,-1.6901408450704225,343,272
22400643,4,96,0.0,0.0,256,160
22400643,4,146,-1.0,-0.410958904109589,146,0
22400644,1,299,9.0,1.8060200668896322,720,421
22400644,1,39,-2.0,-3.0769230769230766,400,361
22400644,1,155,-4.0,-1.5483870967741935,340,185
22400644,1,36,0.0,0.0,185,149
22400644,1,28,0.0,0.0,136,108
22400644,1,106,2.0,1.1320754716981132,106,0
22400644,2,150,0.0,0.0,720,570
22400644,2,26,0.0,0.0,570,544
22400644,2,76,0.0,0.0,537,461
22400644,2,89,3.0,2.0224719101123596,446,357
22400644,2,79,-2.0,-1.5189873417721518,357,278
22400644,2,77,-1.0,-0.7792207792207793,270,193
22400644,2,12,-2.0,-10.0,193,181
22400644,2,38,5.0,7.894736842105263,181,143
22400644,2,70,-2.0,-1.7142857142857142,122,52
22400644,2,52,3.0,3.4615384615384617,52,0
22400644,3,265,-5.0,-1.1320754716981132,720,455
22400644,3,12,-1.0,-5.0,436,424
22400644,3,146,-6.0,-2.4657534246575343,424,278
22400644,3,20,-1.0,-3.0,264,244
22400644,3,178,3.0,1.0112359550561798,244,66
22400644,3,54,2.0,2.2222222222222223,54,0
22400644,4,101,0.0,0.0,720,619
22400644,4,75,-5.0,-4.0,607,532
22400644,4,33,-2.0,-3.6363636363636367,519,486
22400644,4,145,-2.0,-0.8275862068965517,478,333
22400644,4,70,4.0,3.4285714285714284,319,249
22400644,4,39,-2.0,-3.0769230769230766,230,191
22400644,4,25,2.0,4.8,181,156
22400644,4,52,0.0,0.0,155,103
22400644,4,61,2.0,1.9672131147540985,85,24
22400644,4,8,0.0,0.0,24,16
22400645,1,109,1.0,0.5504587155963303,720,611
22400645,1,243,4.0,0.9876543209876544,611,368
22400645,1,81,3.0,2.2222222222222223,355,274
22400645,1,35,6.0,10.285714285714286,264,229
22400645,1,37,2.0,3.2432432432432434,212,175
22400645,1,132,-6.0,-2.7272727272727275,135,3
22400645,1,1,0.0,0.0,1,0
22400645,2,193,-3.0,-0.9326424870466321,720,527
22400645,2,67,-1.0,-0.8955223880597015,527,460
22400645,2,69,0.0,0.0,460,391
22400645,2,44,5.0,6.818181818181818,379,335
22400645,2,101,-1.0,-0.594059405940594,327,226
22400645,2,102,2.0,1.1764705882352942,226,124
22400645,2,118,4.0,2.0338983050847457,118,0
22400645,3,369,-1.0,-0.16260162601626016,720,351
22400645,3,93,-4.0,-2.580645161290323,351,258
22400645,3,104,-5.0,-2.8846153846153846,250,146
22400645,3,124,5.0,2.4193548387096775,124,0
22400645,4,231,-3.0,-0.7792207792207793,720,489
22400645,4,70,5.0,4.285714285714286,489,419
22400645,4,127,1.0,0.47244094488188976,401,274
22400645,4,56,-2.0,-2.142857142857143,252,196
22400645,4,187,3.0,0.9625668449197862,187,0
22400646,1,388,-6.0,-0.9278350515463918,720,332
22400646,1,63,-5.0,-4.761904761904762,324,261
22400646,1,64,3.0,2.8125,254,190
22400646,1,9,-1.0,-6.666666666666666,190,181
22400646,1,52,5.0,5.769230769230769,181,129
22400646,1,129,3.0,1.3953488372093024,129,0
22400646,2,79,2.0,1.5189873417721518,720,641
22400646,2,205,0.0,0.0,641,436
22400646,2,2,-1.0,-30.0,431,429
22400646,2,18,0.0,0.0,418,400
22400646,2,115,-3.0,-1.5652173913043477,400,285
22400646,2,79,1.0,0.7594936708860759,285,206
22400646,2,139,0.0,0.0,184,45
22400646,2,39,0.0,0.0,45,6
22400646,2,4,0.0,0.0,6,2
22400646,2,2,2.0,60.0,2,0
22400646,3,263,6.0,1.3688212927756656,720,457
22400646,3,215,-7.0,-1.9534883720930232,440,225
22400646,3,146,4.0,1.643835616438356,225,79
22400646,3,79,3.0,2.278481012658228,79,0
22400646,4,58,-3.0,-3.103448275862069,720,662
22400646,4,188,6.0,1.9148936170212765,662,474
22400646,4,28,2.0,4.285714285714286,474,446
22400646,4,47,6.0,7.659574468085106,432,385
22400646,4,69,-4.0,-3.4782608695652173,376,307
22400646,4,44,2.0,2.7272727272727275,291,247
22400646,4,76,0.0,0.0,247,171
22400646,4,100,-1.0,-0.6,171,71
22400646,4,71,-2.0,-1.6901408450704225,71,0
22400647,1,275,5.0,1.0909090909090908,720,445
22400647,1,27,0.0,0.0,437,410
22400647,1,56,2.0,2.142857142857143,393,337
22400647,1,154,-3.0,-1.1688311688311688,323,169
22400647,1,14,-1.0,-4.285714285714286,169,155
22400647,1,140,0.0,0.0,140,0
22400647,2,218,-6.0,-1.651376146788991,720,502
22400647,2,49,-4.0,-4.897959183673469,502,453
22400647,2,74,-2.0,-1.6216216216216217,453,379
22400647,2,66,-2.0,-1.8181818181818183,379,313
22400647,2,17,1.0,3.5294117647058822,297,280
22400647,2,116,4.0,2.0689655172413794,280,164
22400647,2,60,4.0,4.0,164,104
22400647,2,20,-2.0,-6.0,104,84
22400647,2,51,-2.0,-2.3529411764705883,84,33
22400647,2,33,0.0,0.0,33,0
22400647,3,251,3.0,0.7171314741035857,720,469
22400647,3,71,2.0,1.6901408450704225,469,398
22400647,3,100,-2.0,-1.2,381,281
22400647,3,41,-2.0,-2.926829268292683,278,237
22400647,3,124,-2.0,-0.967741935483871,223,99
22400647,3,99,-1.0,-0.6060606060606061,99,0
22400647,4,94,7.0,4.468085106382978,720,626
22400647,4,148,-1.0,-0.40540540540540543,626,478
22400647,4,3,0.0,0.0,470,467
22400647,4,34,1.0,1.7647058823529411,455,421
22400647,4,50,-3.0,-3.5999999999999996,421,371
22400647,4,46,3.0,3.9130434782608696,358,312
22400647,4,15,1.0,4.0,312,297
22400647,4,197,-1.0,-0.3045685279187817,244,47
22400647,4,47,2.0,2.5531914893617023,47,0
22400648,1,327,-13.0,-2.385321100917431,720,393
22400648,1,61,-3.0,-2.9508196721311473,380,319
22400648,1,248,0.0,0.0,316,68
22400648,2,108,3.0,1.6666666666666665,720,612
22400648,2,84,3.0,2.142857142857143,606,522
22400648,2,55,0.0,0.0,385,330
22400648,2,46,0.0,0.0,310,264
22400648,2,45,2.0,2.666666666666667,255,210
22400648,2,158,3.0,1.139240506329114,190,32
22400648,2,7,0.0,0.0,7,0
22400648,3,147,-1.0,-0.40816326530612246,720,573
22400648,3,152,0.0,0.0,573,421
22400648,3,153,-2.0,-0.7843137254901961,421,268
22400648,3,20,0.0,0.0,268,248
22400648,3,64,-2.0,-1.875,248,184
22400648,3,237,-1.0,-0.2531645569620253,373,136
22400648,3,74,4.0,3.2432432432432434,136,62
22400648,3,49,-1.0,-1.2244897959183672,49,0
22400648,4,50,4.0,4.8,720,670
22400648,4,168,0.0,0.0,660,492
22400648,4,35,-1.0,-1.7142857142857142,467,432
22400648,4,59,0.0,0.0,398,339
22400648,4,24,-2.0,-5.0,330,306
22400648,4,79,-4.0,-3.0379746835443036,306,227
22400648,4,203,8.0,2.3645320197044337,213,10
22400648,4,8,0.0,0.0,8,0
22400649,1,266,0.0,0.0,720,454
22400649,1,58,0.0,0.0,439,381
22400649,1,130,3.0,1.3846153846153846,373,243
22400649,1,81,0.0,0.0,243,162
22400649,1,158,-3.0,-1.139240506329114,158,0
22400649,2,81,0.0,0.0,720,639
22400649,2,54,-3.0,-3.333333333333333,624,570
22400649,2,49,0.0,0.0,555,506
22400649,2,54,2.0,2.2222222222222223,498,444
22400649,2,36,0.0,0.0,435,399
22400649,2,54,-3.0,-3.333333333333333,396,342
22400649,2,54,4.0,4.444444444444445,342,288
22400649,2,45,0.0,0.0,271,226
22400649,2,60,3.0,3.0,226,166
22400649,2,166,0.0,0.0,166,0
22400649,3,266,3.0,0.6766917293233082,720,454
22400649,3,70,2.0,1.7142857142857142,445,375
22400649,3,42,-2.0,-2.8571428571428568,375,333
22400649,3,66,3.0,2.7272727272727275,317,251
22400649,3,161,-3.0,-1.1180124223602486,241,80
22400649,3,80,2.0,1.5,80,0
22400649,4,110,2.0,1.0909090909090908,720,610
22400649,4,85,-2.0,-1.4117647058823528,593,508
22400649,4,13,0.0,0.0,502,489
22400649,4,11,0.0,0.0,482,471
22400649,4,53,-3.0,-3.3962264150943398,466,413
22400649,4,29,0.0,0.0,413,384
22400649,4,79,0.0,0.0,369,290
22400649,4,10,3.0,18.0,265,255
22400649,4,32,-3.0,-5.625,234,202
22400650,1,374,1.0,0.16042780748663102,720,346
22400650,1,32,2.0,3.75,336,304
22400650,1,61,-5.0,-4.918032786885245,304,243
22400650,1,104,-5.0,-2.8846153846153846,232,128
22400650,1,2,0.0,0.0,116,114
22400650,1,29,-1.0,-2.0689655172413794,104,75
22400650,1,75,3.0,2.4,75,0
22400650,2,122,1.0,0.49180327868852464,720,598
22400650,2,9,0.0,0.0,564,555
22400650,2,33,0.0,0.0,548,515
22400650,2,30,2.0,4.0,501,471
22400650,2,65,-3.0,-2.769230769230769,465,400
22400650,2,142,-6.0,-2.535211267605634,383,241
22400650,2,23,3.0,7.826086956521739,241,218
22400650,2,112,3.0,1.607142857142857,201,89
22400650,2,33,0.0,0.0,66,33
22400650,2,16,0.0,0.0,22,6
22400650,3,358,-4.0,-0.670391061452514,720,362
22400650,3,7,0.0,0.0,362,355
22400650,3,40,2.0,3.0,349,309
22400650,3,15,0.0,0.0,309,294
22400650,3,61,2.0,1.9672131147540985,294,233
22400650,3,19,0.0,0.0,216,197
22400650,3,65,2.0,1.8461538461538463,197,132
22400650,3,94,0.0,0.0,132,38
22400650,3,38,2.0,3.1578947368421053,38,0
22400650,4,92,7.0,4.565217391304348,720,628
22400650,4,147,-2.0,-0.8163265306122449,618,471
22400650,4,51,-3.0,-3.5294117647058822,450,399
22400650,4,133,-1.0,-0.45112781954887216,399,266
22400650,4,38,-2.0,-3.1578947368421053,254,216
22400650,4,18,0.0,0.0,209,191
22400650,4,173,-3.0,-1.0404624277456647,188,15
22400650,4,4,0.0,0.0,4,0
22400651,1,298,-3.0,-0.6040268456375839,720,422
22400651,1,64,-2.0,-1.875,422,358
22400651,1,40,0.0,0.0,349,309
22400651,1,17,0.0,0.0,295,278
22400651,1,43,0.0,0.0,262,219
22400651,1,69,2.0,1.7391304347826086,207,138
22400651,1,99,7.0,4.242424242424242,123,24
22400651,1,2,0.0,0.0,2,0
22400651,2,99,2.0,1.2121212121212122,720,621
22400651,2,16,-2.0,-7.5,605,589
22400651,2,46,0.0,0.0,577,531
22400651,2,20,1.0,3.0,514,494
22400651,2,54,-4.0,-4.444444444444445,494,440
22400651,2,62,-4.0,-3.870967741935484,422,360
22400651,2,41,0.0,0.0,344,303
22400651,2,20,0.0,0.0,303,283
22400651,2,63,2.0,1.9047619047619047,283,220
22400651,2,27,-2.0,-4.444444444444445,220,193
22400651,2,82,2.0,1.4634146341463414,193,111
22400651,2,55,1.0,1.0909090909090908,102,47
22400651,2,44,0.0,0.0,47,3
22400651,3,59,-2.0,-2.0338983050847457,720,661
22400651,3,155,-4.0,-1.5483870967741935,661,506
22400651,3,32,-2.0,-3.75,506,474
22400651,3,88,5.0,3.409090909090909,463,375
22400651,3,224,-3.0,-0.8035714285714285,375,151
22400651,3,30,1.0,2.0,151,121
22400651,3,60,-1.0,-1.0,121,61
22400651,3,6,0.0,0.0,40,34
22400651,3,7,0.0,0.0,34,27
22400651,3,10,0.0,0.0,10,0
22400651,4,49,-4.0,-4.897959183673469,720,671
22400651,4,52,2.0,2.307692307692308,654,602
22400651,4,82,-3.0,-2.195121951219512,589,507
22400651,4,77,-4.0,-3.116883116883117,495,418
22400651,4,46,-4.0,-5.217391304347826,412,366
22400651,4,5,0.0,0.0,342,337
22400651,4,28,2.0,4.285714285714286,321,293
22400651,4,65,-3.0,-2.769230769230769,273,208
22400651,4,161,-3.0,-1.1180124223602486,208,47
22400651,4,44,3.0,4.090909090909091,44,0
22400652,1,190,4.0,1.263157894736842,720,530
22400652,1,162,9.0,3.333333333333333,530,368
22400652,1,74,-3.0,-2.4324324324324325,349,275
22400652,1,35,-2.0,-3.4285714285714284,263,228
22400652,1,87,-1.0,-0.6896551724137931,228,141
22400652,1,99,0.0,0.0,123,24
22400652,1,24,-1.0,-2.5,24,0
22400652,2,162,-8.0,-2.962962962962963,720,558
22400652,2,2,0.0,0.0,558,556
22400652,2,122,4.0,1.9672131147540985,545,423
22400652,2,74,-3.0,-2.4324324324324325,423,349
22400652,2,66,3.0,2.7272727272727275,340,274
22400652,2,28,1.0,2.142857142857143,266,238
22400652,2,32,2.0,3.75,238,206
22400652,2,15,0.0,0.0,206,191
22400652,2,68,0.0,0.0,183,115
22400652,2,115,0.0,0.0,115,0
22400652,3,343,1.0,0.1749271137026239,720,377
22400652,3,17,1.0,3.5294117647058822,377,360
22400652,3,63,2.0,1.9047619047619047,346,283
22400652,3,98,-3.0,-1.836734693877551,283,185
22400652,3,129,-6.0,-2.7906976744186047,162,33
22400652,3,33,0.0,0.0,33,0
22400652,4,149,-2.0,-0.8053691275167785,720,571
22400652,4,61,1.0,0.9836065573770493,558,497
22400652,4,17,0.0,0.0,497,480
22400652,4,230,-1.0,-0.2608695652173913,480,250
22400652,4,71,5.0,4.225352112676057,250,179
22400652,4,122,0.0,0.0,159,37
22400652,4,28,0.0,0.0,28,0
22400652,5,299,0.0,0.0,300,1
22400652,5,1,0.0,0.0,1,0
22400652,6,147,-1.0,-0.40816326530612246,300,153
22400652,6,55,3.0,3.2727272727272725,150,95
22400652,6,82,2.0,1.4634146341463414,82,0
22400653,1,295,7.0,1.423728813559322,720,425
22400653,1,91,3.0,1.978021978021978,413,322
22400653,1,22,2.0,5.454545454545455,307,285
22400653,1,35,-1.0,-1.7142857142857142,270,235
22400653,1,30,-4.0,-8.0,219,189
22400653,1,30,-2.0,-4.0,189,159
22400653,1,39,-5.0,-7.692307692307692,147,108
22400653,1,77,0.0,0.0,100,23
22400653,1,16,-2.0,-7.5,16,0
22400653,2,108,8.0,4.444444444444445,720,612
22400653,2,104,0.0,0.0,593,489
22400653,2,12,-2.0,-10.0,474,462
22400653,2,63,-2.0,-1.9047619047619047,440,377
22400653,2,44,3.0,4.090909090909091,344,300
22400653,2,53,2.0,2.2641509433962264,287,234
22400653,2,95,-5.0,-3.1578947368421053,225,130
22400653,2,66,2.0,1.8181818181818183,130,64
22400653,2,60,0.0,0.0,60,0
22400653,3,309,7.0,1.3592233009708738,720,411
22400653,3,110,8.0,4.363636363636363,402,292
22400653,3,115,3.0,1.5652173913043477,275,160
22400653,3,36,1.0,1.6666666666666665,147,111
22400653,3,87,-4.0,-2.7586206896551726,111,24
22400653,4,225,6.0,1.6,713,488
22400653,4,35,5.0,8.571428571428571,273,238
22400653,4,480,0.0,0.0,715,235
22400653,4,90,1.0,0.6666666666666667,227,137
22400653,4,25,2.0,4.8,137,112
22400653,4,112,5.0,2.678571428571429,112,0
22400654,1,247,2.0,0.4858299595141701,720,473
22400654,1,99,4.0,2.4242424242424243,466,367
22400654,1,2,0.0,0.0,344,342
22400654,1,131,1.0,0.4580152671755725,342,211
22400654,1,33,-1.0,-1.8181818181818183,152,119
22400654,1,74,-1.0,-0.8108108108108109,119,45
22400654,1,36,2.0,3.333333333333333,36,0
22400654,2,221,-3.0,-0.8144796380090498,720,499
22400654,2,74,3.0,2.4324324324324325,499,425
22400654,2,36,-2.0,-3.333333333333333,406,370
22400654,2,46,-1.0,-1.3043478260869565,350,304
22400654,2,70,8.0,6.857142857142857,304,234
22400654,2,74,0.0,0.0,220,146
22400654,2,144,6.0,2.5,146,2
22400654,3,276,-8.0,-1.7391304347826086,720,444
22400654,3,105,0.0,0.0,444,339
22400654,3,44,2.0,2.7272727272727275,339,295
22400654,3,61,-1.0,-0.9836065573770493,295,234
22400654,3,56,0.0,0.0,234,178
22400654,3,149,-6.0,-2.4161073825503356,169,20
22400654,3,11,0.0,0.0,11,0
22400654,4,162,8.0,2.962962962962963,720,558
22400654,4,49,3.0,3.673469387755102,542,493
22400654,4,32,2.0,3.75,474,442
22400654,4,85,2.0,1.4117647058823528,431,346
22400654,4,64,-1.0,-0.9375,331,267
22400654,4,10,3.0,18.0,255,245
22400654,4,41,0.0,0.0,234,193
22400654,4,193,-2.0,-0.6217616580310881,193,0
22400655,1,316,1.0,0.18987341772151897,720,404
22400655,1,159,2.0,0.7547169811320755,404,245
22400655,1,74,0.0,0.0,238,164
22400655,1,45,1.0,1.3333333333333335,150,105
22400655,1,88,-2.0,-1.3636363636363638,88,0
22400655,2,24,0.0,0.0,720,696
22400655,2,115,-4.0,-2.0869565217391304,683,568
22400655,2,169,2.0,0.7100591715976331,555,386
22400655,2,152,-2.0,-0.7894736842105263,380,228
22400655,2,202,4.0,1.188118811881188,219,17
22400655,3,357,2.0,0.33613445378151263,720,363
22400655,3,54,-3.0,-3.333333333333333,363,309
22400655,3,53,2.0,2.2641509433962264,309,256
22400655,3,43,0.0,0.0,237,194
22400655,3,11,0.0,0.0,190,179
22400655,3,172,5.0,1.744186046511628,172,0
22400655,4,163,11.0,4.049079754601227,720,557
22400655,4,23,2.0,5.217391304347826,540,517
22400655,4,59,-4.0,-4.067796610169491,514,455
22400655,4,109,1.0,0.5504587155963303,450,341
22400655,4,54,-3.0,-3.333333333333333,325,271
22400655,4,256,2.0,0.46875,256,0
22400656,1,256,8.0,1.875,720,464
22400656,1,52,-2.0,-2.307692307692308,452,400
22400656,1,22,1.0,2.7272727272727275,400,378
22400656,1,30,-2.0,-4.0,378,348
22400656,1,257,-2.0,-0.4669260700389105,568,311
22400656,1,65,2.0,1.8461538461538463,297,232
22400656,1,30,-2.0,-4.0,232,202
22400656,1,67,1.0,0.8955223880597015,186,119
22400656,1,96,-1.0,-0.625,96,0
22400656,2,66,-2.0,-1.8181818181818183,720,654
22400656,2,118,1.0,0.5084745762711864,653,535
22400656,2,35,2.0,3.4285714285714284,523,488
22400656,2,116,-4.0,-2.0689655172413794,483,367
22400656,2,62,3.0,2.903225806451613,354,292
22400656,2,44,3.0,4.090909090909091,282,238
22400656,2,170,-2.0,-0.7058823529411764,238,68
22400656,2,56,3.0,3.214285714285714,56,0
22400656,3,315,-5.0,-0.9523809523809523,720,405
22400656,3,40,0.0,0.0,405,365
22400656,3,50,3.0,3.5999999999999996,337,287
22400656,3,81,-7.0,-5.185185185185185,287,206
22400656,3,21,0.0,0.0,206,185
22400656,3,185,-4.0,-1.2972972972972974,185,0
22400656,4,110,7.0,3.818181818181818,720,610
22400656,4,34,2.0,3.5294117647058822,610,576
22400656,4,92,-2.0,-1.3043478260869565,576,484
22400656,4,38,-4.0,-6.315789473684211,473,435
22400656,4,22,-2.0,-5.454545454545455,420,398
22400656,4,55,-2.0,-2.1818181818181817,381,326
22400656,4,124,-1.0,-0.4838709677419355,326,202
22400656,4,181,-3.0,-0.9944751381215469,202,21
22400656,4,1,0.0,0.0,21,20
22400656,4,12,2.0,10.0,12,0
22400657,1,393,14.0,2.1374045801526718,720,327
22400657,1,33,3.0,5.454545454545455,327,294
22400657,1,175,2.0,0.6857142857142857,274,99
22400657,1,93,1.0,0.6451612903225807,93,0
22400657,2,312,7.0,1.3461538461538463,720,408
22400657,2,272,0.0,0.0,393,121
22400657,2,76,-3.0,-2.3684210526315788,119,43
22400657,3,343,6.0,1.0495626822157436,720,377
22400657,3,56,0.0,0.0,366,310
22400657,3,39,1.0,1.5384615384615383,301,262
22400657,3,20,-2.0,-6.0,262,242
22400657,3,37,-1.0,-1.6216216216216217,242,205
22400657,3,205,-5.0,-1.4634146341463414,205,0
22400657,4,235,-3.0,-0.7659574468085106,720,485
22400657,4,23,3.0,7.826086956521739,480,457
22400657,4,82,1.0,0.7317073170731707,447,365
22400657,4,104,2.0,1.153846153846154,346,242
22400657,4,11,-2.0,-10.90909090909091,237,226
22400657,4,226,-3.0,-0.7964601769911505,226,0
22400658,1,251,-6.0,-1.4342629482071714,720,469
22400658,1,98,-1.0,-0.6122448979591836,459,361
22400658,1,36,3.0,5.0,355,319
22400658,1,104,-5.0,-2.8846153846153846,319,215
22400658,1,49,0.0,0.0,215,166
22400658,1,162,-5.0,-1.8518518518518516,162,0
22400658,2,215,0.0,0.0,720,505
22400658,2,44,-2.0,-2.7272727272727275,498,454
22400658,2,36,3.0,5.0,454,418
22400658,2,51,0.0,0.0,405,354
22400658,2,56,5.0,5.357142857142858,354,298
22400658,2,70,0.0,0.0,250,180
22400658,2,159,-3.0,-1.1320754716981132,159,0
22400658,3,251,-5.0,-1.1952191235059761,720,469
22400658,3,50,-2.0,-2.4,469,419
22400658,3,149,-6.0,-2.4161073825503356,419,270
22400658,3,55,-1.0,-1.0909090909090908,270,215
22400658,3,36,3.0,5.0,215,179
22400658,3,165,1.0,0.36363636363636365,165,0
22400658,4,144,0.0,0.0,720,576
22400658,4,31,3.0,5.806451612903226,561,530
22400658,4,84,2.0,1.4285714285714284,519,435
22400658,4,24,2.0,5.0,427,403
22400658,4,89,3.0,2.0224719101123596,383,294
22400658,4,55,2.0,2.1818181818181817,271,216
22400658,4,143,-5.0,-2.097902097902098,195,52
22400658,4,52,1.0,1.153846153846154,52,0
22400659,1,332,4.0,0.7228915662650602,720,388
22400659,1,71,-3.0,-2.535211267605634,388,317
22400659,1,22,0.0,0.0,310,288
22400659,1,40,5.0,7.5,285,245
22400659,1,159,5.0,1.8867924528301887,235,76
22400659,1,71,3.0,2.535211267605634,71,0
22400659,2,56,2.0,2.142857142857143,720,664
22400659,2,127,4.0,1.889763779527559,657,530
22400659,2,122,0.0,0.0,513,391
22400659,2,100,0.0,0.0,379,279
22400659,2,169,1.0,0.35502958579881655,271,102
22400659,2,57,1.0,1.0526315789473684,78,21
22400659,3,292,-7.0,-1.4383561643835616,720,428
22400659,3,76,-3.0,-2.3684210526315788,428,352
22400659,3,76,1.0,0.7894736842105263,352,276
22400659,3,97,4.0,2.4742268041237114,263,166
22400659,3,43,-5.0,-6.976744186046512,144,101
22400659,3,91,4.0,2.6373626373626378,91,0
22400659,4,101,3.0,1.782178217821782,720,619
22400659,4,34,-1.0,-1.7647058823529411,610,576
22400659,4,66,-2.0,-1.8181818181818183,576,510
22400659,4,102,0.0,0.0,491,389
22400659,4,58,2.0,2.0689655172413794,390,332
22400659,4,72,3.0,2.5,332,260
22400659,4,208,-9.0,-2.5961538461538463,260,52
22400659,4,10,1.0,6.0,29,19
22400659,4,9,1.0,6.666666666666666,19,10
22400659,4,9,-2.0,-13.333333333333332,10,1
22400659,4,1,0.0,0.0,1,0
22400660,1,346,-6.0,-1.0404624277456647,720,374
22400660,1,23,0.0,0.0,374,351
22400660,1,60,1.0,1.0,333,273
22400660,1,115,4.0,2.0869565217391304,273,158
22400660,1,20,2.0,6.0,150,130
22400660,1,13,1.0,4.615384615384616,130,117
22400660,1,97,0.0,0.0,117,20
22400660,1,20,0.0,0.0,20,0
22400660,2,59,1.0,1.0169491525423728,720,661
22400660,2,6,1.0,10.0,658,652
22400660,2,119,-2.0,-1.0084033613445378,652,533
22400660,2,110,4.0,2.1818181818181817,533,423
22400660,2,57,2.0,2.1052631578947367,423,366
22400660,2,104,2.0,1.153846153846154,357,253
22400660,2,29,-2.0,-4.137931034482759,253,224
22400660,2,132,4.0,1.8181818181818183,224,92
22400660,2,92,4.0,2.608695652173913,92,0
22400660,3,330,-3.0,-0.5454545454545454,720,390
22400660,3,20,3.0,9.0,376,356
22400660,3,172,0.0,0.0,344,172
22400660,4,87,0.0,0.0,720,633
22400660,4,148,-1.0,-0.40540540540540543,629,481
22400660,4,76,-2.0,-1.5789473684210527,470,394
22400660,4,20,-2.0,-6.0,394,374
22400660,4,164,2.0,0.7317073170731707,374,210
22400660,4,199,-5.0,-1.5075376884422111,199,0
22400661,1,247,-4.0,-0.9716599190283401,720,473
22400661,1,114,-3.0,-1.5789473684210527,464,350
22400661,1,25,2.0,4.8,338,313
22400661,1,135,2.0,0.888888888888889,288,153
22400661,2,167,5.0,1.7964071856287425,720,553
22400661,2,29,2.0,4.137931034482759,534,505
22400661,2,125,0.0,0.0,485,360
22400661,2,80,-2.0,-1.5,319,239
22400661,2,32,3.0,5.625,233,201
22400661,2,79,2.0,1.5189873417721518,201,122
22400661,2,12,-2.0,-10.0,122,110
22400661,2,86,2.0,1.3953488372093024,92,6
22400661,2,6,0.0,0.0,6,0
22400661,3,199,1.0,0.30150753768844224,720,521
22400661,3,60,3.0,3.0,512,452
22400661,3,46,-2.0,-2.608695652173913,449,403
22400661,3,72,-4.0,-3.333333333333333,403,331
22400661,3,47,3.0,3.829787234042553,331,284
22400661,3,83,1.0,0.7228915662650602,284,201
22400661,3,29,-1.0,-2.0689655172413794,201,172
22400661,3,130,0.0,0.0,155,25
22400661,3,25,-2.0,-4.8,25,0
22400661,4,205,-3.0,-0.8780487804878049,720,515
22400661,4,98,-3.0,-1.836734693877551,515,417
22400661,4,80,1.0,0.75,397,317
22400661,4,125,5.0,2.4,317,192
22400661,4,175,1.0,0.34285714285714286,175,0
22400662,1,260,-2.0,-0.46153846153846156,720,460
22400662,1,75,0.0,0.0,460,385
22400662,1,41,-4.0,-5.853658536585366,378,337
22400662,1,101,3.0,1.782178217821782,337,236
22400662,1,18,0.0,0.0,216,198
22400662,1,21,-2.0,-5.7142857142857135,188,167
22400662,1,144,-1.0,-0.41666666666666663,167,23
22400662,1,23,-2.0,-5.217391304347826,23,0
22400662,2,101,-4.0,-2.376237623762376,720,619
22400662,2,139,2.0,0.8633093525179857,599,460
22400662,2,44,-1.0,-1.3636363636363638,442,398
22400662,2,31,-2.0,-3.870967741935484,398,367
22400662,2,38,0.0,0.0,357,319
22400662,2,127,5.0,2.3622047244094486,311,184
22400662,2,28,2.0,4.285714285714286,184,156
22400662,2,107,1.0,0.5607476635514018,156,49
22400662,2,34,4.0,7.0588235294117645,34,0
22400662,3,116,2.0,1.0344827586206897,720,604
22400662,3,197,-2.0,-0.6091370558375634,595,398
22400662,3,25,2.0,4.8,392,367
22400662,3,73,1.0,0.821917808219178,356,283
22400662,3,113,-2.0,-1.0619469026548671,265,152
22400662,3,76,2.0,1.5789473684210527,148,72
22400662,3,72,2.0,1.6666666666666665,72,0
22400662,4,124,4.0,1.935483870967742,720,596
22400662,4,34,4.0,7.0588235294117645,585,551
22400662,4,108,-3.0,-1.6666666666666665,539,431
22400662,4,160,2.0,0.75,431,271
22400662,4,68,0.0,0.0,271,203
22400662,4,27,-1.0,-2.2222222222222223,191,164
22400662,4,93,-1.0,-0.6451612903225807,164,71
22400662,4,64,0.0,0.0,64,0
22400663,1,297,-2.0,-0.40404040404040403,720,423
22400663,1,28,0.0,0.0,401,373
22400663,1,97,-2.0,-1.2371134020618557,332,235
22400663,1,201,-1.0,-0.29850746268656714,214,13
22400663,1,1,0.0,0.0,1,0
22400663,2,167,-5.0,-1.7964071856287425,720,553
22400663,2,51,2.0,2.3529411764705883,553,502
22400663,2,45,-1.0,-1.3333333333333335,492,447
22400663,2,78,0.0,0.0,430,352
22400663,2,24,-1.0,-2.5,338,314
22400663,2,21,1.0,2.8571428571428568,314,293
22400663,2,63,-1.0,-0.9523809523809523,293,230
22400663,2,41,-2.0,-2.926829268292683,230,189
22400663,2,38,-1.0,-1.5789473684210527,170,132
22400663,2,132,-5.0,-2.272727272727273,132,0
22400663,3,191,-3.0,-0.9424083769633508,720,529
22400663,3,101,-1.0,-0.594059405940594,529,428
22400663,3,57,3.0,3.1578947368421053,428,371
22400663,3,50,-1.0,-1.2,353,303
22400663,3,92,4.0,2.608695652173913,303,211
22400663,3,80,-5.0,-3.75,211,131
22400663,3,117,1.0,0.5128205128205129,117,0
22400663,4,122,-1.0,-0.49180327868852464,720,598
22400663,4,57,5.0,5.263157894736842,592,535
22400663,4,130,-5.0,-2.307692307692308,509,379
22400663,4,100,3.0,1.7999999999999998,379,279
22400663,4,31,-3.0,-5.806451612903226,264,233
22400663,4,129,-1.0,-0.46511627906976744,221,92
22400663,4,83,-2.0,-1.4457831325301205,83,0
22400664,1,233,5.0,1.2875536480686696,720,487
22400664,1,44,6.0,8.181818181818182,487,443
22400664,1,123,1.0,0.48780487804878053,427,304
22400664,1,27,0.0,0.0,298,271
22400664,1,37,0.0,0.0,267,230
22400664,1,18,-3.0,-10.0,230,212
22400664,1,60,1.0,1.0,190,130
22400664,1,117,-2.0,-1.0256410256410258,130,13
22400664,1,13,-2.0,-9.230769230769232,13,0
22400664,2,178,7.0,2.359550561797753,720,542
22400664,2,1,0.0,0.0,526,525
22400664,2,29,-3.0,-6.206896551724138,513,484
22400664,2,58,4.0,4.137931034482759,484,426
22400664,2,66,1.0,0.9090909090909092,426,360
22400664,2,70,-4.0,-3.4285714285714284,340,270
22400664,2,30,-3.0,-6.0,255,225
22400664,2,36,3.0,5.0,225,189
22400664,2,46,-5.0,-6.521739130434782,189,143
22400664,2,70,-1.0,-0.8571428571428571,143,73
22400664,2,25,2.0,4.8,73,48
22400664,2,15,2.0,8.0,37,22
22400664,3,285,-3.0,-0.631578947368421,720,435
22400664,3,78,1.0,0.7692307692307692,435,357
22400664,3,10,0.0,0.0,357,347
22400664,3,98,0.0,0.0,340,242
22400664,3,64,4.0,3.75,212,148
22400664,3,133,-2.0,-0.9022556390977443,133,0
22400664,4,164,6.0,2.195121951219512,720,556
22400664,4,76,-3.0,-2.3684210526315788,556,480
22400664,4,19,1.0,3.1578947368421053,457,438
22400664,4,80,1.0,0.75,438,358
22400664,4,56,1.0,1.0714285714285714,358,302
22400664,4,63,2.0,1.9047619047619047,285,222
22400664,4,21,-1.0,-2.8571428571428568,221,200
22400664,4,80,3.0,2.25,187,107
22400664,4,90,-2.0,-1.3333333333333335,90,0
22400665,1,289,-12.0,-2.491349480968858,720,431
22400665,1,81,-3.0,-2.2222222222222223,418,337
22400665,1,72,0.0,0.0,332,260
22400665,1,87,2.0,1.3793103448275863,250,163
22400665,1,107,1.0,0.5607476635514018,142,35
22400665,2,207,-1.0,-0.2898550724637681,720,513
22400665,2,2,0.0,0.0,500,498
22400665,2,106,0.0,0.0,498,392
22400665,2,58,4.0,4.137931034482759,392,334
22400665,2,106,-3.0,-1.6981132075471699,326,220
22400665,2,126,-8.0,-3.8095238095238093,220,94
22400665,2,94,3.0,1.9148936170212765,94,0
22400665,3,281,-4.0,-0.8540925266903914,720,439
22400665,3,9,0.0,0.0,428,419
22400665,3,33,4.0,7.272727272727273,414,381
22400665,3,95,-5.0,-3.1578947368421053,375,280
22400665,3,25,-4.0,-9.6,264,239
22400665,3,20,0.0,0.0,232,212
22400665,3,74,0.0,0.0,212,138
22400665,3,83,3.0,2.1686746987951806,136,53
22400665,3,31,0.0,0.0,53,22
22400665,3,17,0.0,0.0,17,0
22400665,4,123,-3.0,-1.4634146341463414,720,597
22400665,4,11,-2.0,-10.90909090909091,592,581
22400665,4,71,3.0,2.535211267605634,570,499
22400665,4,48,0.0,0.0,489,441
22400665,4,51,-1.0,-1.1764705882352942,426,375
22400665,4,148,3.0,1.2162162162162162,374,226
22400665,4,225,2.0,0.5333333333333333,225,0
22400666,1,272,3.0,0.661764705882353,720,448
22400666,1,86,-2.0,-1.3953488372093024,436,350
22400666,1,36,0.0,0.0,350,314
22400666,1,15,-2.0,-8.0,305,290
22400666,1,59,1.0,1.0169491525423728,280,221
22400666,1,97,-2.0,-1.2371134020618557,221,124
22400666,1,84,2.0,1.4285714285714284,109,25
22400666,1,2,0.0,0.0,2,0
22400666,2,126,3.0,1.4285714285714284,720,594
22400666,2,81,-2.0,-1.4814814814814814,573,492
22400666,2,16,0.0,0.0,492,476
22400666,2,25,1.0,2.4,464,439
22400666,2,27,0.0,0.0,439,412
22400666,2,302,1.0,0.1986754966887417,412,110
22400666,3,294,2.0,0.40816326530612246,720,426
22400666,3,104,6.0,3.4615384615384617,412,308
22400666,3,37,0.0,0.0,300,263
22400666,3,113,-1.0,-0.5309734513274336,263,150
22400666,3,63,-2.0,-1.9047619047619047,150,87
22400666,3,65,-1.0,-0.9230769230769231,78,13
22400666,3,53,0.0,0.0,316,263
22400666,4,260,-3.0,-0.6923076923076923,720,460
22400666,4,30,0.0,0.0,460,430
22400666,4,58,0.0,0.0,420,362
22400666,4,61,3.0,2.9508196721311473,357,296
22400666,4,71,-2.0,-1.6901408450704225,296,225
22400666,4,104,0.0,0.0,207,103
22400666,4,87,1.0,0.6896551724137931,87,0
22400667,1,320,-4.0,-0.75,720,400
22400667,1,104,0.0,0.0,388,284
22400667,1,37,0.0,0.0,265,228
22400667,1,114,-2.0,-1.0526315789473684,217,103
22400667,1,103,2.0,1.1650485436893203,103,0
22400667,2,208,0.0,0.0,720,512
22400667,2,88,2.0,1.3636363636363638,498,410
22400667,2,31,-2.0,-3.870967741935484,404,373
22400667,2,33,-2.0,-3.6363636363636367,353,320
22400667,2,198,-4.0,-1.2121212121212122,306,108
22400667,2,47,-2.0,-2.5531914893617023,57,10
22400667,2,2,0.0,0.0,2,0
22400667,3,262,5.0,1.1450381679389314,720,458
22400667,3,95,-6.0,-3.7894736842105265,458,363
22400667,3,125,0.0,0.0,343,218
22400667,3,211,6.0,1.7061611374407581,211,0
22400667,4,203,-4.0,-1.1822660098522169,720,517
22400667,4,143,1.0,0.4195804195804196,495,352
22400667,4,62,-2.0,-1.935483870967742,304,242
22400667,4,53,0.0,0.0,237,184
22400667,4,97,-2.0,-1.2371134020618557,173,76
22400667,4,76,0.0,0.0,76,0
22400668,1,132,1.0,0.4545454545454546,720,588
22400668,1,149,12.0,4.832214765100671,579,430
22400668,1,117,-2.0,-1.0256410256410258,430,313
22400668,1,72,-3.0,-2.5,313,241
22400668,1,21,0.0,0.0,241,220
22400668,1,27,0.0,0.0,199,172
22400668,1,135,-2.0,-0.888888888888889,166,31
22400668,1,31,-1.0,-1.935483870967742,31,0
22400668,2,199,-3.0,-0.9045226130653266,720,521
22400668,2,28,1.0,2.142857142857143,521,493
22400668,2,3,-1.0,-20.0,482,479
22400668,2,45,5.0,6.666666666666666,479,434
22400668,2,104,2.0,1.153846153846154,420,316
22400668,2,316,1.0,0.18987341772151897,316,0
22400668,3,353,-9.0,-1.5297450424929178,720,367
22400668,3,97,2.0,1.2371134020618557,317,220
22400668,3,2,0.0,0.0,204,202
22400668,3,68,2.0,1.7647058823529411,191,123
22400668,3,123,6.0,2.926829268292683,123,0
22400668,4,304,0.0,0.0,720,416
22400668,4,105,-4.0,-2.285714285714286,398,293
22400668,4,228,4.0,1.0526315789473684,291,63
22400669,1,398,-1.0,-0.15075376884422112,720,322
22400669,1,79,1.0,0.7594936708860759,315,236
22400669,1,144,-6.0,-2.5,236,92
22400669,1,23,-1.0,-2.608695652173913,92,69
22400669,1,69,6.0,5.217391304347826,69,0
22400669,2,167,3.0,1.0778443113772456,720,553
22400669,2,71,-4.0,-3.380281690140845,541,470
22400669,2,79,5.0,3.79746835443038,450,371
22400669,2,8,0.0,0.0,352,344
22400669,2,129,0.0,0.0,326,197
22400669,2,59,1.0,1.0169491525423728,194,135
22400669,2,73,-1.0,-0.821917808219178,127,54
22400669,2,54,3.0,3.333333333333333,54,0
22400669,3,325,-12.0,-2.2153846153846155,720,395
22400669,3,70,-1.0,-0.8571428571428571,395,325
22400669,3,131,3.0,1.3740458015267176,325,194
22400669,3,194,7.0,2.1649484536082473,194,0
22400669,4,130,4.0,1.8461538461538463,720,590
22400669,4,62,2.0,1.935483870967742,590,528
22400669,4,137,1.0,0.437956204379562,505,368
22400669,4,17,2.0,7.0588235294117645,359,342
22400669,4,32,-1.0,-1.875,342,310
22400669,4,86,0.0,0.0,310,224
22400669,4,222,7.0,1.8918918918918917,222,0
22400670,1,252,2.0,0.47619047619047616,720,468
22400670,1,89,1.0,0.6741573033707865,466,377
22400670,1,2,0.0,0.0,362,360
22400670,1,111,0.0,0.0,349,238
22400670,1,7,-1.0,-8.571428571428571,229,222
22400670,1,78,-3.0,-2.307692307692308,222,144
22400670,1,21,1.0,2.8571428571428568,133,112
22400670,1,112,-1.0,-0.5357142857142857,112,0
22400670,2,146,0.0,0.0,720,574
22400670,2,80,-3.0,-2.25,560,480
22400670,2,141,1.0,0.425531914893617,472,331
22400670,2,126,2.0,0.9523809523809523,322,196
22400670,2,29,2.0,4.137931034482759,182,153
22400670,2,153,7.0,2.7450980392156863,153,0
22400670,3,277,-8.0,-1.7328519855595668,720,443
22400670,3,25,3.0,7.199999999999999,443,418
22400670,3,18,2.0,6.666666666666666,397,379
22400670,3,61,0.0,0.0,367,306
22400670,3,33,-1.0,-1.8181818181818183,301,268
22400670,3,41,0.0,0.0,268,227
22400670,3,94,-2.0,-1.2765957446808511,222,128
22400670,3,47,-4.0,-5.1063829787234045,128,81
22400670,3,72,-3.0,-2.5,72,0
22400670,4,92,5.0,3.260869565217391,720,628
22400670,4,35,-3.0,-5.142857142857143,612,577
22400670,4,64,-2.0,-1.875,570,506
22400670,4,145,-1.0,-0.41379310344827586,500,355
22400670,4,31,0.0,0.0,349,318
22400670,4,103,6.0,3.4951456310679614,318,215
22400670,4,108,-3.0,-1.6666666666666665,181,73
22400670,4,58,5.0,5.172413793103448,73,15
22400671,1,321,1.0,0.18691588785046728,720,399
22400671,1,88,0.0,0.0,391,303
22400671,1,128,0.0,0.0,281,153
22400671,1,38,0.0,0.0,153,115
22400671,1,115,3.0,1.5652173913043477,115,0
22400671,2,89,2.0,1.348314606741573,720,631
22400671,2,93,-3.0,-1.935483870967742,608,515
22400671,2,46,0.0,0.0,505,459
22400671,2,34,-2.0,-3.5294117647058822,459,425
22400671,2,139,-1.0,-0.43165467625899284,425,286
22400671,2,88,-5.0,-3.409090909090909,286,198
22400671,2,68,3.0,2.647058823529412,189,121
22400671,2,108,2.0,1.1111111111111112,121,13
22400671,2,13,0.0,0.0,13,0
22400671,3,438,-2.0,-0.273972602739726,720,282
22400671,3,59,4.0,4.067796610169491,267,208
22400671,3,122,3.0,1.4754098360655736,194,72
22400671,4,63,0.0,0.0,720,657
22400671,4,68,-2.0,-1.7647058823529411,642,574
22400671,4,49,-2.0,-2.4489795918367343,558,509
22400671,4,27,-2.0,-4.444444444444445,492,465
22400671,4,46,5.0,6.521739130434782,457,411
22400671,4,139,3.0,1.2949640287769786,388,249
22400671,4,10,-1.0,-6.0,249,239
22400671,4,64,-5.0,-4.6875,239,175
22400671,4,95,-5.0,-3.1578947368421053,164,69
22400671,4,69,2.0,1.7391304347826086,69,0
22400672,1,318,6.0,1.1320754716981132,720,402
22400672,1,51,0.0,0.0,392,341
22400672,1,41,2.0,2.926829268292683,341,300
22400672,1,90,0.0,0.0,300,210
22400672,1,133,-4.0,-1.8045112781954886,202,69
22400672,1,14,0.0,0.0,46,32
22400672,1,13,1.0,4.615384615384616,25,12
22400672,1,12,2.0,10.0,12,0
22400672,2,12,2.0,10.0,720,708
22400672,2,112,-1.0,-0.5357142857142857,708,596
22400672,2,34,-1.0,-1.7647058823529411,596,562
22400672,2,101,2.0,1.188118811881188,562,461
22400672,2,186,-4.0,-1.2903225806451615,461,275
22400672,2,69,-4.0,-3.4782608695652173,267,198
22400672,2,40,-2.0,-3.0,198,158
22400672,2,93,4.0,2.580645161290323,158,65
22400672,2,63,-3.0,-2.8571428571428568,65,2
22400672,3,294,0.0,0.0,720,426
22400672,3,10,0.0,0.0,420,410
22400672,3,17,0.0,0.0,397,380
22400672,3,58,-2.0,-2.0689655172413794,365,307
22400672,3,73,0.0,0.0,380,307
22400672,3,91,0.0,0.0,283,192
22400672,3,73,-4.0,-3.287671232876712,176,103
22400672,3,56,0.0,0.0,103,47
22400672,3,39,0.0,0.0,41,2
22400672,4,210,-6.0,-1.7142857142857142,720,510
22400672,4,87,-7.0,-4.827586206896552,496,409
22400672,4,69,-2.0,-1.7391304347826086,404,335
22400672,4,93,3.0,1.935483870967742,324,231
22400672,4,24,0.0,0.0,231,207
22400672,4,4,-1.0,-15.0,192,188
22400672,4,168,7.0,2.5,188,20
22400672,4,9,0.0,0.0,9,0
22400673,1,349,-8.0,-1.3753581661891117,720,371
22400673,1,107,-3.0,-1.6822429906542056,363,256
22400673,1,47,-1.0,-1.2765957446808511,256,209
22400673,1,28,-1.0,-2.142857142857143,209,181
22400673,1,22,2.0,5.454545454545455,181,159
22400673,1,117,-3.0,-1.5384615384615383,141,24
22400673,2,149,3.0,1.2080536912751678,720,571
22400673,2,85,-3.0,-2.1176470588235294,569,484
22400673,2,50,2.0,2.4,467,417
22400673,2,81,8.0,5.925925925925926,408,327
22400673,2,34,-1.0,-1.7647058823529411,314,280
22400673,2,41,2.0,2.926829268292683,280,239
22400673,2,100,0.0,0.0,239,139
22400673,3,237,9.0,2.278481012658228,720,483
22400673,3,29,2.0,4.137931034482759,465,436
22400673,3,25,1.0,2.4,419,394
22400673,3,83,-4.0,-2.891566265060241,394,311
22400673,3,121,-6.0,-2.975206611570248,297,176
22400673,3,18,0.0,0.0,156,138
22400673,3,9,0.0,0.0,138,129
22400673,3,41,-3.0,-4.390243902439024,116,75
22400673,3,73,2.0,1.643835616438356,73,0
22400673,4,125,0.0,0.0,720,595
22400673,4,80,1.0,0.75,578,498
22400673,4,113,2.0,1.0619469026548671,498,385
22400673,4,116,2.0,1.0344827586206897,385,269
22400673,4,25,2.0,4.8,269,244
22400673,4,2,0.0,0.0,222,220
22400673,4,191,-1.0,-0.31413612565445026,207,16
22400673,4,9,0.0,0.0,9,0
22400674,1,449,-7.0,-0.9354120267260579,720,271
22400674,1,56,-2.0,-2.142857142857143,258,202
22400674,1,68,3.0,2.647058823529412,202,134
22400674,1,84,-5.0,-3.571428571428571,140,56
22400674,1,15,-2.0,-8.0,56,41
22400674,1,7,0.0,0.0,41,34
22400674,1,32,0.0,0.0,34,2
22400674,2,156,-2.0,-0.7692307692307692,720,564
22400674,2,65,-4.0,-3.6923076923076925,564,499
22400674,2,32,0.0,0.0,481,449
22400674,2,21,-2.0,-5.7142857142857135,440,419
22400674,2,35,-1.0,-1.7142857142857142,404,369
22400674,2,175,-5.0,-1.7142857142857142,369,194
22400674,2,122,-7.0,-3.4426229508196724,185,63
22400674,2,53,-1.0,-1.1320754716981132,54,1
22400674,3,249,-3.0,-0.7228915662650602,720,471
22400674,3,23,0.0,0.0,461,438
22400674,3,215,1.0,0.27906976744186046,419,204
22400674,3,1,1.0,60.0,204,203
22400674,3,15,2.0,8.0,188,173
22400674,3,160,-1.0,-0.375,160,0
22400674,4,111,2.0,1.0810810810810811,720,609
22400674,4,88,-7.0,-4.7727272727272725,597,509
22400674,4,77,-1.0,-0.7792207792207793,496,419
22400674,4,51,3.0,3.5294117647058822,419,368
22400674,4,1,0.0,0.0,358,357
22400674,4,272,-3.0,-0.661764705882353,357,85
22400675,1,275,1.0,0.21818181818181817,720,445
22400675,1,118,3.0,1.5254237288135595,423,305
22400675,1,123,4.0,1.9512195121951221,305,182
22400675,1,180,0.0,0.0,180,0
22400675,2,140,2.0,0.8571428571428571,720,580
22400675,2,68,2.0,1.7647058823529411,580,512
22400675,2,55,0.0,0.0,489,434
22400675,2,14,-2.0,-8.571428571428571,434,420
22400675,2,77,-2.0,-1.5584415584415585,420,343
22400675,2,12,1.0,5.0,343,331
22400675,2,111,-2.0,-1.0810810810810811,331,220
22400675,2,207,0.0,0.0,220,13
22400675,2,13,0.0,0.0,13,0
22400675,3,307,6.0,1.1726384364820845,720,413
22400675,3,20,4.0,12.0,413,393
22400675,3,60,-5.0,-5.0,391,331
22400675,3,27,0.0,0.0,331,304
22400675,3,76,5.0,3.9473684210526314,296,220
22400675,3,48,3.0,3.75,203,155
22400675,4,157,0.0,0.0,720,563
22400675,4,58,-1.0,-1.0344827586206897,563,505
22400675,4,14,-1.0,-4.285714285714286,505,491
22400675,4,208,-6.0,-1.7307692307692308,491,283
22400675,4,61,-1.0,-0.9836065573770493,283,222
22400675,4,213,2.0,0.5633802816901409,213,0
22400676,1,328,6.0,1.097560975609756,720,392
22400676,1,173,-1.0,-0.3468208092485549,381,208
22400676,1,6,0.0,0.0,208,202
22400676,1,42,-1.0,-1.4285714285714284,184,142
22400676,1,110,-1.0,-0.5454545454545454,132,22
22400676,1,22,-3.0,-8.181818181818182,22,0
22400676,2,205,-3.0,-0.8780487804878049,720,515
22400676,2,48,2.0,2.5,515,467
22400676,2,103,-3.0,-1.7475728155339807,467,364
22400676,2,28,0.0,0.0,353,325
22400676,2,52,0.0,0.0,303,251
22400676,2,154,1.0,0.38961038961038963,251,97
22400676,2,59,0.0,0.0,86,27
22400676,2,22,0.0,0.0,22,0
22400676,3,194,4.0,1.2371134020618557,720,526
22400676,3,75,0.0,0.0,511,436
22400676,3,98,0.0,0.0,419,321
22400676,3,1,0.0,0.0,306,305
22400676,3,104,0.0,0.0,295,191
22400676,3,57,1.0,1.0526315789473684,175,118
22400676,3,15,-2.0,-8.0,118,103
22400676,3,54,-3.0,-3.333333333333333,103,49
22400676,3,28,1.0,2.142857142857143,49,21
22400676,4,76,3.0,2.3684210526315788,720,644
22400676,4,60,3.0,3.0,644,584
22400676,4,55,-5.0,-5.454545454545455,567,512
22400676,4,184,-4.0,-1.3043478260869565,512,328
22400676,4,27,2.0,4.444444444444445,310,283
22400676,4,77,2.0,1.5584415584415585,283,206
22400676,4,79,-1.0,-0.7594936708860759,193,114
22400676,4,89,4.0,2.696629213483146,114,25
22400676,4,2,0.0,0.0,15,13
22400676,4,2,0.0,0.0,2,0
22400677,1,333,5.0,0.9009009009009009,720,387
22400677,1,163,3.0,1.1042944785276074,376,213
22400677,1,203,-10.0,-2.955665024630542,203,0
22400677,2,85,2.0,1.4117647058823528,720,635
22400677,2,14,0.0,0.0,626,612
22400677,2,37,-9.0,-14.594594594594595,598,561
22400677,2,19,0.0,0.0,485,466
22400677,2,41,-2.0,-2.926829268292683,449,408
22400677,2,93,0.0,0.0,395,302
22400677,2,133,0.0,0.0,300,167
22400677,2,9,-2.0,-13.333333333333332,155,146
22400677,2,120,-1.0,-0.5,140,20
22400677,2,20,3.0,9.0,20,0
22400677,3,238,-8.0,-2.0168067226890756,720,482
22400677,3,43,2.0,2.7906976744186047,482,439
22400677,3,24,0.0,0.0,439,415
22400677,3,157,-8.0,-3.0573248407643314,410,253
22400677,3,29,-1.0,-2.0689655172413794,242,213
22400677,3,186,-7.0,-2.2580645161290325,213,27
22400677,4,225,5.0,1.3333333333333335,720,495
22400677,4,159,1.0,0.37735849056603776,482,323
22400677,4,35,-1.0,-1.7142857142857142,309,274
22400677,4,16,1.0,3.75,259,243
22400677,4,12,0.0,0.0,243,231
22400677,4,149,-1.0,-0.40268456375838924,218,69
22400678,1,261,-6.0,-1.3793103448275863,720,459
22400678,1,160,3.0,1.125,452,292
22400678,1,76,-3.0,-2.3684210526315788,271,195
22400678,1,36,-3.0,-5.0,195,159
22400678,1,16,-1.0,-3.75,148,132
22400678,1,124,2.0,0.967741935483871,132,8
22400678,1,8,0.0,0.0,8,0
22400678,2,182,3.0,0.989010989010989,720,538
22400678,2,114,-1.0,-0.5263157894736842,534,420
22400678,2,82,2.0,1.4634146341463414,420,338
22400678,2,85,2.0,1.4117647058823528,193,108
22400678,3,214,7.0,1.9626168224299063,720,506
22400678,3,40,0.0,0.0,484,444
22400678,3,16,0.0,0.0,428,412
22400678,3,86,4.0,2.7906976744186047,407,321
22400678,3,104,7.0,4.038461538461538,321,217
22400678,3,145,-1.0,-0.41379310344827586,201,56
22400678,3,45,-4.0,-5.333333333333334,45,0
22400678,4,39,-1.0,-1.5384615384615383,720,681
22400678,4,46,0.0,0.0,681,635
22400678,4,56,0.0,0.0,635,579
22400678,4,68,-2.0,-1.7647058823529411,563,495
22400678,4,207,2.0,0.5797101449275363,495,288
22400678,4,51,2.0,2.3529411764705883,279,228
22400678,4,24,1.0,2.5,228,204
22400678,4,198,2.0,0.6060606060606061,198,0
22400679,1,259,-5.0,-1.1583011583011582,720,461
22400679,1,75,-4.0,-3.2,445,370
22400679,1,41,3.0,4.390243902439024,370,329
22400679,1,32,0.0,0.0,328,296
22400679,1,99,0.0,0.0,281,182
22400679,2,72,0.0,0.0,720,648
22400679,2,136,-2.0,-0.8823529411764706,648,512
22400679,2,107,-5.0,-2.803738317757009,502,395
22400679,2,50,2.0,2.4,380,330
22400679,2,117,-1.0,-0.5128205128205129,330,213
22400679,2,83,5.0,3.6144578313253013,207,124
22400679,2,124,-3.0,-1.4516129032258065,124,0
22400679,3,182,-4.0,-1.3186813186813189,720,538
22400679,3,111,0.0,0.0,515,404
22400679,3,47,0.0,0.0,393,346
22400679,3,104,2.0,1.153846153846154,334,230
22400679,3,4,0.0,0.0,230,226
22400679,3,189,-1.0,-0.31746031746031744,355,166
22400679,3,97,0.0,0.0,166,69
22400679,4,213,7.0,1.971830985915493,720,507
22400679,4,53,3.0,3.3962264150943398,499,446
22400679,4,55,0.0,0.0,446,391
22400679,4,94,-1.0,-0.6382978723404256,385,291
22400679,4,162,-6.0,-2.2222222222222223,267,105
22400679,4,63,0.0,0.0,101,38
22400679,4,33,0.0,0.0,33,0
22400680,1,254,-9.0,-2.1259842519685037,720,466
22400680,1,152,3.0,1.1842105263157894,454,302
22400680,1,164,3.0,1.097560975609756,302,138
22400680,1,89,2.0,1.348314606741573,120,31
22400680,1,16,0.0,0.0,16,0
22400680,2,211,5.0,1.4218009478672984,720,509
22400680,2,92,0.0,0.0,509,417
22400680,2,86,-3.0,-2.0930232558139537,402,316
22400680,2,83,-2.0,-1.4457831325301205,316,233
22400680,2,26,0.0,0.0,218,192
22400680,2,33,2.0,3.6363636363636367,189,156
22400680,2,345,1.0,0.17391304347826086,489,144
22400680,2,144,-1.0,-0.41666666666666663,144,0
22400680,3,346,3.0,0.5202312138728323,720,374
22400680,3,35,1.0,1.7142857142857142,360,325
22400680,3,70,2.0,1.7142857142857142,325,255
22400680,3,62,-5.0,-4.838709677419355,237,175
22400680,4,155,-4.0,-1.5483870967741935,720,565
22400680,4,26,1.0,2.307692307692308,552,526
22400680,4,21,1.0,2.8571428571428568,526,505
22400680,4,106,4.0,2.2641509433962264,505,399
22400680,4,3,1.0,20.0,381,378
22400680,4,80,4.0,3.0,378,298
22400680,4,49,2.0,2.4489795918367343,290,241
22400680,4,139,2.0,0.8633093525179857,230,91
22400680,4,91,-3.0,-1.978021978021978,91,0
22400681,1,407,-4.0,-0.5896805896805897,720,313
22400681,1,126,3.0,1.4285714285714284,313,187
22400681,1,87,0.0,0.0,176,89
22400681,1,63,-1.0,-0.9523809523809523,89,26
22400681,1,26,1.0,2.307692307692308,26,0
22400681,2,243,-1.0,-0.2469135802469136,720,477
22400681,2,77,0.0,0.0,477,400
22400681,2,163,-1.0,-0.36809815950920244,392,229
22400681,2,121,-4.0,-1.9834710743801653,229,108
22400681,2,104,-2.0,-1.153846153846154,108,4
22400681,3,382,-1.0,-0.15706806282722513,720,338
22400681,3,41,2.0,2.926829268292683,338,297
22400681,3,133,1.0,0.45112781954887216,274,141
22400681,3,135,2.0,0.888888888888889,135,0
22400681,4,50,1.0,1.2,720,670
22400681,4,147,-1.0,-0.40816326530612246,652,505
22400681,4,87,-1.0,-0.6896551724137931,495,408
22400681,4,2,0.0,0.0,388,386
22400681,4,60,-2.0,-2.0,367,307
22400681,4,87,2.0,1.3793103448275863,299,212
22400681,4,204,-2.0,-0.5882352941176471,204,0
22400682,1,244,7.0,1.7213114754098362,720,476
22400682,1,81,-3.0,-2.2222222222222223,463,382
22400682,1,86,-6.0,-4.186046511627907,382,296
22400682,1,43,3.0,4.186046511627907,296,253
22400682,1,71,-2.0,-1.6901408450704225,253,182
22400682,1,182,-1.0,-0.3296703296703297,182,0
22400682,2,250,0.0,0.0,720,470
22400682,2,107,3.0,1.6822429906542056,470,363
22400682,2,98,-3.0,-1.836734693877551,351,253
22400682,2,30,0.0,0.0,238,208
22400682,2,110,2.0,1.0909090909090908,197,87
22400682,2,76,-1.0,-0.7894736842105263,76,0
22400682,3,225,1.0,0.26666666666666666,720,495
22400682,3,47,4.0,5.1063829787234045,495,448
22400682,3,92,-7.0,-4.565217391304348,437,345
22400682,3,99,-3.0,-1.8181818181818183,345,246
22400682,3,41,-1.0,-1.4634146341463414,233,192
22400682,3,192,-5.0,-1.5625,192,0
22400682,4,117,3.0,1.5384615384615383,720,603
22400682,4,84,-2.0,-1.4285714285714284,603,519
22400682,4,63,-7.0,-6.666666666666666,493,430
22400682,4,58,1.0,1.0344827586206897,417,359
22400682,4,25,0.0,0.0,359,334
22400682,4,75,1.0,0.8,329,254
22400682,4,85,-2.0,-1.4117647058823528,237,152
22400682,4,67,0.0,0.0,152,85
22400682,4,30,-2.0,-4.0,85,55
22400682,4,53,0.0,0.0,53,0
22400683,1,325,-1.0,-0.18461538461538463,720,395
22400683,1,129,1.0,0.46511627906976744,395,266
22400683,1,26,2.0,4.615384615384616,257,231
22400683,1,213,4.0,1.1267605633802817,213,0
22400683,2,197,-2.0,-0.6091370558375634,720,523
22400683,2,78,0.0,0.0,511,433
22400683,2,41,0.0,0.0,419,378
22400683,2,61,-6.0,-5.9016393442622945,363,302
22400683,2,285,-6.0,-1.263157894736842,289,4
22400683,2,3,3.0,60.0,3,0
22400683,3,347,3.0,0.5187319884726225,720,373
22400683,3,368,2.0,0.32608695652173914,662,294
22400683,3,33,3.0,5.454545454545455,285,252
22400683,3,21,0.0,0.0,252,231
22400683,3,86,0.0,0.0,231,145
22400683,3,37,1.0,1.6216216216216217,126,89
22400683,3,73,-3.0,-2.4657534246575343,75,2
22400683,4,129,1.0,0.46511627906976744,720,591
22400683,4,34,1.0,1.7647058823529411,569,535
22400683,4,66,3.0,2.7272727272727275,526,460
22400683,4,46,-1.0,-1.3043478260869565,460,414
22400683,4,15,0.0,0.0,414,399
22400683,4,107,0.0,0.0,399,292
22400683,4,57,1.0,1.0526315789473684,281,224
22400683,4,43,2.0,2.7906976744186047,224,181
22400683,4,22,0.0,0.0,175,153
22400683,4,120,0.0,0.0,153,33
22400683,4,24,0.0,0.0,24,0
22400684,1,327,9.0,1.651376146788991,720,393
22400684,1,49,-4.0,-4.897959183673469,393,344
22400684,1,16,-2.0,-7.5,320,304
22400684,1,70,1.0,0.8571428571428571,291,221
22400684,1,44,-1.0,-1.3636363636363638,211,167
22400684,1,162,1.0,0.37037037037037035,162,0
22400684,2,167,1.0,0.3592814371257485,720,553
22400684,2,46,-1.0,-1.3043478260869565,553,507
22400684,2,140,0.0,0.0,507,367
22400684,2,74,-1.0,-0.8108108108108109,351,277
22400684,2,45,1.0,1.3333333333333335,264,219
22400684,2,173,2.0,0.6936416184971098,209,36
22400684,2,36,0.0,0.0,36,0
22400684,3,344,7.0,1.2209302325581397,720,376
22400684,3,29,-1.0,-2.0689655172413794,372,343
22400684,3,25,2.0,4.8,330,305
22400684,3,41,3.0,4.390243902439024,296,255
22400684,3,17,-1.0,-3.5294117647058822,255,238
22400684,3,6,1.0,10.0,238,232
22400684,3,16,-1.0,-3.75,232,216
22400684,3,216,5.0,1.3888888888888888,216,0
22400684,4,101,1.0,0.594059405940594,720,619
22400684,4,13,2.0,9.230769230769232,611,598
22400684,4,54,2.0,2.2222222222222223,576,522
22400684,4,48,0.0,0.0,507,459
22400684,4,104,-1.0,-0.576923076923077,446,342
22400684,4,116,2.0,1.0344827586206897,342,226
22400684,4,211,4.0,1.137440758293839,211,0
22400685,1,352,4.0,0.6818181818181819,720,368
22400685,1,31,1.0,1.935483870967742,357,326
22400685,1,69,-5.0,-4.3478260869565215,326,257
22400685,1,17,0.0,0.0,248,231
22400685,1,140,0.0,0.0,230,90
22400685,1,84,-2.0,-1.4285714285714284,84,0
22400685,2,175,-5.0,-1.7142857142857142,720,545
22400685,2,32,-5.0,-9.375,526,494
22400685,2,33,0.0,0.0,478,445
22400685,2,124,7.0,3.3870967741935485,445,321
22400685,2,141,-6.0,-2.5531914893617023,308,167
22400685,2,101,1.0,0.594059405940594,164,63
22400685,2,63,2.0,1.9047619047619047,63,0
22400685,3,208,-7.0,-2.019230769230769,720,512
22400685,3,71,2.0,1.6901408450704225,501,430
22400685,3,133,-2.0,-0.9022556390977443,430,297
22400685,3,41,-1.0,-1.4634146341463414,282,241
22400685,3,44,-1.0,-1.3636363636363638,241,197
22400685,3,32,1.0,1.875,186,154
22400685,3,154,0.0,0.0,154,0
22400685,4,161,4.0,1.4906832298136645,720,559
22400685,4,54,-4.0,-4.444444444444445,559,505
22400685,4,42,-3.0,-4.285714285714286,505,463
22400685,4,102,-2.0,-1.1764705882352942,457,355
22400685,4,43,-3.0,-4.186046511627907,331,288
22400685,4,30,2.0,4.0,274,244
22400685,4,244,1.0,0.24590163934426232,244,0
22400686,1,318,7.0,1.320754716981132,720,402
22400686,1,64,2.0,1.875,395,331
22400686,1,118,3.0,1.5254237288135595,331,213
22400686,1,125,4.0,1.92,199,74
22400686,1,7,-1.0,-8.571428571428571,74,67
22400686,1,67,2.0,1.791044776119403,67,0
22400686,2,34,1.0,1.7647058823529411,720,686
22400686,2,69,0.0,0.0,686,617
22400686,2,95,-3.0,-1.8947368421052633,617,522
22400686,2,7,0.0,0.0,502,495
22400686,2,83,1.0,0.7228915662650602,478,395
22400686,2,14,0.0,0.0,394,380
22400686,2,53,-3.0,-3.3962264150943398,369,316
22400686,2,85,-3.0,-2.1176470588235294,310,225
22400686,2,60,1.0,1.0,225,165
22400686,2,151,-7.0,-2.781456953642384,165,14
22400686,2,14,2.0,8.571428571428571,14,0
22400686,3,218,-8.0,-2.2018348623853212,720,502
22400686,3,133,-3.0,-1.3533834586466165,480,347
22400686,3,31,2.0,3.870967741935484,347,316
22400686,3,83,6.0,4.337349397590361,316,233
22400686,3,72,-4.0,-3.333333333333333,223,151
22400686,3,54,0.0,0.0,101,47
22400686,3,47,0.0,0.0,47,0
22400686,4,140,-3.0,-1.2857142857142858,720,580
22400686,4,22,0.0,0.0,574,552
22400686,4,77,0.0,0.0,526,449
22400686,4,124,0.0,0.0,433,309
22400686,4,257,7.0,1.6342412451361867,295,38
22400686,4,7,-3.0,-25.71428571428571,33,26
22400686,4,10,1.0,6.0,22,12
22400686,4,7,1.0,8.571428571428571,7,0
22400687,1,304,10.0,1.9736842105263157,720,416
22400687,1,21,0.0,0.0,416,395
22400687,1,112,7.0,3.75,384,272
22400687,1,23,0.0,0.0,260,237
22400687,1,72,-3.0,-2.5,230,158
22400687,1,94,1.0,0.6382978723404256,141,47
22400687,1,40,-1.0,-1.5,47,7
22400687,1,7,0.0,0.0,7,0
22400687,2,195,-2.0,-0.6153846153846154,720,525
22400687,2,32,0.0,0.0,514,482
22400687,2,56,-4.0,-4.285714285714286,465,409
22400687,2,37,3.0,4.864864864864865,397,360
22400687,2,5,2.0,24.0,351,346
22400687,2,98,4.0,2.4489795918367343,324,226
22400687,2,63,-2.0,-1.9047619047619047,226,163
22400687,2,153,0.0,0.0,153,0
22400687,3,318,6.0,1.1320754716981132,720,402
22400687,3,76,0.0,0.0,379,303
22400687,3,85,3.0,2.1176470588235294,303,218
22400687,3,44,-2.0,-2.7272727272727275,199,155
22400687,3,63,-1.0,-0.9523809523809523,155,92
22400687,3,85,0.0,0.0,85,0
22400687,4,125,1.0,0.48,720,595
22400687,4,67,1.0,0.8955223880597015,595,528
22400687,4,41,0.0,0.0,528,487
22400687,4,43,2.0,2.7906976744186047,473,430
22400687,4,215,-6.0,-1.6744186046511627,420,205
22400687,4,6,2.0,20.0,205,199
22400687,4,190,0.0,0.0,190,0
22400688,1,440,-9.0,-1.2272727272727273,720,280
22400688,1,61,0.0,0.0,263,202
22400688,1,24,2.0,5.0,187,163
22400688,2,76,2.0,1.5789473684210527,720,644
22400688,2,85,-6.0,-4.235294117647059,636,551
22400688,2,301,-1.0,-0.19933554817275748,551,250
22400688,2,34,5.0,8.823529411764707,250,216
22400688,2,32,0.0,0.0,203,171
22400688,3,237,-7.0,-1.7721518987341773,720,483
22400688,3,98,0.0,0.0,473,375
22400688,3,37,0.0,0.0,364,327
22400688,3,35,-2.0,-3.4285714285714284,318,283
22400688,3,64,2.0,1.875,283,219
22400688,3,88,4.0,2.7272727272727275,219,131
22400688,3,131,-1.0,-0.4580152671755725,131,0
22400688,4,110,4.0,2.1818181818181817,720,610
22400688,4,207,1.0,0.2898550724637681,600,393
22400688,4,174,0.0,0.0,374,200
22400688,4,160,-1.0,-0.375,168,8
22400688,4,3,0.0,0.0,3,0
22400689,1,317,-5.0,-0.946372239747634,720,403
22400689,1,90,4.0,2.666666666666667,383,293
22400689,1,31,0.0,0.0,278,247
22400689,1,55,-1.0,-1.0909090909090908,235,180
22400689,1,30,-2.0,-4.0,166,136
22400689,1,124,-2.0,-0.967741935483871,128,4
22400689,2,100,-2.0,-1.2,720,620
22400689,2,72,-4.0,-3.333333333333333,605,533
22400689,2,38,0.0,0.0,520,482
22400689,2,114,2.0,1.0526315789473684,466,352
22400689,2,28,-1.0,-2.142857142857143,346,318
22400689,2,59,-2.0,-2.0338983050847457,318,259
22400689,2,325,0.0,0.0,445,120
22400689,2,65,-4.0,-3.6923076923076925,115,50
22400689,2,50,-3.0,-3.5999999999999996,50,0
22400689,3,255,0.0,0.0,720,465
22400689,3,240,-4.0,-1.0,456,216
22400689,3,91,-2.0,-1.3186813186813189,207,116
22400689,3,63,0.0,0.0,100,37
22400689,3,16,1.0,3.75,37,21
22400689,3,21,1.0,2.8571428571428568,21,0
22400689,4,97,0.0,0.0,720,623
22400689,4,99,4.0,2.4242424242424243,606,507
22400689,4,47,3.0,3.829787234042553,491,444
22400689,4,9,-1.0,-6.666666666666666,434,425
22400689,4,78,-1.0,-0.7692307692307692,425,347
22400689,4,222,1.0,0.2702702702702703,507,285
22400689,4,220,-3.0,-0.8181818181818181,285,65
22400689,4,65,4.0,3.6923076923076925,65,0
22400690,1,340,-5.0,-0.8823529411764706,720,380
22400690,1,54,0.0,0.0,380,326
22400690,1,9,2.0,13.333333333333332,303,294
22400690,1,48,3.0,3.75,281,233
22400690,1,33,-2.0,-3.6363636363636367,218,185
22400690,1,131,4.0,1.83206106870229,180,49
22400690,1,148,2.0,0.8108108108108109,148,0
22400690,2,190,-6.0,-1.8947368421052633,720,530
22400690,2,67,0.0,0.0,521,454
22400690,2,93,-1.0,-0.6451612903225807,454,361
22400690,2,53,0.0,0.0,361,308
22400690,2,103,-1.0,-0.5825242718446602,295,192
22400690,2,27,2.0,4.444444444444445,172,145
22400690,2,124,1.0,0.4838709677419355,131,7
22400690,3,210,-3.0,-0.8571428571428571,720,510
22400690,3,107,-2.0,-1.1214953271028036,510,403
22400690,3,65,-2.0,-1.8461538461538463,390,325
22400690,3,1,0.0,0.0,295,294
22400690,3,45,3.0,4.0,280,235
22400690,3,65,-1.0,-0.9230769230769231,225,160
22400690,3,14,-1.0,-4.285714285714286,147,133
22400690,3,27,0.0,0.0,133,106
22400690,3,84,1.0,0.7142857142857142,106,22
22400690,3,22,0.0,0.0,22,0
22400690,4,215,5.0,1.3953488372093024,720,505
22400690,4,11,2.0,10.90909090909091,485,474
22400690,4,137,-2.0,-0.875912408759124,455,318
22400690,4,14,-2.0,-8.571428571428571,302,288
22400690,4,56,-1.0,-1.0714285714285714,288,232
22400690,4,217,3.0,0.8294930875576038,232,15
22400690,4,11,0.0,0.0,11,0
22400691,1,305,-3.0,-0.5901639344262296,720,415
22400691,1,66,2.0,1.8181818181818183,404,338
22400691,1,144,5.0,2.0833333333333335,338,194
22400691,1,53,0.0,0.0,180,127
22400691,2,129,6.0,2.7906976744186047,720,591
22400691,2,39,0.0,0.0,581,542
22400691,2,70,-1.0,-0.8571428571428571,526,456
22400691,2,27,2.0,4.444444444444445,445,418
22400691,2,31,-2.0,-3.870967741935484,400,369
22400691,2,51,0.0,0.0,369,318
22400691,2,110,9.0,4.909090909090909,318,208
22400691,2,10,0.0,0.0,202,192
22400691,2,3,0.0,0.0,187,184
22400691,2,139,4.0,1.7266187050359714,175,36
22400691,2,10,0.0,0.0,36,26
22400691,2,17,1.0,3.5294117647058822,18,1
22400691,2,1,0.0,0.0,1,0
22400691,3,319,2.0,0.37617554858934166,720,401
22400691,3,32,1.0,1.875,401,369
22400691,3,183,-7.0,-2.2950819672131146,369,186
22400691,3,52,2.0,2.307692307692308,171,119
22400691,3,12,0.0,0.0,119,107
22400691,3,435,-5.0,-0.6896551724137931,437,2
22400691,4,202,3.0,0.891089108910891,720,518
22400691,4,79,4.0,3.0379746835443036,502,423
22400691,4,82,5.0,3.6585365853658534,419,337
22400691,4,267,0.0,0.0,337,70
22400691,4,70,2.0,1.7142857142857142,70,0
22400692,1,226,-3.0,-0.7964601769911505,720,494
22400692,1,143,2.0,0.8391608391608392,486,343
22400692,1,7,0.0,0.0,332,325
22400692,1,73,2.0,1.643835616438356,317,244
22400692,1,54,-1.0,-1.1111111111111112,244,190
22400692,1,6,-2.0,-20.0,183,177
22400692,1,72,0.0,0.0,177,105
22400692,1,41,3.0,4.390243902439024,93,52
22400692,1,27,0.0,0.0,32,5
22400692,1,1,0.0,0.0,1,0
22400692,2,296,1.0,0.20270270270270271,720,424
22400692,2,44,-1.0,-1.3636363636363638,424,380
22400692,2,17,0.0,0.0,380,363
22400692,2,200,-4.0,-1.2,342,142
22400692,2,131,0.0,0.0,131,0
22400692,3,82,0.0,0.0,720,638
22400692,3,108,3.0,1.6666666666666665,629,521
22400692,3,166,-4.0,-1.4457831325301205,518,352
22400692,3,49,-4.0,-4.897959183673469,334,285
22400692,3,72,1.0,0.8333333333333333,285,213
22400692,3,17,4.0,14.117647058823529,205,188
22400692,3,51,4.0,4.705882352941177,165,114
22400692,3,40,0.0,0.0,93,53
22400692,4,13,0.0,0.0,720,707
22400692,4,133,-3.0,-1.3533834586466165,701,568
22400692,4,11,-3.0,-16.363636363636363,552,541
22400692,4,109,2.0,1.1009174311926606,527,418
22400692,4,121,-5.0,-2.479338842975207,401,280
22400692,4,25,-1.0,-2.4,274,249
22400692,4,121,-2.0,-0.9917355371900827,236,115
22400692,4,5,0.0,0.0,115,110
22400692,4,105,0.0,0.0,105,0
22400693,1,303,0.0,0.0,720,417
22400693,1,105,3.0,1.7142857142857142,417,312
22400693,1,111,-2.0,-1.0810810810810811,312,201
22400693,1,89,3.0,2.0224719101123596,201,112
22400693,1,56,0.0,0.0,112,56
22400693,1,56,2.0,2.142857142857143,56,0
22400693,2,144,-5.0,-2.0833333333333335,720,576
22400693,2,71,3.0,2.535211267605634,560,489
22400693,2,19,3.0,9.473684210526315,464,445
22400693,2,30,0.0,0.0,428,398
22400693,2,120,-3.0,-1.5,398,278
22400693,2,63,0.0,0.0,265,202
22400693,2,21,-1.0,-2.8571428571428568,189,168
22400693,2,107,0.0,0.0,168,61
22400693,2,56,0.0,0.0,56,0
22400693,3,394,-2.0,-0.3045685279187817,720,326
22400693,3,108,1.0,0.5555555555555556,318,210
22400693,3,65,-3.0,-2.769230769230769,204,139
22400693,4,95,0.0,0.0,720,625
22400693,4,46,-1.0,-1.3043478260869565,625,579
22400693,4,22,0.0,0.0,565,543
22400693,4,48,0.0,0.0,543,495
22400693,4,18,1.0,3.333333333333333,465,447
22400693,4,51,0.0,0.0,447,396
22400693,4,84,4.0,2.8571428571428568,396,312
22400693,4,132,-4.0,-1.8181818181818183,275,143
22400693,4,140,0.0,0.0,143,3
22400694,1,355,7.0,1.183098591549296,720,365
22400694,1,63,-1.0,-0.9523809523809523,353,290
22400694,1,53,2.0,2.2641509433962264,290,237
22400694,1,85,1.0,0.7058823529411764,237,152
22400694,1,126,-4.0,-1.9047619047619047,143,17
22400694,1,17,2.0,7.0588235294117645,17,0
22400694,2,226,-3.0,-0.7964601769911505,720,494
22400694,2,10,2.0,12.0,477,467
22400694,2,9,0.0,0.0,414,405
22400694,2,82,1.0,0.7317073170731707,382,300
22400694,2,128,5.0,2.34375,300,172
22400694,2,134,5.0,2.2388059701492535,168,34
22400694,2,6,0.0,0.0,34,28
22400694,2,19,0.0,0.0,19,0
22400694,3,350,-5.0,-0.8571428571428571,720,370
22400694,3,62,5.0,4.838709677419355,363,301
22400694,3,14,0.0,0.0,279,265
22400694,3,89,5.0,3.3707865168539324,260,171
22400694,3,18,1.0,3.333333333333333,171,153
22400694,3,39,-2.0,-3.0769230769230766,153,114
22400694,3,99,-1.0,-0.6060606060606061,114,15
22400694,3,15,0.0,0.0,15,0
22400694,4,134,1.0,0.44776119402985076,720,586
22400694,4,37,-1.0,-1.6216216216216217,586,549
22400694,4,34,-1.0,-1.7647058823529411,549,515
22400694,4,92,0.0,0.0,515,423
22400694,4,68,5.0,4.411764705882353,359,291
22400694,4,82,5.0,3.6585365853658534,277,195
22400694,4,192,-6.0,-1.875,192,0
22400695,1,230,0.0,0.0,720,490
22400695,1,71,2.0,1.6901408450704225,474,403
22400695,1,48,6.0,7.5,387,339
22400695,1,71,0.0,0.0,324,253
22400695,1,84,-7.0,-5.0,210,126
22400695,1,111,-1.0,-0.5405405405405406,111,0
22400695,2,132,3.0,1.3636363636363638,720,588
22400695,2,10,2.0,12.0,477,467
22400695,2,29,-2.0,-4.137931034482759,464,435
22400695,2,53,-3.0,-3.3962264150943398,417,364
22400695,2,34,-2.0,-3.5294117647058822,354,320
22400695,2,122,3.0,1.4754098360655736,306,184
22400695,2,50,2.0,2.4,184,134
22400695,2,111,2.0,1.0810810810810811,111,0
22400695,3,297,-5.0,-1.0101010101010102,720,423
22400695,3,76,1.0,0.7894736842105263,423,347
22400695,3,175,1.0,0.34285714285714286,347,172
22400695,3,50,3.0,3.5999999999999996,166,116
22400695,3,116,0.0,0.0,116,0
22400695,4,71,2.0,1.6901408450704225,720,649
22400695,4,48,2.0,2.5,631,583
22400695,4,93,-6.0,-3.870967741935484,583,490
22400695,4,89,-1.0,-0.6741573033707865,468,379
22400695,4,81,1.0,0.7407407407407407,373,292
22400695,4,121,2.0,0.9917355371900827,292,171
22400695,4,89,4.0,2.696629213483146,171,82
22400695,4,71,-2.0,-1.6901408450704225,71,0
22400696,1,222,7.0,1.8918918918918917,720,498
22400696,1,136,10.0,4.411764705882353,481,345
22400696,1,108,1.0,0.5555555555555556,331,223
22400696,1,44,-3.0,-4.090909090909091,210,166
22400696,1,50,1.0,1.2,166,116
22400696,1,109,13.0,7.155963302752294,109,0
22400696,2,102,4.0,2.3529411764705883,720,618
22400696,2,89,0.0,0.0,618,529
22400696,2,102,2.0,1.1764705882352942,518,416
22400696,2,32,2.0,3.75,416,384
22400696,2,131,-5.0,-2.290076335877863,384,253
22400696,2,37,0.0,0.0,241,204
22400696,2,42,5.0,7.142857142857142,204,162
22400696,2,60,6.0,6.0,154,94
22400696,3,378,1.0,0.15873015873015872,720,342
22400696,3,30,1.0,2.0,342,312
22400696,3,12,0.0,0.0,312,300
22400696,3,45,0.0,0.0,290,245
22400696,3,77,-4.0,-3.116883116883117,237,160
22400696,3,149,4.0,1.610738255033557,149,0
22400696,4,176,7.0,2.3863636363636362,720,544
22400696,4,120,4.0,2.0,537,417
22400696,4,94,-3.0,-1.9148936170212765,399,305
22400696,4,279,-7.0,-1.5053763440860215,279,0
22400697,1,244,5.0,1.2295081967213113,720,476
22400697,1,107,4.0,2.2429906542056073,476,369
22400697,1,106,-5.0,-2.8301886792452833,369,263
22400697,1,12,0.0,0.0,263,251
22400697,1,61,1.0,0.9836065573770493,241,180
22400697,1,83,2.0,1.4457831325301205,180,97
22400697,1,88,-4.0,-2.7272727272727275,97,9
22400697,1,1,0.0,0.0,1,0
22400697,2,214,-3.0,-0.8411214953271028,720,506
22400697,2,12,-2.0,-10.0,492,480
22400697,2,9,0.0,0.0,460,451
22400697,2,36,0.0,0.0,443,407
22400697,2,83,4.0,2.891566265060241,407,324
22400697,2,113,-2.0,-1.0619469026548671,304,191
22400697,2,111,-2.0,-1.0810810810810811,191,80
22400697,2,18,1.0,3.333333333333333,70,52
22400697,2,52,4.0,4.615384615384616,52,0
22400697,3,292,0.0,0.0,720,428
22400697,3,56,4.0,4.285714285714286,421,365
22400697,3,20,1.0,3.0,348,328
22400697,3,26,0.0,0.0,328,302
22400697,3,77,6.0,4.675324675324675,288,211
22400697,3,52,-3.0,-3.4615384615384617,189,137
22400697,3,123,7.0,3.4146341463414633,123,0
22400697,4,222,-3.0,-0.8108108108108109,720,498
22400697,4,56,-3.0,-3.214285714285714,498,442
22400697,4,95,5.0,3.1578947368421053,442,347
22400697,4,50,0.0,0.0,333,283
22400697,4,138,-4.0,-1.7391304347826086,283,145
22400697,4,145,-2.0,-0.8275862068965517,145,0
22400698,1,316,9.0,1.7088607594936709,720,404
22400698,1,61,3.0,2.9508196721311473,386,325
22400698,1,145,-9.0,-3.7241379310344827,325,180
22400698,1,143,5.0,2.097902097902098,175,32
22400698,2,197,3.0,0.9137055837563453,720,523
22400698,2,27,0.0,0.0,508,481
22400698,2,66,6.0,5.454545454545455,471,405
22400698,2,43,-4.0,-5.5813953488372094,393,350
22400698,2,279,-2.0,-0.43010752688172044,350,71
22400698,2,32,4.0,7.5,71,39
22400698,2,39,2.0,3.0769230769230766,39,0
22400698,3,433,4.0,0.5542725173210161,720,287
22400698,3,164,1.0,0.36585365853658536,273,109
22400698,3,48,-3.0,-3.75,106,58
22400698,3,48,-2.0,-2.5,48,0
22400698,4,158,-6.0,-2.278481012658228,720,562
22400698,4,24,-2.0,-5.0,545,521
22400698,4,225,-8.0,-2.1333333333333333,511,286
22400698,4,101,0.0,0.0,286,185
22400698,4,161,-7.0,-2.608695652173913,161,0
22400699,1,328,3.0,0.548780487804878,720,392
22400699,1,13,-1.0,-4.615384615384616,386,373
22400699,1,93,-1.0,-0.6451612903225807,352,259
22400699,1,7,1.0,8.571428571428571,249,242
22400699,1,55,0.0,0.0,242,187
22400699,1,36,-2.0,-3.333333333333333,187,151
22400699,1,18,0.0,0.0,151,133
22400699,1,111,-4.0,-2.1621621621621623,111,0
22400699,2,28,0.0,0.0,720,692
22400699,2,147,6.0,2.4489795918367343,679,532
22400699,2,215,-4.0,-1.1162790697674418,532,317
22400699,2,29,0.0,0.0,317,288
22400699,2,139,3.0,1.2949640287769786,283,144
22400699,2,10,0.0,0.0,131,121
22400699,2,105,0.0,0.0,108,3
22400699,2,2,1.0,30.0,3,1
22400699,3,320,2.0,0.375,720,400
22400699,3,54,3.0,3.333333333333333,392,338
22400699,3,202,0.0,0.0,318,116
22400699,3,26,0.0,0.0,36,10
22400699,3,7,3.0,25.71428571428571,7,0
22400699,4,92,-3.0,-1.9565217391304348,720,628
22400699,4,42,-5.0,-7.142857142857142,628,586
22400699,4,41,0.0,0.0,567,526
22400699,4,129,-1.0,-0.46511627906976744,526,397
22400699,4,126,-2.0,-0.9523809523809523,388,262
22400699,4,34,0.0,0.0,262,228
22400699,4,47,0.0,0.0,227,180
22400699,4,113,-4.0,-2.1238938053097343,173,60
22400700,1,332,-1.0,-0.18072289156626506,720,388
22400700,1,72,-2.0,-1.6666666666666665,376,304
22400700,1,53,-3.0,-3.3962264150943398,304,251
22400700,1,24,0.0,0.0,251,227
22400700,1,40,4.0,6.0,208,168
22400700,1,41,-2.0,-2.926829268292683,151,110
22400700,1,110,-4.0,-2.1818181818181817,110,0
22400700,2,194,-1.0,-0.30927835051546393,720,526
22400700,2,25,-4.0,-9.6,526,501
22400700,2,43,-6.0,-8.372093023255815,501,458
22400700,2,37,4.0,6.486486486486487,421,384
22400700,2,75,-5.0,-4.0,371,296
22400700,2,63,-4.0,-3.8095238095238093,282,219
22400700,2,208,-2.0,-0.576923076923077,208,0
22400700,3,320,7.0,1.3125,720,400
22400700,3,7,0.0,0.0,400,393
22400700,3,65,0.0,0.0,387,322
22400700,3,74,2.0,1.6216216216216217,309,235
22400700,3,230,4.0,1.0434782608695652,230,0
22400700,4,108,-8.0,-4.444444444444445,720,612
22400700,4,158,0.0,0.0,596,438
22400700,4,16,0.0,0.0,438,422
22400700,4,22,2.0,5.454545454545455,422,400
22400700,4,24,2.0,5.0,375,351
22400700,4,307,4.0,0.7817589576547231,351,44
22400700,4,33,-1.0,-1.8181818181818183,33,0
22400701,1,378,4.0,0.6349206349206349,720,342
22400701,1,71,-2.0,-1.6901408450704225,339,268
22400701,1,56,5.0,5.357142857142858,257,201
22400701,1,70,1.0,0.8571428571428571,191,121
22400701,1,21,0.0,0.0,121,100
22400701,1,96,0.0,0.0,96,0
22400701,2,136,-3.0,-1.323529411764706,720,584
22400701,2,67,0.0,0.0,558,491
22400701,2,91,-5.0,-3.2967032967032965,491,400
22400701,2,16,0.0,0.0,400,384
22400701,2,31,-2.0,-3.870967741935484,377,346
22400701,2,162,-2.0,-0.7407407407407407,333,171
22400701,2,141,3.0,1.2765957446808511,171,30
22400701,3,114,8.0,4.2105263157894735,720,606
22400701,3,220,-1.0,-0.2727272727272727,606,386
22400701,3,122,0.0,0.0,386,264
22400701,3,12,2.0,10.0,260,248
22400701,3,62,-2.0,-1.935483870967742,248,186
22400701,3,45,-1.0,-1.3333333333333335,168,123
22400701,3,187,-2.0,-0.6417112299465241,264,77
22400701,3,28,1.0,2.142857142857143,77,49
22400701,3,49,0.0,0.0,49,0
22400701,4,123,-7.0,-3.4146341463414633,720,597
22400701,4,14,-2.0,-8.571428571428571,592,578
22400701,4,56,5.0,5.357142857142858,560,504
22400701,4,31,1.0,1.935483870967742,485,454
22400701,4,43,-2.0,-2.7906976744186047,454,411
22400701,4,287,8.0,1.6724738675958188,407,120
22400701,4,89,-3.0,-2.0224719101123596,120,31
22400702,1,340,-1.0,-0.1764705882352941,720,380
22400702,1,90,-3.0,-2.0,371,281
22400702,1,23,2.0,5.217391304347826,275,252
22400702,1,118,5.0,2.542372881355932,252,134
22400702,1,78,-3.0,-2.307692307692308,120,42
22400702,1,42,0.0,0.0,42,0
22400702,2,177,-9.0,-3.050847457627119,720,543
22400702,2,17,0.0,0.0,530,513
22400702,2,67,-1.0,-0.8955223880597015,513,446
22400702,2,8,-2.0,-15.0,389,381
22400702,2,131,3.0,1.3740458015267176,374,243
22400702,2,122,2.0,0.9836065573770493,243,121
22400702,2,99,4.0,2.4242424242424243,110,11
22400702,2,2,0.0,0.0,2,0
22400702,3,222,4.0,1.0810810810810811,720,498
22400702,3,197,2.0,0.6091370558375634,481,284
22400702,3,70,-2.0,-1.7142857142857142,264,194
22400702,3,11,0.0,0.0,194,183
22400702,3,66,-3.0,-2.7272727272727275,169,103
22400702,3,61,-7.0,-6.885245901639345,89,28
22400702,3,27,0.0,0.0,28,1
22400702,4,195,4.0,1.2307692307692308,720,525
22400702,4,85,-2.0,-1.4117647058823528,525,440
22400702,4,36,2.0,3.333333333333333,440,404
22400702,4,130,2.0,0.9230769230769231,404,274
22400702,4,46,2.0,2.608695652173913,264,218
22400702,4,86,0.0,0.0,218,132
22400702,4,78,5.0,3.846153846153846,132,54
22400702,4,16,-1.0,-3.75,54,38
22400702,4,5,0.0,0.0,27,22
22400702,4,10,0.0,0.0,21,11
22400702,4,1,1.0,60.0,11,10
22400702,4,1,1.0,60.0,7,6
22400702,4,6,0.0,0.0,6,0
22400703,1,195,-3.0,-0.9230769230769231,720,525
22400703,1,80,-4.0,-3.0,514,434
22400703,1,18,3.0,10.0,427,409
22400703,1,37,5.0,8.108108108108109,392,355
22400703,1,91,-4.0,-2.6373626373626378,355,264
22400703,1,30,0.0,0.0,250,220
22400703,1,147,3.0,1.2244897959183672,198,51
22400703,1,44,1.0,1.3636363636363638,44,0
22400703,2,128,-1.0,-0.46875,720,592
22400703,2,115,2.0,1.0434782608695652,592,477
22400703,2,88,4.0,2.7272727272727275,455,367
22400703,2,17,2.0,7.0588235294117645,367,350
22400703,2,111,3.0,1.6216216216216217,350,239
22400703,2,23,0.0,0.0,230,207
22400703,2,97,-10.0,-6.185567010309278,190,93
22400703,2,80,1.0,0.75,80,0
22400703,3,224,-3.0,-0.8035714285714285,720,496
22400703,3,65,1.0,0.9230769230769231,489,424
22400703,3,34,4.0,7.0588235294117645,411,377
22400703,3,51,0.0,0.0,377,326
22400703,3,13,0.0,0.0,313,300
22400703,3,34,0.0,0.0,284,250
22400703,3,50,2.0,2.4,250,200
22400703,3,113,1.0,0.5309734513274336,197,84
22400703,3,67,-3.0,-2.6865671641791042,85,18
22400703,4,154,2.0,0.7792207792207793,720,566
22400703,4,19,1.0,3.1578947368421053,554,535
22400703,4,76,4.0,3.1578947368421053,535,459
22400703,4,93,3.0,1.935483870967742,449,356
22400703,4,28,-2.0,-4.285714285714286,356,328
22400703,4,102,2.0,1.1764705882352942,328,226
22400703,4,31,3.0,5.806451612903226,206,175
22400703,4,52,1.0,1.153846153846154,175,123
22400703,4,26,1.0,2.307692307692308,75,49
22400703,4,49,0.0,0.0,49,0
22400704,1,379,-1.0,-0.15831134564643798,720,341
22400704,1,166,1.0,0.3614457831325301,330,164
22400704,1,51,-2.0,-2.3529411764705883,164,113
22400704,1,103,0.0,0.0,103,0
22400704,2,105,1.0,0.5714285714285715,720,615
22400704,2,110,-6.0,-3.2727272727272725,610,500
22400704,2,79,3.0,2.278481012658228,494,415
22400704,2,61,1.0,0.9836065573770493,402,341
22400704,2,180,-1.0,-0.33333333333333337,204,24
22400704,2,1,0.0,0.0,1,0
22400704,3,157,2.0,0.7643312101910829,720,563
22400704,3,147,-1.0,-0.40816326530612246,550,403
22400704,3,54,2.0,2.2222222222222223,400,346
22400704,3,17,3.0,10.588235294117649,343,326
22400704,3,115,-2.0,-1.0434782608695652,315,200
22400704,3,43,2.0,2.7906976744186047,200,157
22400704,3,138,-1.0,-0.43478260869565216,138,0
22400704,4,90,0.0,0.0,720,630
22400704,4,109,-3.0,-1.651376146788991,617,508
22400704,4,151,0.0,0.0,659,508
22400704,4,82,0.0,0.0,479,397
22400704,4,330,1.0,0.18181818181818182,377,47
22400704,4,17,-2.0,-7.0588235294117645,47,30
22400704,4,16,-1.0,-3.75,22,6
22400704,4,5,3.0,36.0,5,0
22400705,1,309,9.0,1.7475728155339807,720,411
22400705,1,12,0.0,0.0,399,387
22400705,1,35,-1.0,-1.7142857142857142,374,339
22400705,1,163,3.0,1.1042944785276074,325,162
22400705,1,120,1.0,0.5,151,31
22400705,1,25,0.0,0.0,25,0
22400705,2,345,6.0,1.0434782608695652,720,375
22400705,2,19,1.0,3.1578947368421053,354,335
22400705,2,43,-3.0,-4.186046511627907,324,281
22400705,2,188,5.0,1.5957446808510638,266,78
22400705,2,55,5.0,5.454545454545455,55,0
22400705,3,201,5.0,1.492537313432836,720,519
22400705,3,62,1.0,0.967741935483871,515,453
22400705,3,37,0.0,0.0,446,409
22400705,3,32,1.0,1.875,409,377
22400705,3,179,-2.0,-0.670391061452514,377,198
22400705,3,3,0.0,0.0,181,178
22400705,3,131,5.0,2.290076335877863,164,33
22400705,4,194,-4.0,-1.2371134020618557,720,526
22400705,4,458,-10.0,-1.3100436681222707,508,50
22400706,1,251,-4.0,-0.9561752988047809,720,469
22400706,1,55,6.0,6.545454545454545,455,400
22400706,1,124,3.0,1.4516129032258065,389,265
22400706,1,27,-2.0,-4.444444444444445,255,228
22400706,1,135,4.0,1.777777777777778,228,93
22400706,2,271,-2.0,-0.44280442804428044,720,449
22400706,2,41,2.0,2.926829268292683,437,396
22400706,2,163,5.0,1.8404907975460123,384,221
22400706,2,174,-2.0,-0.6896551724137931,207,33
22400706,2,8,1.0,7.5,32,24
22400706,2,21,2.0,5.7142857142857135,24,3
22400706,2,3,0.0,0.0,3,0
22400706,3,325,-4.0,-0.7384615384615385,720,395
22400706,3,58,-3.0,-3.103448275862069,384,326
22400706,3,18,1.0,3.333333333333333,326,308
22400706,3,65,1.0,0.9230769230769231,308,243
22400706,3,46,-3.0,-3.9130434782608696,243,197
22400706,3,100,-5.0,-3.0,197,97
22400706,3,43,0.0,0.0,73,30
22400706,3,9,0.0,0.0,13,4
22400706,3,1,0.0,0.0,1,0
22400706,4,74,6.0,4.864864864864865,720,646
22400706,4,104,-4.0,-2.307692307692308,633,529
22400706,4,31,2.0,3.870967741935484,529,498
22400706,4,19,-4.0,-12.631578947368421,482,463
22400706,4,135,2.0,0.888888888888889,463,328
22400706,4,26,3.0,6.923076923076923,309,283
22400706,4,163,2.0,0.7361963190184049,268,105
22400706,4,91,-2.0,-1.3186813186813189,91,0
22400707,1,164,-1.0,-0.36585365853658536,720,556
22400707,1,187,4.0,1.2834224598930482,539,352
22400707,1,25,3.0,7.199999999999999,352,327
22400707,1,70,6.0,5.142857142857143,319,249
22400707,1,44,0.0,0.0,247,203
22400707,1,94,-2.0,-1.2765957446808511,185,91
22400707,1,83,-3.0,-2.1686746987951806,91,8
22400707,1,5,-1.0,-12.0,8,3
22400707,1,3,2.0,40.0,3,0
22400707,2,246,-1.0,-0.24390243902439027,720,474
22400707,2,90,5.0,3.333333333333333,460,370
22400707,2,95,-1.0,-0.631578947368421,364,269
22400707,2,11,-1.0,-5.454545454545455,260,249
22400707,2,194,-5.0,-1.5463917525773194,249,55
22400707,2,54,0.0,0.0,54,0
22400707,3,360,4.0,0.6666666666666667,720,360
22400707,3,20,0.0,0.0,345,325
22400707,3,75,-1.0,-0.8,325,250
22400707,3,94,2.0,1.2765957446808511,250,156
22400707,3,156,-6.0,-2.307692307692308,156,0
22400707,4,175,2.0,0.6857142857142857,720,545
22400707,4,59,-2.0,-2.0338983050847457,534,475
22400707,4,49,4.0,4.897959183673469,473,424
22400707,4,2,0.0,0.0,412,410
22400707,4,154,-8.0,-3.116883116883117,381,227
22400707,4,212,-6.0,-1.6981132075471699,224,12
22400707,4,5,1.0,12.0,12,7
22400708,1,300,-1.0,-0.2,720,420
22400708,1,50,-2.0,-2.4,415,365
22400708,1,156,4.0,1.5384615384615383,353,197
22400708,1,35,0.0,0.0,182,147
22400708,1,141,-6.0,-2.5531914893617023,145,4
22400708,1,4,3.0,45.0,4,0
22400708,2,135,-1.0,-0.4444444444444445,720,585
22400708,2,76,-2.0,-1.5789473684210527,567,491
22400708,2,11,0.0,0.0,482,471
22400708,2,23,3.0,7.826086956521739,471,448
22400708,2,58,1.0,1.0344827586206897,427,369
22400708,2,48,2.0,2.5,360,312
22400708,2,63,0.0,0.0,274,211
22400708,2,72,-1.0,-0.8333333333333333,207,135
22400708,2,92,4.0,2.608695652173913,119,27
22400708,3,302,10.0,1.9867549668874174,720,418
22400708,3,57,0.0,0.0,397,340
22400708,3,109,-2.0,-1.1009174311926606,340,231
22400708,3,19,-2.0,-6.315789473684211,223,204
22400708,3,40,-2.0,-3.0,204,164
22400708,3,148,5.0,2.027027027027027,148,0
22400708,4,93,-1.0,-0.6451612903225807,720,627
22400708,4,27,-2.0,-4.444444444444445,619,592
22400708,4,37,-3.0,-4.864864864864865,592,555
22400708,4,25,0.0,0.0,544,519
22400708,4,90,0.0,0.0,508,418
22400708,4,44,-2.0,-2.7272727272727275,405,361
22400708,4,78,0.0,0.0,351,273
22400708,4,28,0.0,0.0,267,239
22400708,4,195,7.0,2.1538461538461537,233,38
22400708,4,1,1.0,60.0,33,32
22400708,4,8,-2.0,-15.0,32,24
22400708,4,11,-2.0,-10.90909090909091,24,13
22400708,4,13,0.0,0.0,13,0
22400709,1,423,3.0,0.425531914893617,720,297
22400709,1,90,2.0,1.3333333333333335,287,197
22400709,1,42,2.0,2.8571428571428568,184,142
22400709,1,123,-6.0,-2.926829268292683,130,7
22400709,1,7,0.0,0.0,7,0
22400709,2,180,-6.0,-2.0,720,540
22400709,2,60,1.0,1.0,525,465
22400709,2,31,1.0,1.935483870967742,465,434
22400709,2,43,0.0,0.0,434,391
22400709,2,68,3.0,2.647058823529412,384,316
22400709,2,44,-4.0,-5.454545454545455,306,262
22400709,2,262,-3.0,-0.6870229007633588,262,0
22400709,3,321,2.0,0.37383177570093457,720,399
22400709,3,49,1.0,1.2244897959183672,399,350
22400709,3,154,1.0,0.38961038961038963,350,196
22400709,3,75,1.0,0.8,175,100
22400709,3,100,7.0,4.2,100,0
22400709,4,144,-2.0,-0.8333333333333333,720,576
22400709,4,78,-5.0,-3.846153846153846,568,490
22400709,4,128,-2.0,-0.9375,477,349
22400709,4,190,-3.0,-0.9473684210526316,342,152
22400709,4,110,0.0,0.0,152,42
22400709,4,16,0.0,0.0,37,21
22400709,4,16,2.0,7.5,17,1
22400709,5,262,5.0,1.1450381679389314,300,38
22400709,5,9,1.0,6.666666666666666,16,7
22400709,5,2,-1.0,-30.0,7,5
22400709,5,1,1.0,60.0,4,3
22400709,5,3,0.0,0.0,3,0
22400710,1,315,0.0,0.0,720,405
22400710,1,86,-3.0,-2.0930232558139537,394,308
22400710,1,38,-4.0,-6.315789473684211,287,249
22400710,1,89,1.0,0.6741573033707865,249,160
22400710,1,147,-8.0,-3.2653061224489797,147,0
22400710,2,57,-6.0,-6.315789473684211,720,663
22400710,2,134,3.0,1.3432835820895521,663,529
22400710,2,60,-1.0,-1.0,509,449
22400710,2,114,0.0,0.0,449,335
22400710,2,140,2.0,0.8571428571428571,326,186
22400710,2,186,5.0,1.6129032258064517,186,0
22400710,3,293,-1.0,-0.20477815699658702,720,427
22400710,3,74,5.0,4.054054054054054,416,342
22400710,3,148,0.0,0.0,319,171
22400710,3,118,-1.0,-0.5084745762711864,158,40
22400710,3,33,-2.0,-3.6363636363636367,33,0
22400710,4,114,0.0,0.0,720,606
22400710,4,105,1.0,0.5714285714285715,597,492
22400710,4,27,0.0,0.0,473,446
22400710,4,66,5.0,4.545454545454546,446,380
22400710,4,50,2.0,2.4,380,330
22400710,4,53,0.0,0.0,330,277
22400710,4,118,-6.0,-3.050847457627119,263,145
22400710,4,103,5.0,2.912621359223301,125,22
22400710,4,2,-1.0,-30.0,14,12
22400710,4,12,0.0,0.0,12,0
22400711,1,285,0.0,0.0,720,435
22400711,1,130,1.0,0.46153846153846156,435,305
22400711,1,58,2.0,2.0689655172413794,297,239
22400711,1,64,0.0,0.0,224,160
22400711,1,18,1.0,3.333333333333333,155,137
22400711,1,134,-2.0,-0.8955223880597015,134,0
22400711,2,249,0.0,0.0,720,471
22400711,2,144,3.0,1.25,456,312
22400711,2,56,-3.0,-3.214285714285714,300,244
22400711,2,10,0.0,0.0,221,211
22400711,2,10,0.0,0.0,194,184
22400711,2,163,0.0,0.0,176,13
22400711,2,13,0.0,0.0,13,0
22400711,3,293,-6.0,-1.2286689419795223,720,427
22400711,3,33,0.0,0.0,414,381
22400711,3,21,1.0,2.8571428571428568,373,352
22400711,3,45,2.0,2.666666666666667,352,307
22400711,3,31,3.0,5.806451612903226,296,265
22400711,3,44,0.0,0.0,262,218
22400711,3,188,-2.0,-0.6382978723404256,208,20
22400711,4,108,-1.0,-0.5555555555555556,720,612
22400711,4,48,1.0,1.25,612,564
22400711,4,70,0.0,0.0,564,494
22400711,4,43,-1.0,-1.3953488372093024,488,445
22400711,4,110,-1.0,-0.5454545454545454,445,335
22400711,4,45,-1.0,-1.3333333333333335,323,278
22400711,4,27,1.0,2.2222222222222223,278,251
22400711,4,41,-3.0,-4.390243902439024,251,210
22400711,4,166,0.0,0.0,203,37
22400711,4,9,1.0,6.666666666666666,18,9
22400711,4,5,3.0,36.0,8,3
22400711,4,59,0.0,0.0,59,0
22400712,1,283,6.0,1.2720848056537104,720,437
22400712,1,20,0.0,0.0,437,417
22400712,1,27,2.0,4.444444444444445,404,377
22400712,1,85,-4.0,-2.8235294117647056,365,280
22400712,1,35,2.0,3.4285714285714284,272,237
22400712,1,92,-1.0,-0.6521739130434783,237,145
22400712,1,137,3.0,1.3138686131386863,145,8
22400712,2,209,-7.0,-2.009569377990431,720,511
22400712,2,67,-3.0,-2.6865671641791042,504,437
22400712,2,6,0.0,0.0,420,414
22400712,2,36,-1.0,-1.6666666666666665,402,366
22400712,2,28,0.0,0.0,366,338
22400712,2,51,-2.0,-2.3529411764705883,326,275
22400712,2,69,1.0,0.8695652173913043,275,206
22400712,2,32,-1.0,-1.875,206,174
22400712,2,45,2.0,2.666666666666667,163,118
22400712,2,17,2.0,7.0588235294117645,118,101
22400712,2,89,-4.0,-2.696629213483146,101,12
22400712,2,12,-2.0,-10.0,12,0
22400712,3,288,0.0,0.0,720,432
22400712,3,94,0.0,0.0,432,338
22400712,3,207,9.0,2.608695652173913,331,124
22400712,3,40,1.0,1.5,108,68
22400712,3,25,4.0,9.6,68,43
22400712,3,30,-2.0,-4.0,43,13
22400712,3,13,0.0,0.0,13,0
22400712,4,77,-4.0,-3.116883116883117,720,643
22400712,4,73,-2.0,-1.643835616438356,625,552
22400712,4,58,5.0,5.172413793103448,538,480
22400712,4,84,0.0,0.0,462,378
22400712,4,178,-4.0,-1.348314606741573,378,200
22400712,4,178,2.0,0.6741573033707865,200,22
22400712,4,5,0.0,0.0,15,10
22400712,4,3,0.0,0.0,3,0
22400713,1,304,0.0,0.0,720,416
22400713,1,45,0.0,0.0,396,351
22400713,1,55,4.0,4.363636363636363,349,294
22400713,1,102,1.0,0.5882352941176471,283,181
22400713,1,26,0.0,0.0,174,148
22400713,1,187,-1.0,-0.32085561497326204,197,10
22400713,1,1,0.0,0.0,1,0
22400713,2,89,-3.0,-2.0224719101123596,720,631
22400713,2,41,0.0,0.0,623,582
22400713,2,37,0.0,0.0,582,545
22400713,2,67,-4.0,-3.582089552238806,530,463
22400713,2,111,-2.0,-1.0810810810810811,452,341
22400713,2,37,-1.0,-1.6216216216216217,341,304
22400713,2,10,0.0,0.0,304,294
22400713,2,229,-10.0,-2.6200873362445414,281,52
22400713,2,38,0.0,0.0,52,14
22400713,2,2,0.0,0.0,2,0
22400713,3,364,-1.0,-0.16483516483516486,720,356
22400713,3,106,3.0,1.6981132075471699,356,250
22400713,3,123,3.0,1.4634146341463414,229,106
22400713,3,4,2.0,30.0,92,88
22400713,3,77,-1.0,-0.7792207792207793,88,11
22400713,3,7,-1.0,-8.571428571428571,11,4
22400713,3,4,0.0,0.0,4,0
22400713,4,36,-2.0,-3.333333333333333,720,684
22400713,4,63,2.0,1.9047619047619047,684,621
22400713,4,103,-1.0,-0.5825242718446602,603,500
22400713,4,9,0.0,0.0,500,491
22400713,4,41,3.0,4.390243902439024,483,442
22400713,4,26,2.0,4.615384615384616,423,397
22400713,4,130,1.0,0.46153846153846156,375,245
22400713,4,186,-2.0,-0.6451612903225807,231,45
22400713,4,20,-2.0,-6.0,45,25
22400713,4,24,0.0,0.0,24,0
22400714,1,215,-3.0,-0.8372093023255813,720,505
22400714,1,138,0.0,0.0,500,362
22400714,1,97,-3.0,-1.8556701030927836,308,211
22400714,1,24,3.0,7.5,211,187
22400714,1,50,-2.0,-2.4,171,121
22400714,2,80,2.0,1.5,720,640
22400714,2,141,0.0,0.0,640,499
22400714,2,73,-1.0,-0.821917808219178,499,426
22400714,2,13,2.0,9.230769230769232,411,398
22400714,2,12,-1.0,-5.0,398,386
22400714,2,76,-2.0,-1.5789473684210527,386,310
22400714,2,73,1.0,0.821917808219178,310,237
22400714,2,113,0.0,0.0,226,113
22400714,2,56,-2.0,-2.142857142857143,56,0
22400714,3,258,11.0,2.558139534883721,720,462
22400714,3,47,-4.0,-5.1063829787234045,455,408
22400714,3,39,-3.0,-4.615384615384616,392,353
22400714,3,246,6.0,1.4634146341463414,343,97
22400714,3,97,-5.0,-3.092783505154639,97,0
22400714,4,143,-1.0,-0.4195804195804196,720,577
22400714,4,74,4.0,3.2432432432432434,577,503
22400714,4,38,3.0,4.7368421052631575,503,465
22400714,4,35,-1.0,-1.7142857142857142,446,411
22400714,4,54,-1.0,-1.1111111111111112,411,357
22400714,4,50,-1.0,-1.2,349,299
22400714,4,140,7.0,3.0,299,159
22400714,4,86,-1.0,-0.6976744186046512,141,55
22400714,4,12,1.0,5.0,55,43
22400714,4,41,2.0,2.926829268292683,41,0
22400715,1,173,-3.0,-1.0404624277456647,720,547
22400715,1,114,2.0,1.0526315789473684,535,421
22400715,1,61,1.0,0.9836065573770493,411,350
22400715,1,218,-6.0,-1.651376146788991,350,132
22400715,1,19,1.0,3.1578947368421053,124,105
22400715,1,14,-1.0,-4.285714285714286,105,91
22400715,1,49,-2.0,-2.4489795918367343,91,42
22400715,1,42,-4.0,-5.7142857142857135,42,0
22400715,2,286,-5.0,-1.048951048951049,720,434
22400715,2,65,-2.0,-1.8461538461538463,410,345
22400715,2,31,1.0,1.935483870967742,326,295
22400715,2,28,-1.0,-2.142857142857143,295,267
22400715,2,125,2.0,0.96,267,142
22400715,2,142,-2.0,-0.8450704225352113,142,0
22400715,3,241,6.0,1.4937759336099583,720,479
22400715,3,106,-2.0,-1.1320754716981132,479,373
22400715,3,29,2.0,4.137931034482759,361,332
22400715,3,69,-2.0,-1.7391304347826086,317,248
22400715,3,138,1.0,0.43478260869565216,231,93
22400715,3,10,0.0,0.0,81,71
22400715,3,42,-1.0,-1.4285714285714284,47,5
22400715,3,5,-2.0,-24.0,5,0
22400715,4,221,-2.0,-0.5429864253393666,720,499
22400715,4,38,0.0,0.0,493,455
22400715,4,37,-3.0,-4.864864864864865,455,418
22400715,4,45,-1.0,-1.3333333333333335,404,359
22400715,4,25,0.0,0.0,347,322
22400715,4,58,1.0,1.0344827586206897,314,256
22400716,1,338,-1.0,-0.17751479289940827,720,382
22400716,1,44,-3.0,-4.090909090909091,366,322
22400716,1,57,2.0,2.1052631578947367,308,251
22400716,1,39,3.0,4.615384615384616,241,202
22400716,1,57,2.0,2.1052631578947367,187,130
22400716,1,89,2.0,1.348314606741573,119,30
22400716,1,30,-2.0,-4.0,30,0
22400716,2,179,-4.0,-1.340782122905028,720,541
22400716,2,121,1.0,0.49586776859504134,522,401
22400716,2,179,0.0,0.0,401,222
22400716,2,46,0.0,0.0,209,163
22400716,2,77,1.0,0.7792207792207793,152,75
22400716,3,272,-5.0,-1.1029411764705883,720,448
22400716,3,64,5.0,4.6875,448,384
22400716,3,24,2.0,5.0,365,341
22400716,3,50,0.0,0.0,317,267
22400716,3,26,-1.0,-2.307692307692308,262,236
22400716,3,125,4.0,1.92,226,101
22400716,3,101,-2.0,-1.188118811881188,101,0
22400716,4,55,-2.0,-2.1818181818181817,720,665
22400716,4,54,-1.0,-1.1111111111111112,577,523
22400716,4,46,0.0,0.0,523,477
22400716,4,251,14.0,3.346613545816733,467,216
22400716,4,58,2.0,2.0689655172413794,201,143
22400716,4,124,-2.0,-0.967741935483871,124,0
22400717,1,441,-12.0,-1.6326530612244898,720,279
22400717,1,108,4.0,2.2222222222222223,268,160
22400717,1,74,1.0,0.8108108108108109,146,72
22400717,1,58,-3.0,-3.103448275862069,58,0
22400717,2,139,5.0,2.158273381294964,720,581
22400717,2,98,2.0,1.2244897959183672,581,483
22400717,2,23,1.0,2.608695652173913,466,443
22400717,2,95,-8.0,-5.052631578947368,443,348
22400717,2,82,0.0,0.0,334,252
22400717,2,56,3.0,3.214285714285714,252,196
22400717,2,71,1.0,0.8450704225352113,196,125
22400717,3,305,-7.0,-1.3770491803278688,720,415
22400717,3,30,2.0,4.0,387,357
22400717,3,37,6.0,9.72972972972973,357,320
22400717,3,19,0.0,0.0,296,277
22400717,3,63,-4.0,-3.8095238095238093,277,214
22400717,3,172,2.0,0.6976744186046512,201,29
22400717,3,2,2.0,60.0,5,3
22400717,4,233,-8.0,-2.060085836909871,720,487
22400717,4,52,-5.0,-5.769230769230769,464,412
22400717,4,145,1.0,0.41379310344827586,412,267
22400717,4,9,2.0,13.333333333333332,247,238
22400717,4,123,-1.0,-0.48780487804878053,238,115
22400717,4,115,6.0,3.1304347826086953,115,0
22400718,1,211,-2.0,-0.5687203791469195,720,509
22400718,1,174,5.0,1.7241379310344827,509,335
22400718,1,117,0.0,0.0,324,207
22400718,1,145,-2.0,-0.8275862068965517,186,41
22400718,1,28,-3.0,-6.428571428571428,41,13
22400718,1,2,0.0,0.0,2,0
22400718,2,141,1.0,0.425531914893617,720,579
22400718,2,76,1.0,0.7894736842105263,576,500
22400718,2,33,-3.0,-5.454545454545455,494,461
22400718,2,68,5.0,4.411764705882353,461,393
22400718,2,45,-1.0,-1.3333333333333335,393,348
22400718,2,166,-2.0,-0.7228915662650602,348,182
22400718,2,38,1.0,1.5789473684210527,182,144
22400718,2,37,0.0,0.0,144,107
22400718,2,44,-2.0,-2.7272727272727275,107,63
22400718,2,58,0.0,0.0,58,0
22400718,3,190,2.0,0.631578947368421,720,530
22400718,3,115,3.0,1.5652173913043477,530,415
22400718,3,85,1.0,0.7058823529411764,415,330
22400718,3,16,0.0,0.0,317,301
22400718,3,39,0.0,0.0,287,248
22400718,3,63,-1.0,-0.9523809523809523,236,173
22400718,3,134,0.0,0.0,230,96
22400718,3,75,0.0,0.0,96,21
22400718,3,1,0.0,0.0,1,0
22400718,4,118,-2.0,-1.0169491525423728,720,602
22400718,4,129,-2.0,-0.9302325581395349,602,473
22400718,4,31,4.0,7.741935483870968,456,425
22400718,4,130,3.0,1.3846153846153846,409,279
22400718,4,55,-2.0,-2.1818181818181817,275,220
22400718,4,158,-1.0,-0.37974683544303794,220,62
22400718,4,6,0.0,0.0,62,56
22400718,4,44,6.0,8.181818181818182,56,12
22400718,4,5,2.0,24.0,12,7
22400718,4,1,-2.0,-120.0,7,6
22400718,4,5,-2.0,-24.0,5,0
22400719,1,289,1.0,0.20761245674740486,720,431
22400719,1,12,0.0,0.0,431,419
22400719,1,85,-2.0,-1.4117647058823528,412,327
22400719,1,17,0.0,0.0,309,292
22400719,1,55,-1.0,-1.0909090909090908,290,235
22400719,1,73,-2.0,-1.643835616438356,214,141
22400719,1,42,-2.0,-2.8571428571428568,141,99
22400719,1,99,0.0,0.0,99,0
22400719,2,121,-5.0,-2.479338842975207,720,599
22400719,2,24,1.0,2.5,586,562
22400719,2,38,2.0,3.1578947368421053,562,524
22400719,2,82,-1.0,-0.7317073170731707,517,435
22400719,2,53,-2.0,-2.2641509433962264,415,362
22400719,2,59,1.0,1.0169491525423728,360,301
22400719,2,53,0.0,0.0,295,242
22400719,2,99,2.0,1.2121212121212122,237,138
22400719,2,128,-8.0,-3.75,128,0
22400719,3,310,4.0,0.7741935483870968,720,410
22400719,3,105,0.0,0.0,399,294
22400719,3,91,9.0,5.934065934065933,283,192
22400719,3,21,2.0,5.7142857142857135,177,156
22400719,3,156,-2.0,-0.7692307692307692,156,0
22400719,4,118,-1.0,-0.5084745762711864,720,602
22400719,4,93,5.0,3.2258064516129035,590,497
22400719,4,125,-5.0,-2.4,497,372
22400719,4,61,0.0,0.0,354,293
22400719,4,11,3.0,16.363636363636363,286,275
22400719,4,101,-3.0,-1.782178217821782,263,162
22400719,4,100,6.0,3.5999999999999996,148,48
22400719,4,31,-1.0,-1.935483870967742,48,17
22400719,4,2,0.0,0.0,2,0
22400720,1,195,-5.0,-1.5384615384615383,720,525
22400720,1,156,-4.0,-1.5384615384615383,502,346
22400720,1,31,0.0,0.0,323,292
22400720,1,96,-1.0,-0.625,287,191
22400720,1,37,-3.0,-4.864864864864865,191,154
22400720,1,127,4.0,1.889763779527559,147,20
22400720,1,20,0.0,0.0,20,0
22400720,2,205,2.0,0.5853658536585366,720,515
22400720,2,78,3.0,2.307692307692308,510,432
22400720,2,166,-2.0,-0.7228915662650602,422,256
22400720,2,12,0.0,0.0,236,224
22400720,2,166,-2.0,-0.7228915662650602,188,22
22400720,2,18,0.0,0.0,22,4
22400720,2,2,0.0,0.0,2,0
22400720,3,300,-2.0,-0.4,720,420
22400720,3,46,-3.0,-3.9130434782608696,410,364
22400720,3,152,-1.0,-0.39473684210526316,364,212
22400720,3,94,-3.0,-1.9148936170212765,156,62
22400720,3,34,-2.0,-3.5294117647058822,62,28
22400720,3,15,0.0,0.0,28,13
22400720,3,1,0.0,0.0,1,0
22400720,4,105,-8.0,-4.571428571428572,720,615
22400720,4,121,2.0,0.9917355371900827,598,477
22400720,4,26,2.0,4.615384615384616,458,432
22400720,4,2,0.0,0.0,414,412
22400720,4,126,-1.0,-0.47619047619047616,403,277
22400720,4,155,0.0,0.0,277,122
22400720,4,115,2.0,1.0434782608695652,115,0
22400721,1,269,-6.0,-1.3382899628252787,720,451
22400721,1,28,-2.0,-4.285714285714286,451,423
22400721,1,93,4.0,2.580645161290323,412,319
22400721,1,130,2.0,0.9230769230769231,306,176
22400721,1,33,0.0,0.0,160,127
22400721,1,117,-2.0,-1.0256410256410258,117,0
22400721,2,134,6.0,2.6865671641791042,720,586
22400721,2,57,-2.0,-2.1052631578947367,570,513
22400721,2,88,-1.0,-0.6818181818181819,506,418
22400721,2,62,0.0,0.0,418,356
22400721,2,145,-2.0,-0.8275862068965517,344,199
22400721,2,132,-8.0,-3.6363636363636367,136,4
22400721,2,4,0.0,0.0,4,0
22400721,3,350,0.0,0.0,720,370
22400721,3,84,-2.0,-1.4285714285714284,359,275
22400721,3,44,-2.0,-2.7272727272727275,275,231
22400721,3,141,0.0,0.0,231,90
22400721,3,1,0.0,0.0,74,73
22400721,3,60,3.0,3.0,61,1
22400721,4,197,1.0,0.3045685279187817,720,523
22400721,4,31,1.0,1.935483870967742,523,492
22400721,4,33,-2.0,-3.6363636363636367,492,459
22400721,4,57,0.0,0.0,444,387
22400721,4,362,-2.0,-0.3314917127071823,362,0
22400722,1,385,-2.0,-0.3116883116883117,720,335
22400722,1,79,-2.0,-1.5189873417721518,317,238
22400722,1,32,0.0,0.0,230,198
22400722,1,192,5.0,1.5625,198,6
22400722,2,164,3.0,1.097560975609756,720,556
22400722,2,25,0.0,0.0,543,518
22400722,2,44,-5.0,-6.818181818181818,518,474
22400722,2,67,-3.0,-2.6865671641791042,459,392
22400722,2,15,0.0,0.0,385,370
22400722,2,137,2.0,0.875912408759124,360,223
22400722,2,96,1.0,0.625,211,115
22400722,2,62,1.0,0.967741935483871,115,53
22400722,2,44,-1.0,-1.3636363636363638,53,9
22400722,2,9,0.0,0.0,9,0
22400722,3,323,-13.0,-2.414860681114551,720,397
22400722,3,59,0.0,0.0,383,324
22400722,3,45,-2.0,-2.666666666666667,319,274
22400722,3,14,0.0,0.0,274,260
22400722,3,104,-5.0,-2.8846153846153846,260,156
22400722,3,7,2.0,17.142857142857142,156,149
22400722,3,128,-1.0,-0.46875,149,21
22400722,3,19,0.0,0.0,21,2
22400722,4,69,-1.0,-0.8695652173913043,720,651
22400722,4,98,-4.0,-2.4489795918367343,651,553
22400722,4,95,-4.0,-2.526315789473684,539,444
22400722,4,83,0.0,0.0,432,349
22400722,4,17,-4.0,-14.117647058823529,343,326
22400722,4,40,1.0,1.5,309,269
22400722,4,49,-3.0,-3.673469387755102,269,220
22400723,1,182,6.0,1.978021978021978,720,538
22400723,1,116,6.0,3.103448275862069,530,414
22400723,1,73,3.0,2.4657534246575343,399,326
22400723,1,90,-7.0,-4.666666666666667,314,224
22400723,1,21,0.0,0.0,209,188
22400723,1,185,-4.0,-1.2972972972972974,185,0
22400723,2,63,0.0,0.0,720,657
22400723,2,125,-2.0,-0.96,644,519
22400723,2,98,0.0,0.0,519,421
22400723,2,28,-2.0,-4.285714285714286,403,375
22400723,2,57,-3.0,-3.1578947368421053,372,315
22400723,2,36,-1.0,-1.6666666666666665,313,277
22400723,2,75,0.0,0.0,277,202
22400723,2,189,5.0,1.5873015873015872,189,0
22400723,3,290,1.0,0.20689655172413793,720,430
22400723,3,89,-2.0,-1.348314606741573,416,327
22400723,3,37,1.0,1.6216216216216217,313,276
22400723,3,23,-5.0,-13.043478260869565,269,246
22400723,3,40,4.0,6.0,231,191
22400723,3,135,2.0,0.888888888888889,167,32
22400723,3,32,-2.0,-3.75,32,0
22400723,4,161,4.0,1.4906832298136645,720,559
22400723,4,150,-2.0,-0.8,559,409
22400723,4,20,3.0,9.0,409,389
22400723,4,29,1.0,2.0689655172413794,389,360
22400723,4,38,2.0,3.1578947368421053,360,322
22400723,4,153,-1.0,-0.39215686274509803,302,149
22400723,4,8,0.0,0.0,149,141
22400723,4,82,1.0,0.7317073170731707,141,59
22400723,4,59,2.0,2.0338983050847457,59,0
22400724,1,302,5.0,0.9933774834437087,720,418
22400724,1,65,-1.0,-0.9230769230769231,393,328
22400724,1,65,-5.0,-4.615384615384616,328,263
22400724,1,30,2.0,4.0,250,220
22400724,1,220,7.0,1.909090909090909,220,0
22400724,2,150,-1.0,-0.4,720,570
22400724,2,174,-11.0,-3.7931034482758625,570,396
22400724,2,137,-4.0,-1.751824817518248,383,246
22400724,2,143,5.0,2.097902097902098,246,103
22400724,2,58,2.0,2.0689655172413794,71,13
22400724,2,13,2.0,9.230769230769232,13,0
22400724,3,235,13.0,3.3191489361702127,720,485
22400724,3,87,5.0,3.4482758620689653,468,381
22400724,3,138,3.0,1.3043478260869565,364,226
22400724,3,14,-1.0,-4.285714285714286,226,212
22400724,3,99,2.0,1.2121212121212122,212,113
22400724,3,113,6.0,3.185840707964602,113,0
22400724,4,31,-1.0,-1.935483870967742,720,689
22400724,4,188,5.0,1.5957446808510638,689,501
22400724,4,101,3.0,1.782178217821782,491,390
22400724,4,26,2.0,4.615384615384616,390,364
22400724,4,21,2.0,5.7142857142857135,362,341
22400724,4,39,0.0,0.0,341,302
22400724,4,283,-7.0,-1.4840989399293285,283,0
22400725,1,285,8.0,1.6842105263157896,720,435
22400725,1,72,-1.0,-0.8333333333333333,430,358
22400725,1,49,-2.0,-2.4489795918367343,358,309
22400725,1,16,-2.0,-7.5,304,288
22400725,1,32,0.0,0.0,277,245
22400725,1,37,0.0,0.0,234,197
22400725,1,33,-3.0,-5.454545454545455,188,155
22400725,1,139,-5.0,-2.158273381294964,145,6
22400725,1,2,0.0,0.0,6,4
22400725,2,168,-5.0,-1.7857142857142856,720,552
22400725,2,22,2.0,5.454545454545455,540,518
22400725,2,116,1.0,0.5172413793103449,515,399
22400725,2,1,0.0,0.0,393,392
22400725,2,138,-2.0,-0.8695652173913043,387,249
22400725,2,27,0.0,0.0,233,206
22400725,2,30,0.0,0.0,206,176
22400725,2,124,-1.0,-0.4838709677419355,152,28
22400725,2,21,2.0,5.7142857142857135,21,0
22400725,3,364,0.0,0.0,720,356
22400725,3,86,4.0,2.7906976744186047,343,257
22400725,3,19,0.0,0.0,199,180
22400725,3,68,0.0,0.0,173,105
22400725,3,99,0.0,0.0,99,0
22400725,4,156,5.0,1.923076923076923,720,564
22400725,4,11,0.0,0.0,558,547
22400725,4,71,-3.0,-2.535211267605634,547,476
22400725,4,76,-4.0,-3.1578947368421053,474,398
22400725,4,118,-1.0,-0.5084745762711864,398,280
22400725,4,53,-1.0,-1.1320754716981132,280,227
22400725,4,111,7.0,3.7837837837837833,210,99
22400725,4,75,7.0,5.6000000000000005,85,10
22400725,4,9,0.0,0.0,9,0
22400726,1,261,3.0,0.6896551724137931,720,459
22400726,1,52,0.0,0.0,459,407
22400726,1,136,2.0,0.8823529411764706,407,271
22400726,1,54,-2.0,-2.2222222222222223,264,210
22400726,1,24,0.0,0.0,210,186
22400726,1,18,-4.0,-13.333333333333332,179,161
22400726,1,63,9.0,8.571428571428571,149,86
22400726,1,73,-2.0,-1.643835616438356,75,2
22400726,1,1,-2.0,-120.0,1,0
22400726,2,275,-1.0,-0.21818181818181817,720,445
22400726,2,67,2.0,1.791044776119403,445,378
22400726,2,80,4.0,3.0,366,286
22400726,2,19,0.0,0.0,277,258
22400726,2,35,-1.0,-1.7142857142857142,257,222
22400726,2,208,2.0,0.576923076923077,222,14
22400726,2,5,0.0,0.0,5,0
22400726,3,278,8.0,1.7266187050359714,720,442
22400726,3,21,3.0,8.571428571428571,430,409
22400726,3,123,7.0,3.4146341463414633,401,278
22400726,3,41,2.0,2.926829268292683,278,237
22400726,3,30,-3.0,-6.0,227,197
22400726,3,20,1.0,3.0,156,136
22400726,3,136,7.0,3.0882352941176467,136,0
22400726,4,269,-3.0,-0.6691449814126393,720,451
22400726,4,88,1.0,0.6818181818181819,440,352
22400726,4,15,-1.0,-4.0,352,337
22400726,4,59,2.0,2.0338983050847457,325,266
22400726,4,16,-2.0,-7.5,245,229
22400726,4,52,2.0,2.307692307692308,229,177
22400726,4,11,1.0,5.454545454545455,177,166
22400726,4,39,0.0,0.0,166,127
22400726,4,35,3.0,5.142857142857143,114,79
22400726,4,44,1.0,1.3636363636363638,78,34
22400726,4,34,-1.0,-1.7647058823529411,34,0
22400727,1,315,-5.0,-0.9523809523809523,720,405
22400727,1,150,1.0,0.4,384,234
22400727,1,53,2.0,2.2641509433962264,234,181
22400727,1,21,2.0,5.7142857142857135,178,157
22400727,1,157,0.0,0.0,157,0
22400727,2,100,3.0,1.7999999999999998,720,620
22400727,2,35,-3.0,-5.142857142857143,596,561
22400727,2,47,0.0,0.0,561,514
22400727,2,21,-2.0,-5.7142857142857135,490,469
22400727,2,19,1.0,3.1578947368421053,469,450
22400727,2,42,4.0,5.7142857142857135,450,408
22400727,2,41,0.0,0.0,387,346
22400727,2,229,5.0,1.3100436681222707,334,105
22400727,2,92,-2.0,-1.3043478260869565,93,1
22400727,2,1,0.0,0.0,1,0
22400727,3,105,-8.0,-4.571428571428572,720,615
22400727,3,271,-2.0,-0.44280442804428044,603,332
22400727,3,29,-3.0,-6.206896551724138,332,303
22400727,3,72,0.0,0.0,261,189
22400727,3,46,-3.0,-3.9130434782608696,189,143
22400727,3,16,0.0,0.0,143,127
22400727,3,60,0.0,0.0,115,55
22400727,3,55,0.0,0.0,55,0
22400727,4,173,-4.0,-1.3872832369942196,720,547
22400727,4,38,-4.0,-6.315789473684211,531,493
22400727,4,43,-1.0,-1.3953488372093024,471,428
22400727,4,6,0.0,0.0,428,422
22400727,4,72,-3.0,-2.5,412,340
22400727,4,42,2.0,2.8571428571428568,329,287
22400727,4,271,9.0,1.992619926199262,271,0
22400728,1,244,-8.0,-1.9672131147540985,720,476
22400728,1,80,1.0,0.75,457,377
22400728,1,133,-3.0,-1.3533834586466165,369,236
22400728,1,120,0.0,0.0,236,116
22400728,1,114,-3.0,-1.5789473684210527,114,0
22400728,2,229,-7.0,-1.8340611353711789,720,491
22400728,2,96,-1.0,-0.625,497,401
22400728,2,27,3.0,6.666666666666666,401,374
22400728,2,46,2.0,2.608695652173913,341,295
22400728,2,10,2.0,12.0,280,270
22400728,2,105,-5.0,-2.8571428571428568,270,165
22400728,2,21,6.0,17.142857142857142,162,141
22400728,3,247,-7.0,-1.7004048582995952,720,473
22400728,3,44,-1.0,-1.3636363636363638,462,418
22400728,3,10,0.0,0.0,418,408
22400728,3,76,2.0,1.5789473684210527,396,320
22400728,3,95,-1.0,-0.631578947368421,320,225
22400728,3,36,-1.0,-1.6666666666666665,213,177
22400728,3,27,1.0,2.2222222222222223,164,137
22400728,3,132,-1.0,-0.4545454545454546,137,5
22400728,3,3,0.0,0.0,3,0
22400728,4,145,-3.0,-1.2413793103448276,720,575
22400728,4,51,0.0,0.0,561,510
22400728,4,78,2.0,1.5384615384615383,501,423
22400728,4,55,2.0,2.1818181818181817,413,358
22400728,4,147,5.0,2.0408163265306123,345,198
22400728,4,173,1.0,0.3468208092485549,185,12
22400728,4,8,1.0,7.5,8,0
22400729,1,447,4.0,0.5369127516778524,720,273
22400729,1,33,0.0,0.0,257,224
22400729,1,61,0.0,0.0,216,155
22400729,1,5,0.0,0.0,155,150
22400729,1,30,0.0,0.0,150,120
22400729,1,86,1.0,0.6976744186046512,120,34
22400729,1,10,0.0,0.0,34,24
22400729,1,24,0.0,0.0,24,0
22400729,2,25,-1.0,-2.4,720,695
22400729,2,37,-4.0,-6.486486486486487,527,490
22400729,2,77,2.0,1.5584415584415585,479,402
22400729,2,176,0.0,0.0,394,218
22400729,2,97,-1.0,-0.6185567010309279,218,121
22400729,2,69,0.0,0.0,105,36
22400729,2,33,-3.0,-5.454545454545455,36,3
22400729,3,290,3.0,0.6206896551724138,720,430
22400729,3,101,0.0,0.0,417,316
22400729,3,77,0.0,0.0,309,232
22400729,3,131,2.0,0.916030534351145,232,101
22400729,3,66,1.0,0.9090909090909092,96,30
22400729,3,30,-3.0,-6.0,30,0
22400729,4,158,4.0,1.5189873417721518,720,562
22400729,4,71,0.0,0.0,560,489
22400729,4,24,1.0,2.5,489,465
22400729,4,17,0.0,0.0,455,438
22400729,4,32,1.0,1.875,438,406
22400729,4,75,0.0,0.0,406,331
22400729,4,48,2.0,2.5,315,267
22400729,4,108,4.0,2.2222222222222223,267,159
22400729,4,159,6.0,2.2641509433962264,159,0
22400730,1,329,-4.0,-0.729483282674772,720,391
22400730,1,110,-2.0,-1.0909090909090908,381,271
22400730,1,34,0.0,0.0,271,237
22400730,1,91,2.0,1.3186813186813189,226,135
22400730,1,3,1.0,20.0,118,115
22400730,1,63,3.0,2.8571428571428568,115,52
22400730,1,7,0.0,0.0,36,29
22400730,2,196,3.0,0.9183673469387755,720,524
22400730,2,80,0.0,0.0,507,427
22400730,2,63,5.0,4.761904761904762,412,349
22400730,2,107,2.0,1.1214953271028036,349,242
22400730,2,235,2.0,0.5106382978723404,242,7
22400730,2,7,0.0,0.0,7,0
22400730,3,284,8.0,1.6901408450704225,720,436
22400730,3,143,0.0,0.0,417,274
22400730,3,48,4.0,5.0,274,226
22400730,3,156,7.0,2.6923076923076925,226,70
22400730,3,49,-3.0,-3.673469387755102,49,0
22400730,4,272,4.0,0.8823529411764706,720,448
22400730,4,37,2.0,3.2432432432432434,438,401
22400730,4,104,2.0,1.153846153846154,394,290
22400730,4,4,0.0,0.0,279,275
22400730,4,272,-9.0,-1.9852941176470589,272,0
22400731,1,319,7.0,1.316614420062696,720,401
22400731,1,15,0.0,0.0,389,374
22400731,1,134,3.0,1.3432835820895521,364,230
22400731,1,39,2.0,3.0769230769230766,225,186
22400731,1,115,-3.0,-1.5652173913043477,172,57
22400731,1,47,2.0,2.5531914893617023,49,2
22400731,1,1,0.0,0.0,1,0
22400731,2,173,9.0,3.121387283236994,720,547
22400731,2,35,1.0,1.7142857142857142,534,499
22400731,2,52,0.0,0.0,499,447
22400731,2,81,0.0,0.0,438,357
22400731,2,72,-1.0,-0.8333333333333333,339,267
22400731,2,41,-4.0,-5.853658536585366,267,226
22400731,2,48,4.0,5.0,175,127
22400731,2,90,-4.0,-2.666666666666667,113,23
22400731,2,1,0.0,0.0,3,2
22400731,2,1,0.0,0.0,1,0
22400731,3,126,-7.0,-3.333333333333333,720,594
22400731,3,140,-1.0,-0.42857142857142855,594,454
22400731,3,39,1.0,1.5384615384615383,446,407
22400731,3,64,-3.0,-2.8125,407,343
22400731,3,23,0.0,0.0,343,320
22400731,3,217,-2.0,-0.5529953917050692,521,304
22400731,3,39,0.0,0.0,304,265
22400731,3,48,0.0,0.0,257,209
22400731,3,40,-2.0,-3.0,209,169
22400731,3,78,3.0,2.307692307692308,169,91
22400731,3,77,1.0,0.7792207792207793,91,14
22400731,3,5,2.0,24.0,5,0
22400731,4,54,2.0,2.2222222222222223,720,666
22400731,4,74,-5.0,-4.054054054054054,661,587
22400731,4,25,2.0,4.8,587,562
22400731,4,61,-1.0,-0.9836065573770493,559,498
22400731,4,16,0.0,0.0,498,482
22400731,4,94,0.0,0.0,476,382
22400731,4,23,-2.0,-5.217391304347826,382,359
22400731,4,41,1.0,1.4634146341463414,341,300
22400731,4,89,-4.0,-2.696629213483146,300,211
22400731,4,98,0.0,0.0,98,0
22400732,1,309,-8.0,-1.5533980582524272,720,411
22400732,1,214,5.0,1.4018691588785046,379,165
22400732,1,91,2.0,1.3186813186813189,151,60
22400732,1,60,0.0,0.0,60,0
22400732,2,123,3.0,1.4634146341463414,720,597
22400732,2,84,4.0,2.8571428571428568,594,510
22400732,2,66,-3.0,-2.7272727272727275,496,430
22400732,2,89,4.0,2.696629213483146,430,341
22400732,2,129,1.0,0.46511627906976744,325,196
22400732,3,273,-5.0,-1.098901098901099,720,447
22400732,3,34,-1.0,-1.7647058823529411,447,413
22400732,3,122,-4.0,-1.9672131147540985,402,280
22400732,3,60,0.0,0.0,266,206
22400732,3,82,2.0,1.4634146341463414,206,124
22400732,3,117,8.0,4.102564102564103,117,0
22400732,4,154,0.0,0.0,720,566
22400732,4,124,-1.0,-0.4838709677419355,566,442
22400732,4,27,0.0,0.0,433,406
22400732,4,169,1.0,0.35502958579881655,396,227
22400732,4,45,1.0,1.3333333333333335,227,182
22400732,4,83,3.0,2.1686746987951806,165,82
22400732,4,40,3.0,4.5,76,36
22400732,4,36,0.0,0.0,36,0
22400733,1,347,6.0,1.037463976945245,720,373
22400733,1,69,-1.0,-0.8695652173913043,366,297
22400733,1,128,8.0,3.75,297,169
22400733,1,151,5.0,1.9867549668874174,151,0
22400733,2,189,-8.0,-2.5396825396825395,720,531
22400733,2,83,-4.0,-2.891566265060241,513,430
22400733,2,38,2.0,3.1578947368421053,430,392
22400733,2,108,1.0,0.5555555555555556,379,271
22400733,2,84,5.0,3.571428571428571,271,187
22400733,2,166,-17.0,-6.144578313253012,180,14
22400733,2,5,0.0,0.0,5,0
22400733,3,191,-7.0,-2.1989528795811517,720,529
22400733,3,94,3.0,1.9148936170212765,518,424
22400733,3,66,1.0,0.9090909090909092,424,358
22400733,3,40,1.0,1.5,326,286
22400733,3,45,-1.0,-1.3333333333333335,286,241
22400733,3,72,3.0,2.5,238,166
22400733,3,61,7.0,6.885245901639345,150,89
22400733,4,156,-3.0,-1.153846153846154,720,564
22400733,4,91,1.0,0.6593406593406594,564,473
22400733,4,65,0.0,0.0,460,395
22400733,4,19,-1.0,-3.1578947368421053,395,376
22400733,4,189,0.0,0.0,376,187
22400733,4,73,-5.0,-4.10958904109589,174,101
22400733,4,101,-3.0,-1.782178217821782,101,0
22400734,1,334,11.0,1.976047904191617,720,386
22400734,1,61,3.0,2.9508196721311473,381,320
22400734,1,69,4.0,3.4782608695652173,302,233
22400734,1,17,2.0,7.0588235294117645,218,201
22400734,1,173,-4.0,-1.3872832369942196,201,28
22400734,1,28,0.0,0.0,28,0
22400734,2,149,4.0,1.610738255033557,720,571
22400734,2,44,-3.0,-4.090909090909091,556,512
22400734,2,45,2.0,2.666666666666667,503,458
22400734,2,90,-2.0,-1.3333333333333335,445,355
22400734,2,83,3.0,2.1686746987951806,345,262
22400734,2,22,0.0,0.0,255,233
22400734,2,71,8.0,6.76056338028169,220,149
22400734,2,126,-1.0,-0.47619047619047616,133,7
22400734,3,288,1.0,0.20833333333333331,720,432
22400734,3,50,-2.0,-2.4,413,363
22400734,3,46,0.0,0.0,348,302
22400734,3,88,3.0,2.0454545454545454,302,214
22400734,3,142,3.0,1.267605633802817,214,72
22400734,3,9,-1.0,-6.666666666666666,56,47
22400734,4,219,-1.0,-0.273972602739726,720,501
22400734,4,14,-3.0,-12.857142857142856,493,479
22400734,4,25,1.0,2.4,464,439
22400734,4,36,-5.0,-8.333333333333334,427,391
22400734,4,193,-3.0,-0.9326424870466321,391,198
22400734,4,46,-2.0,-2.608695652173913,198,152
22400734,4,141,-3.0,-1.2765957446808511,148,7
22400735,1,320,3.0,0.5625,720,400
22400735,1,17,-2.0,-7.0588235294117645,400,383
22400735,1,89,-4.0,-2.696629213483146,383,294
22400735,1,13,-1.0,-4.615384615384616,279,266
22400735,1,57,3.0,3.1578947368421053,266,209
22400735,1,99,-3.0,-1.8181818181818183,209,110
22400735,1,88,-4.0,-2.7272727272727275,93,5
22400735,2,198,3.0,0.9090909090909092,720,522
22400735,2,27,-3.0,-6.666666666666666,510,483
22400735,2,38,1.0,1.5789473684210527,463,425
22400735,2,89,-1.0,-0.6741573033707865,488,399
22400735,2,39,6.0,9.230769230769232,389,350
22400735,2,14,0.0,0.0,234,220
22400735,2,66,2.0,1.8181818181818183,220,154
22400735,2,126,2.0,0.9523809523809523,154,28
22400735,3,291,-2.0,-0.41237113402061853,720,429
22400735,3,89,-5.0,-3.3707865168539324,415,326
22400735,3,23,1.0,2.608695652173913,317,294
22400735,3,47,0.0,0.0,294,247
22400735,3,2,0.0,0.0,237,235
22400735,3,29,1.0,2.0689655172413794,212,183
22400735,3,67,2.0,1.791044776119403,167,100
22400735,3,89,-2.0,-1.348314606741573,100,11
22400735,3,11,-2.0,-10.90909090909091,11,0
22400735,4,87,-5.0,-3.4482758620689653,720,633
22400735,4,41,-3.0,-4.390243902439024,633,592
22400735,4,159,-3.0,-1.1320754716981132,586,427
22400735,4,84,-1.0,-0.7142857142857142,427,343
22400735,4,61,0.0,0.0,329,268
22400735,4,157,-4.0,-1.5286624203821657,263,106
22400735,4,95,4.0,2.526315789473684,95,0
22400736,1,322,-5.0,-0.9316770186335404,720,398
22400736,1,15,0.0,0.0,391,376
22400736,1,58,2.0,2.0689655172413794,359,301
22400736,1,45,6.0,8.0,288,243
22400736,1,90,5.0,3.333333333333333,228,138
22400736,1,138,3.0,1.3043478260869565,138,0
22400736,2,265,-7.0,-1.5849056603773586,720,455
22400736,2,14,0.0,0.0,440,426
22400736,2,46,-5.0,-6.521739130434782,416,370
22400736,2,91,-7.0,-4.615384615384616,358,267
22400736,2,25,2.0,4.8,244,219
22400736,2,19,-1.0,-3.1578947368421053,214,195
22400736,2,174,-8.0,-2.7586206896551726,195,21
22400736,2,16,1.0,3.75,21,5
22400736,2,5,0.0,0.0,5,0
22400736,3,406,7.0,1.0344827586206897,720,314
22400736,3,41,2.0,2.926829268292683,303,262
22400736,3,64,4.0,3.75,250,186
22400736,3,28,0.0,0.0,178,150
22400736,4,175,2.0,0.6857142857142857,720,545
22400736,4,47,-1.0,-1.2765957446808511,519,472
22400736,4,100,4.0,2.4,472,372
22400736,4,112,-3.0,-1.607142857142857,358,246
22400736,4,137,3.0,1.3138686131386863,246,109
22400736,4,69,0.0,0.0,92,23
22400736,4,4,1.0,15.0,19,15
22400737,1,322,-6.0,-1.1180124223602486,720,398
22400737,1,135,8.0,3.555555555555556,388,253
22400737,1,30,0.0,0.0,237,207
22400737,1,72,6.0,5.0,207,135
22400737,1,131,-2.0,-0.916030534351145,131,0
22400737,2,219,-4.0,-1.095890410958904,720,501
22400737,2,40,2.0,3.0,490,450
22400737,2,34,0.0,0.0,445,411
22400737,2,17,0.0,0.0,402,385
22400737,2,180,-2.0,-0.6666666666666667,383,203
22400737,2,111,2.0,1.0810810810810811,203,92
22400737,2,85,4.0,2.8235294117647056,92,7
22400737,2,7,0.0,0.0,7,0
22400737,3,186,-7.0,-2.2580645161290325,720,534
22400737,3,103,-2.0,-1.1650485436893203,521,418
22400737,3,36,-2.0,-3.333333333333333,417,381
22400737,3,28,1.0,2.142857142857143,375,347
22400737,3,106,3.0,1.6981132075471699,333,227
22400737,3,127,-3.0,-1.4173228346456692,216,89
22400737,3,80,0.0,0.0,85,5
22400737,4,233,8.0,2.060085836909871,720,487
22400737,4,37,2.0,3.2432432432432434,479,442
22400737,4,60,-3.0,-3.0,442,382
22400737,4,21,0.0,0.0,371,350
22400737,4,178,6.0,2.0224719101123596,331,153
22400737,4,12,0.0,0.0,148,136
22400737,4,10,-1.0,-6.0,114,104
22400737,4,35,2.0,3.4285714285714284,104,69
22400737,4,63,2.0,1.9047619047619047,63,0
22400738,1,353,13.0,2.2096317280453257,720,367
22400738,1,67,0.0,0.0,353,286
22400738,1,87,1.0,0.6896551724137931,277,190
22400738,1,104,-3.0,-1.7307692307692308,190,86
22400738,1,83,1.0,0.7228915662650602,86,3
22400738,2,201,3.0,0.8955223880597015,720,519
22400738,2,23,1.0,2.608695652173913,517,494
22400738,2,121,4.0,1.9834710743801653,494,373
22400738,2,67,3.0,2.6865671641791042,361,294
22400738,2,37,2.0,3.2432432432432434,294,257
22400738,2,44,-1.0,-1.3636363636363638,243,199
22400738,2,179,-2.0,-0.670391061452514,199,20
22400738,2,11,2.0,10.90909090909091,11,0
22400738,3,137,3.0,1.3138686131386863,720,583
22400738,3,92,-4.0,-2.608695652173913,565,473
22400738,3,93,-3.0,-1.935483870967742,469,376
22400738,3,105,-6.0,-3.4285714285714284,376,271
22400738,3,62,-2.0,-1.935483870967742,312,250
22400738,3,118,5.0,2.542372881355932,250,132
22400738,3,122,0.0,0.0,122,0
22400738,4,118,-2.0,-1.0169491525423728,720,602
22400738,4,33,5.0,9.090909090909092,576,543
22400738,4,34,-3.0,-5.294117647058824,521,487
22400738,4,48,-2.0,-2.5,473,425
22400738,4,61,0.0,0.0,400,339
22400738,4,200,4.0,1.2,331,131
22400738,4,92,-3.0,-1.9565217391304348,113,21
22400739,1,313,2.0,0.38338658146964855,720,407
22400739,1,16,0.0,0.0,393,377
22400739,1,45,2.0,2.666666666666667,368,323
22400739,1,35,1.0,1.7142857142857142,317,282
22400739,1,88,-1.0,-0.6818181818181819,277,189
22400739,1,189,4.0,1.2698412698412698,189,0
22400739,2,111,-3.0,-1.6216216216216217,720,609
22400739,2,35,0.0,0.0,597,562
22400739,2,70,-2.0,-1.7142857142857142,546,476
22400739,2,28,0.0,0.0,474,446
22400739,2,135,8.0,3.555555555555556,443,308
22400739,2,29,1.0,2.0689655172413794,308,279
22400739,2,91,2.0,1.3186813186813189,279,188
22400739,2,100,-1.0,-0.6,188,88
22400739,3,249,0.0,0.0,720,471
22400739,3,48,2.0,2.5,458,410
22400739,3,102,0.0,0.0,410,308
22400739,3,64,-2.0,-1.875,308,244
22400739,3,78,-1.0,-0.7692307692307692,215,137
22400739,3,137,0.0,0.0,137,0
22400739,4,236,-1.0,-0.2542372881355932,720,484
22400739,4,43,3.0,4.186046511627907,467,424
22400739,4,22,2.0,5.454545454545455,424,402
22400739,4,112,4.0,2.142857142857143,394,282
22400739,4,18,3.0,10.0,277,259
22400739,4,138,-4.0,-1.7391304347826086,244,106
22400739,4,106,-5.0,-2.8301886792452833,106,0
22400740,1,294,-5.0,-1.0204081632653061,720,426
22400740,1,49,-3.0,-3.673469387755102,416,367
22400740,1,11,0.0,0.0,367,356
22400740,1,108,1.0,0.5555555555555556,356,248
22400740,1,37,-2.0,-3.2432432432432434,237,200
22400740,1,113,-2.0,-1.0619469026548671,198,85
22400740,1,10,0.0,0.0,80,70
22400740,2,99,1.0,0.6060606060606061,720,621
22400740,2,52,0.0,0.0,611,559
22400740,2,84,2.0,1.4285714285714284,556,472
22400740,2,25,2.0,4.8,464,439
22400740,2,11,0.0,0.0,429,418
22400740,2,16,-2.0,-7.5,406,390
22400740,2,78,5.0,3.846153846153846,375,297
22400740,2,169,-2.0,-0.7100591715976331,297,128
22400740,3,259,-7.0,-1.6216216216216217,720,461
22400740,3,130,5.0,2.307692307692308,461,331
22400740,3,40,3.0,4.5,331,291
22400740,3,112,1.0,0.5357142857142857,291,179
22400740,3,25,1.0,2.4,166,141
22400740,3,141,-1.0,-0.425531914893617,141,0
22400740,4,204,6.0,1.7647058823529411,720,516
22400740,4,2,0.0,0.0,472,470
22400740,4,24,0.0,0.0,463,439
22400740,4,172,-3.0,-1.0465116279069768,418,246
22400740,4,23,0.0,0.0,246,223
22400740,4,12,0.0,0.0,211,199
22400740,4,186,-3.0,-0.967741935483871,187,1
22400740,5,300,5.0,1.0,300,0
22400741,1,332,5.0,0.9036144578313253,720,388
22400741,1,78,1.0,0.7692307692307692,388,310
22400741,1,25,-2.0,-4.8,310,285
22400741,1,53,4.0,4.528301886792453,277,224
22400741,1,59,4.0,4.067796610169491,208,149
22400741,1,96,-2.0,-1.25,132,36
22400741,1,36,0.0,0.0,36,0
22400741,2,157,2.0,0.7643312101910829,720,563
22400741,2,13,-1.0,-4.615384615384616,563,550
22400741,2,41,-2.0,-2.926829268292683,537,496
22400741,2,18,0.0,0.0,496,478
22400741,2,191,9.0,2.8272251308900525,478,287
22400741,2,97,-5.0,-3.092783505154639,271,174
22400741,2,104,4.0,2.307692307692308,174,70
22400741,2,66,-1.0,-0.9090909090909092,66,0
22400741,3,230,-8.0,-2.0869565217391304,720,490
22400741,3,12,-1.0,-5.0,471,459
22400741,3,118,-3.0,-1.5254237288135595,459,341
22400741,3,86,3.0,2.0930232558139537,331,245
22400741,3,40,3.0,4.5,241,201
22400741,3,31,0.0,0.0,201,170
22400741,3,58,2.0,2.0689655172413794,155,97
22400741,3,54,1.0,1.1111111111111112,90,36
22400741,3,25,-2.0,-4.8,25,0
22400741,4,167,4.0,1.437125748502994,720,553
22400741,4,43,-1.0,-1.3953488372093024,553,510
22400741,4,24,0.0,0.0,510,486
22400741,4,38,0.0,0.0,476,438
22400741,4,16,0.0,0.0,430,414
22400741,4,38,-2.0,-3.1578947368421053,403,365
22400741,4,158,1.0,0.37974683544303794,365,207
22400741,4,62,-2.0,-1.935483870967742,190,128
22400741,4,36,3.0,5.0,124,88
22400741,4,42,1.0,1.4285714285714284,79,37
22400741,4,32,2.0,3.75,32,0
22400742,1,110,3.0,1.6363636363636362,720,610
22400742,1,303,12.0,2.376237623762376,606,303
22400742,1,61,2.0,1.9672131147540985,303,242
22400742,1,44,0.0,0.0,223,179
22400742,1,44,1.0,1.3636363636363638,179,135
22400742,1,124,0.0,0.0,124,0
22400742,2,197,-3.0,-0.9137055837563453,720,523
22400742,2,93,5.0,3.2258064516129035,523,430
22400742,2,57,0.0,0.0,416,359
22400742,2,68,0.0,0.0,350,282
22400742,2,34,0.0,0.0,282,248
22400742,2,48,-2.0,-2.5,229,181
22400742,2,79,1.0,0.7594936708860759,181,102
22400742,2,49,-3.0,-3.673469387755102,87,38
22400742,2,11,-1.0,-5.454545454545455,15,4
22400742,2,4,0.0,0.0,4,0
22400742,3,76,-1.0,-0.7894736842105263,720,644
22400742,3,131,-9.0,-4.122137404580153,644,513
22400742,3,121,2.0,0.9917355371900827,513,392
22400742,3,173,7.0,2.4277456647398843,392,219
22400742,3,85,4.0,2.8235294117647056,219,134
22400742,3,16,-1.0,-3.75,134,118
22400742,3,112,-7.0,-3.75,112,0
22400742,4,147,4.0,1.6326530612244898,720,573
22400742,4,87,2.0,1.3793103448275863,557,470
22400742,4,3,2.0,40.0,460,457
22400742,4,48,2.0,2.5,431,383
22400742,4,133,-8.0,-3.6090225563909772,383,250
22400742,4,54,0.0,0.0,248,194
22400742,4,49,1.0,1.2244897959183672,185,136
22400742,4,106,-5.0,-2.8301886792452833,136,30
22400742,4,30,2.0,4.0,30,0
22400743,1,292,-5.0,-1.0273972602739725,720,428
22400743,1,55,-1.0,-1.0909090909090908,411,356
22400743,1,40,-6.0,-9.0,346,306
22400743,1,80,-2.0,-1.5,290,210
22400743,1,79,3.0,2.278481012658228,210,131
22400743,1,131,5.0,2.290076335877863,131,0
22400743,2,250,-7.0,-1.68,720,470
22400743,2,90,6.0,4.0,447,357
22400743,2,180,1.0,0.33333333333333337,339,159
22400743,2,145,-2.0,-0.8275862068965517,159,14
22400743,2,8,0.0,0.0,8,0
22400743,3,305,2.0,0.39344262295081966,720,415
22400743,3,84,-5.0,-3.571428571428571,408,324
22400743,3,16,-1.0,-3.75,324,308
22400743,3,53,1.0,1.1320754716981132,308,255
22400743,3,30,-4.0,-8.0,255,225
22400743,3,27,-2.0,-4.444444444444445,225,198
22400743,3,111,2.0,1.0810810810810811,198,87
22400743,3,87,5.0,3.4482758620689653,87,0
22400743,4,200,0.0,0.0,720,520
22400743,4,222,4.0,1.0810810810810811,498,276
22400743,4,41,-5.0,-7.317073170731707,276,235
22400743,4,195,7.0,2.1538461538461537,219,24
22400744,1,306,-4.0,-0.7843137254901961,720,414
22400744,1,55,4.0,4.363636363636363,402,347
22400744,1,20,0.0,0.0,341,321
22400744,1,2,1.0,30.0,306,304
22400744,1,135,3.0,1.3333333333333335,304,169
22400744,1,161,1.0,0.37267080745341613,161,0
22400744,2,171,-3.0,-1.0526315789473684,720,549
22400744,2,56,0.0,0.0,538,482
22400744,2,31,-4.0,-7.741935483870968,470,439
22400744,2,19,0.0,0.0,427,408
22400744,2,90,2.0,1.3333333333333335,401,311
22400744,2,54,2.0,2.2222222222222223,311,257
22400744,2,178,-5.0,-1.6853932584269662,247,69
22400744,2,61,-4.0,-3.934426229508197,69,8
22400744,2,7,0.0,0.0,8,1
22400744,3,215,-9.0,-2.511627906976744,720,505
22400744,3,143,-1.0,-0.4195804195804196,490,347
22400744,3,29,2.0,4.137931034482759,329,300
22400744,3,63,1.0,0.9523809523809523,300,237
22400744,3,71,-2.0,-1.6901408450704225,237,166
22400744,3,35,-2.0,-3.4285714285714284,166,131
22400744,3,124,-4.0,-1.935483870967742,124,0
22400744,4,185,3.0,0.972972972972973,720,535
22400744,4,79,5.0,3.79746835443038,520,441
22400744,4,84,-2.0,-1.4285714285714284,430,346
22400744,4,160,-2.0,-0.75,327,167
22400744,4,52,-2.0,-2.307692307692308,152,100
22400744,4,84,0.0,0.0,84,0
22400745,1,258,1.0,0.23255813953488372,720,462
22400745,1,112,-1.0,-0.5357142857142857,456,344
22400745,1,58,-1.0,-1.0344827586206897,340,282
22400745,1,33,0.0,0.0,282,249
22400745,1,84,-1.0,-0.7142857142857142,248,164
22400745,1,163,1.0,0.36809815950920244,163,0
22400745,2,138,7.0,3.0434782608695654,720,582
22400745,2,11,3.0,16.363636363636363,571,560
22400745,2,43,5.0,6.976744186046512,539,496
22400745,2,294,3.0,0.6122448979591836,645,351
22400745,2,23,2.0,5.217391304347826,338,315
22400745,2,68,-5.0,-4.411764705882353,315,247
22400745,2,42,0.0,0.0,227,185
22400745,2,149,6.0,2.4161073825503356,185,36
22400745,2,12,-1.0,-5.0,36,24
22400745,2,1,0.0,0.0,1,0
22400745,3,156,7.0,2.6923076923076925,720,564
22400745,3,115,-4.0,-2.0869565217391304,564,449
22400745,3,68,0.0,0.0,449,381
22400745,3,29,-10.0,-20.689655172413794,381,352
22400745,3,112,-7.0,-3.75,112,0
22400745,4,10,0.0,0.0,720,710
22400745,4,36,-2.0,-3.333333333333333,705,669
22400745,4,13,0.0,0.0,669,656
22400745,4,84,-5.0,-3.571428571428571,638,554
22400745,4,102,-9.0,-5.294117647058824,554,452
22400745,4,11,0.0,0.0,444,433
22400745,4,191,-8.0,-2.513089005235602,424,233
22400745,4,220,1.0,0.2727272727272727,220,0
22400746,1,311,-6.0,-1.157556270096463,720,409
22400746,1,24,-1.0,-2.5,409,385
22400746,1,52,-5.0,-5.769230769230769,372,320
22400746,1,32,-1.0,-1.875,320,288
22400746,1,119,-3.0,-1.5126050420168067,288,169
22400746,1,120,2.0,1.0,156,36
22400746,1,20,0.0,0.0,21,1
22400746,2,237,-2.0,-0.5063291139240506,720,483
22400746,2,45,0.0,0.0,469,424
22400746,2,39,2.0,3.0769230769230766,424,385
22400746,2,56,-5.0,-5.357142857142858,373,317
22400746,2,42,-1.0,-1.4285714285714284,317,275
22400746,2,130,1.0,0.46153846153846156,275,145
22400746,2,55,-5.0,-5.454545454545455,129,74
22400746,3,133,1.0,0.45112781954887216,720,587
22400746,3,137,-9.0,-3.9416058394160585,563,426
22400746,3,15,2.0,8.0,408,393
22400746,3,73,2.0,1.643835616438356,393,320
22400746,3,52,-2.0,-2.307692307692308,320,268
22400746,3,15,0.0,0.0,268,253
22400746,3,29,-5.0,-10.344827586206897,243,214
22400746,3,135,1.0,0.4444444444444445,214,79
22400746,3,76,2.0,1.5789473684210527,79,3
22400746,3,3,4.0,80.0,3,0
22400746,4,194,8.0,2.4742268041237114,720,526
22400746,4,81,0.0,0.0,526,445
22400746,4,53,-2.0,-2.2641509433962264,430,377
22400746,4,142,2.0,0.8450704225352113,364,222
22400746,4,2,0.0,0.0,222,220
22400746,4,152,0.0,0.0,204,52
22400746,4,3,0.0,0.0,52,49
22400746,4,34,0.0,0.0,34,0
22400747,1,287,-1.0,-0.20905923344947736,720,433
22400747,1,60,3.0,3.0,425,365
22400747,1,44,2.0,2.7272727272727275,344,300
22400747,1,44,-1.0,-1.3636363636363638,286,242
22400747,1,70,-2.0,-1.7142857142857142,242,172
22400747,1,161,-3.0,-1.1180124223602486,161,0
22400747,2,113,-5.0,-2.6548672566371683,720,607
22400747,2,61,-4.0,-3.934426229508197,607,546
22400747,2,53,-2.0,-2.2641509433962264,541,488
22400747,2,22,-2.0,-5.454545454545455,476,454
22400747,2,155,1.0,0.3870967741935484,443,288
22400747,2,62,-5.0,-4.838709677419355,288,226
22400747,2,74,0.0,0.0,226,152
22400747,2,138,0.0,0.0,138,0
22400747,3,266,6.0,1.3533834586466165,720,454
22400747,3,157,1.0,0.3821656050955414,448,291
22400747,3,49,2.0,2.4489795918367343,291,242
22400747,3,21,0.0,0.0,232,211
22400747,3,33,-1.0,-1.8181818181818183,187,154
22400747,3,154,1.0,0.38961038961038963,154,0
22400747,4,141,7.0,2.9787234042553195,720,579
22400747,4,106,-3.0,-1.6981132075471699,575,469
22400747,4,47,5.0,6.382978723404255,454,407
22400747,4,129,4.0,1.8604651162790697,399,270
22400747,4,23,2.0,5.217391304347826,254,231
22400747,4,13,0.0,0.0,224,211
22400747,4,67,4.0,3.582089552238806,193,126
22400747,4,126,4.0,1.9047619047619047,126,0
22400748,1,389,-9.0,-1.3881748071979434,720,331
22400748,1,81,-5.0,-3.7037037037037033,331,250
22400748,1,9,0.0,0.0,230,221
22400748,1,42,-2.0,-2.8571428571428568,212,170
22400748,1,115,5.0,2.608695652173913,147,32
22400748,1,19,-1.0,-3.1578947368421053,32,13
22400748,1,13,2.0,9.230769230769232,13,0
22400748,2,368,-6.0,-0.9782608695652174,720,352
22400748,2,56,2.0,2.142857142857143,352,296
22400748,2,134,-3.0,-1.3432835820895521,296,162
22400748,2,30,-1.0,-2.0,121,91
22400748,2,82,4.0,2.926829268292683,91,9
22400748,2,9,0.0,0.0,9,0
22400748,3,171,3.0,1.0526315789473684,720,549
22400748,3,213,2.0,0.5633802816901409,547,334
22400748,3,107,-2.0,-1.1214953271028036,319,212
22400748,3,63,-6.0,-5.7142857142857135,212,149
22400748,3,134,-3.0,-1.3432835820895521,134,0
22400748,4,191,1.0,0.31413612565445026,720,529
22400748,4,49,-1.0,-1.2244897959183672,519,470
22400748,4,141,-10.0,-4.25531914893617,470,329
22400748,4,49,0.0,0.0,320,271
22400748,4,64,-5.0,-4.6875,262,198
22400748,4,159,8.0,3.018867924528302,159,0
22400749,1,383,2.0,0.3133159268929504,720,337
22400749,1,51,-5.0,-5.88235294117647,337,286
22400749,1,85,-2.0,-1.4117647058823528,286,201
22400749,1,55,-2.0,-2.1818181818181817,196,141
22400749,1,26,3.0,6.923076923076923,133,107
22400749,1,28,0.0,0.0,104,76
22400749,1,64,3.0,2.8125,64,0
22400749,2,125,0.0,0.0,720,595
22400749,2,21,-2.0,-5.7142857142857135,593,572
22400749,2,91,3.0,1.978021978021978,565,474
22400749,2,72,0.0,0.0,461,389
22400749,2,53,0.0,0.0,373,320
22400749,2,127,-2.0,-0.9448818897637795,315,188
22400749,2,102,1.0,0.5882352941176471,188,86
22400749,2,64,0.0,0.0,64,0
22400749,3,301,-2.0,-0.39867109634551495,720,419
22400749,3,87,-2.0,-1.3793103448275863,419,332
22400749,3,91,-1.0,-0.6593406593406594,322,231
22400749,3,60,-1.0,-1.0,231,171
22400749,3,31,-3.0,-5.806451612903226,166,135
22400749,3,96,-2.0,-1.25,131,35
22400749,3,35,0.0,0.0,35,0
22400749,4,113,0.0,0.0,720,607
22400749,4,56,-1.0,-1.0714285714285714,607,551
22400749,4,230,-2.0,-0.5217391304347826,551,321
22400749,4,143,-3.0,-1.2587412587412588,306,163
22400749,4,142,6.0,2.535211267605634,142,0
22400750,1,256,-7.0,-1.640625,720,464
22400750,1,175,-6.0,-2.0571428571428574,441,266
22400750,1,58,-5.0,-5.172413793103448,258,200
22400750,1,52,5.0,5.769230769230769,187,135
22400750,1,118,6.0,3.050847457627119,118,0
22400750,2,130,-9.0,-4.153846153846154,720,590
22400750,2,66,0.0,0.0,572,506
22400750,2,22,-3.0,-8.181818181818182,493,471
22400750,2,72,1.0,0.8333333333333333,456,384
22400750,2,17,0.0,0.0,384,367
22400750,2,116,2.0,1.0344827586206897,342,226
22400750,2,52,2.0,2.307692307692308,205,153
22400750,2,141,0.0,0.0,146,5
22400750,3,290,5.0,1.0344827586206897,720,430
22400750,3,109,3.0,1.651376146788991,430,321
22400750,3,9,1.0,6.666666666666666,309,300
22400750,3,21,2.0,5.7142857142857135,300,279
22400750,3,3,0.0,0.0,269,266
22400750,3,61,4.0,3.934426229508197,266,205
22400750,3,70,2.0,1.7142857142857142,196,126
22400750,3,16,0.0,0.0,115,99
22400750,4,67,6.0,5.3731343283582085,720,653
22400750,4,107,-5.0,-2.803738317757009,643,536
22400750,4,10,0.0,0.0,536,526
22400750,4,11,-2.0,-10.90909090909091,516,505
22400750,4,96,-4.0,-2.5,505,409
22400750,4,203,-1.0,-0.2955665024630542,409,206
22400750,4,72,-1.0,-0.8333333333333333,190,118
22400750,4,52,0.0,0.0,118,66
22400750,4,11,-2.0,-10.90909090909091,53,42
22400750,4,34,1.0,1.7647058823529411,42,8
22400750,4,3,0.0,0.0,3,0
22400751,1,293,-8.0,-1.6382252559726962,720,427
22400751,1,129,4.0,1.8604651162790697,427,298
22400751,1,16,0.0,0.0,289,273
22400751,1,37,-2.0,-3.2432432432432434,260,223
22400751,1,72,2.0,1.6666666666666665,223,151
22400751,1,138,3.0,1.3043478260869565,138,0
22400751,2,163,-2.0,-0.7361963190184049,720,557
22400751,2,35,-6.0,-10.285714285714286,557,522
22400751,2,130,-2.0,-0.9230769230769231,513,383
22400751,2,110,4.0,2.1818181818181817,383,273
22400751,2,69,1.0,0.8695652173913043,250,181
22400751,2,157,9.0,3.4394904458598727,181,24
22400751,2,24,-2.0,-5.0,24,0
22400751,3,74,3.0,2.4324324324324325,720,646
22400751,3,190,-10.0,-3.1578947368421053,633,443
22400751,3,118,1.0,0.5084745762711864,434,316
22400751,3,41,0.0,0.0,289,248
22400751,3,152,1.0,0.39473684210526316,248,96
22400751,3,32,2.0,3.75,76,44
22400751,3,44,3.0,4.090909090909091,44,0
22400751,4,132,-2.0,-0.9090909090909092,720,588
22400751,4,24,3.0,7.5,578,554
22400751,4,80,-3.0,-2.25,538,458
22400751,4,31,-3.0,-5.806451612903226,445,414
22400751,4,97,6.0,3.711340206185567,406,309
22400751,4,134,5.0,2.2388059701492535,294,160
22400751,4,28,0.0,0.0,148,120
22400751,4,110,1.0,0.5454545454545454,110,0
22400752,1,354,5.0,0.847457627118644,720,366
22400752,1,20,0.0,0.0,366,346
22400752,1,24,2.0,5.0,329,305
22400752,1,142,0.0,0.0,305,163
22400752,1,156,8.0,3.0769230769230766,156,0
22400752,2,119,3.0,1.5126050420168067,720,601
22400752,2,1,0.0,0.0,591,590
22400752,2,132,0.0,0.0,590,458
22400752,2,13,2.0,9.230769230769232,444,431
22400752,2,33,-3.0,-5.454545454545455,411,378
22400752,2,54,-1.0,-1.1111111111111112,369,315
22400752,2,30,-2.0,-4.0,290,260
22400752,2,137,-4.0,-1.751824817518248,260,123
22400752,2,123,3.0,1.4634146341463414,123,0
22400752,3,253,0.0,0.0,720,467
22400752,3,71,2.0,1.6901408450704225,467,396
22400752,3,58,3.0,3.103448275862069,389,331
22400752,3,68,-2.0,-1.7647058823529411,331,263
22400752,3,200,-3.0,-0.8999999999999999,263,63
22400752,3,51,3.0,3.5294117647058822,51,0
22400752,4,144,-10.0,-4.166666666666667,720,576
22400752,4,71,-3.0,-2.535211267605634,556,485
22400752,4,60,-3.0,-3.0,485,425
22400752,4,81,1.0,0.7407407407407407,412,331
22400752,4,85,3.0,2.1176470588235294,319,234
22400752,4,68,0.0,0.0,234,166
22400752,4,154,-1.0,-0.38961038961038963,154,0
22400753,1,196,-2.0,-0.6122448979591836,720,524
22400753,1,80,4.0,3.0,514,434
22400753,1,156,-5.0,-1.923076923076923,434,278
22400753,1,59,0.0,0.0,278,219
22400753,1,49,0.0,0.0,211,162
22400753,1,3,1.0,20.0,146,143
22400753,1,68,-2.0,-1.7647058823529411,143,75
22400753,1,67,-2.0,-1.791044776119403,67,0
22400753,2,84,-2.0,-1.4285714285714284,720,636
22400753,2,95,0.0,0.0,630,535
22400753,2,44,-2.0,-2.7272727272727275,530,486
22400753,2,94,3.0,1.9148936170212765,478,384
22400753,2,47,3.0,3.829787234042553,384,337
22400753,2,250,-4.0,-0.96,337,87
22400753,2,65,0.0,0.0,87,22
22400753,2,4,0.0,0.0,4,0
22400753,3,294,2.0,0.40816326530612246,720,426
22400753,3,40,2.0,3.0,414,374
22400753,3,138,2.0,0.8695652173913043,356,218
22400753,3,41,0.0,0.0,214,173
22400753,3,65,0.0,0.0,158,93
22400753,3,93,-3.0,-1.935483870967742,93,0
22400753,4,176,7.0,2.3863636363636362,720,544
22400753,4,147,1.0,0.40816326530612246,544,397
22400753,4,105,3.0,1.7142857142857142,397,292
22400753,4,31,0.0,0.0,278,247
22400753,4,220,-1.0,-0.2727272727272727,247,27
22400754,1,274,-5.0,-1.094890510948905,720,446
22400754,1,182,-5.0,-1.6483516483516483,446,264
22400754,1,24,-3.0,-7.5,249,225
22400754,1,52,3.0,3.4615384615384617,217,165
22400754,1,49,3.0,3.673469387755102,156,107
22400754,1,104,1.0,0.576923076923077,107,3
22400754,1,3,2.0,40.0,3,0
22400754,2,236,5.0,1.271186440677966,720,484
22400754,2,82,-2.0,-1.4634146341463414,484,402
22400754,2,62,-2.0,-1.935483870967742,395,333
22400754,2,79,-1.0,-0.7594936708860759,324,245
22400754,2,77,5.0,3.8961038961038956,231,154
22400754,2,24,-1.0,-2.5,142,118
22400754,2,357,-7.0,-1.1764705882352942,365,8
22400754,3,189,1.0,0.31746031746031744,720,531
22400754,3,28,0.0,0.0,531,503
22400754,3,117,4.0,2.0512820512820515,503,386
22400754,3,112,-2.0,-1.0714285714285714,386,274
22400754,3,182,6.0,1.978021978021978,267,85
22400754,3,53,1.0,1.1320754716981132,74,21
22400754,3,21,0.0,0.0,21,0
22400754,4,146,7.0,2.8767123287671232,720,574
22400754,4,176,4.0,1.3636363636363638,558,382
22400754,4,27,-2.0,-4.444444444444445,374,347
22400754,4,263,-8.0,-1.8250950570342206,345,82
22400754,4,38,0.0,0.0,82,44
22400754,4,35,-1.0,-1.7142857142857142,35,0
22400755,1,301,6.0,1.1960132890365447,720,419
22400755,1,24,2.0,5.0,409,385
22400755,1,54,2.0,2.2222222222222223,385,331
22400755,1,94,6.0,3.829787234042553,323,229
22400755,1,94,-3.0,-1.9148936170212765,213,119
22400755,1,7,-1.0,-8.571428571428571,107,100
22400755,1,100,2.0,1.2,100,0
22400755,2,127,6.0,2.8346456692913384,720,593
22400755,2,43,-1.0,-1.3953488372093024,582,539
22400755,2,63,-2.0,-1.9047619047619047,539,476
22400755,2,142,-5.0,-2.1126760563380285,472,330
22400755,2,20,0.0,0.0,316,296
22400755,2,33,0.0,0.0,284,251
22400755,2,59,-3.0,-3.050847457627119,244,185
22400755,2,181,6.0,1.9889502762430937,181,0
22400755,3,359,-4.0,-0.6685236768802229,720,361
22400755,3,432,-2.0,-0.2777777777777778,720,288
22400755,3,31,0.0,0.0,288,257
22400755,3,39,2.0,3.0769230769230766,257,218
22400755,3,22,1.0,2.7272727272727275,218,196
22400755,3,25,0.0,0.0,184,159
22400755,3,159,6.0,2.2641509433962264,159,0
22400755,4,132,-2.0,-0.9090909090909092,720,588
22400755,4,134,0.0,0.0,588,454
22400755,4,19,0.0,0.0,445,426
22400755,4,133,4.0,1.8045112781954886,418,285
22400755,4,2,0.0,0.0,270,268
22400755,4,268,-4.0,-0.8955223880597015,268,0
22400756,1,310,5.0,0.967741935483871,720,410
22400756,1,60,-4.0,-4.0,392,332
22400756,1,36,0.0,0.0,321,285
22400756,1,26,-3.0,-6.923076923076923,269,243
22400756,1,76,2.0,1.5789473684210527,243,167
22400756,1,167,1.0,0.3592814371257485,167,0
22400756,2,116,-2.0,-1.0344827586206897,720,604
22400756,2,47,-1.0,-1.2765957446808511,592,545
22400756,2,108,-1.0,-0.5555555555555556,545,437
22400756,2,87,0.0,0.0,371,284
22400756,2,43,3.0,4.186046511627907,278,235
22400756,2,229,9.0,2.3580786026200875,229,0
22400756,3,253,-5.0,-1.1857707509881423,720,467
22400756,3,63,2.0,1.9047619047619047,467,404
22400756,3,52,-2.0,-2.307692307692308,404,352
22400756,3,38,-4.0,-6.315789473684211,352,314
22400756,3,42,-1.0,-1.4285714285714284,314,272
22400756,3,133,5.0,2.2556390977443606,248,115
22400756,3,115,-3.0,-1.5652173913043477,115,0
22400756,4,177,2.0,0.6779661016949152,720,543
22400756,4,40,-3.0,-4.5,543,503
22400756,4,16,2.0,7.5,497,481
22400756,4,13,0.0,0.0,476,463
22400756,4,61,-2.0,-1.9672131147540985,458,397
22400756,4,397,-5.0,-0.7556675062972292,397,0
22400757,1,345,-14.0,-2.434782608695652,720,375
22400757,1,54,-5.0,-5.555555555555555,353,299
22400757,1,50,-3.0,-3.5999999999999996,290,240
22400757,1,39,0.0,0.0,234,195
22400757,1,66,1.0,0.9090909090909092,184,118
22400757,1,105,4.0,2.285714285714286,105,0
22400757,2,64,5.0,4.6875,720,656
22400757,2,57,2.0,2.1052631578947367,656,599
22400757,2,72,3.0,2.5,589,517
22400757,2,49,1.0,1.2244897959183672,501,452
22400757,2,46,1.0,1.3043478260869565,443,397
22400757,2,10,0.0,0.0,388,378
22400757,2,32,0.0,0.0,365,333
22400757,2,96,0.0,0.0,325,229
22400757,2,91,-2.0,-1.3186813186813189,220,129
22400757,2,129,-4.0,-1.8604651162790697,129,0
22400757,3,326,4.0,0.7361963190184049,720,394
22400757,3,41,0.0,0.0,383,342
22400757,3,37,-4.0,-6.486486486486487,336,299
22400757,3,110,-5.0,-2.7272727272727275,299,189
22400757,3,165,1.0,0.36363636363636365,176,11
22400757,4,183,-1.0,-0.32786885245901637,720,537
22400757,4,68,-2.0,-1.7647058823529411,537,469
22400757,4,127,3.0,1.4173228346456692,469,342
22400757,4,130,1.0,0.46153846153846156,334,204
22400757,4,111,-2.0,-1.0810810810810811,193,82
22400757,4,40,-1.0,-1.5,78,38
22400757,4,36,0.0,0.0,36,0
22400758,1,302,-4.0,-0.7947019867549668,720,418
22400758,1,29,2.0,4.137931034482759,404,375
22400758,1,37,1.0,1.6216216216216217,353,316
22400758,1,74,-1.0,-0.8108108108108109,300,226
22400758,1,118,5.0,2.542372881355932,219,101
22400758,2,144,-1.0,-0.41666666666666663,720,576
22400758,2,81,6.0,4.444444444444445,576,495
22400758,2,74,2.0,1.6216216216216217,466,392
22400758,2,130,1.0,0.46153846153846156,392,262
22400758,2,121,2.0,0.9917355371900827,262,141
22400758,2,128,-2.0,-0.9375,141,13
22400758,3,299,1.0,0.20066889632107024,720,421
22400758,3,40,0.0,0.0,409,369
22400758,3,38,2.0,3.1578947368421053,351,313
22400758,3,71,2.0,1.6901408450704225,302,231
22400758,3,25,2.0,4.8,218,193
22400758,3,72,3.0,2.5,180,108
22400758,3,13,0.0,0.0,108,95
22400758,3,90,-2.0,-1.3333333333333335,90,0
22400758,4,152,-3.0,-1.1842105263157894,720,568
22400758,4,76,-1.0,-0.7894736842105263,560,484
22400758,4,122,4.0,1.9672131147540985,470,348
22400758,4,57,-4.0,-4.2105263157894735,348,291
22400758,4,156,-10.0,-3.846153846153846,291,135
22400759,1,299,5.0,1.0033444816053512,720,421
22400759,1,87,2.0,1.3793103448275863,406,319
22400759,1,114,2.0,1.0526315789473684,319,205
22400759,1,37,0.0,0.0,194,157
22400759,1,139,-5.0,-2.158273381294964,139,0
22400759,2,172,-10.0,-3.488372093023256,720,548
22400759,2,132,-6.0,-2.7272727272727275,533,401
22400759,2,120,-3.0,-1.5,383,263
22400759,2,40,1.0,1.5,245,205
22400759,2,205,-1.0,-0.2926829268292683,205,0
22400759,3,395,-7.0,-1.0632911392405064,720,325
22400759,3,152,-3.0,-1.1842105263157894,313,161
22400759,3,116,-2.0,-1.0344827586206897,146,30
22400759,3,28,0.0,0.0,30,2
22400759,4,216,2.0,0.5555555555555556,720,504
22400759,4,268,1.0,0.22388059701492538,489,221
22400759,4,55,-2.0,-2.1818181818181817,214,159
22400759,4,65,0.0,0.0,141,76
22400759,4,65,3.0,2.769230769230769,65,0
22400760,1,291,-1.0,-0.20618556701030927,720,429
22400760,1,59,-3.0,-3.050847457627119,413,354
22400760,1,131,-4.0,-1.83206106870229,345,214
22400760,1,75,-2.0,-1.6,214,139
22400760,1,133,2.0,0.9022556390977443,133,0
22400760,2,111,-2.0,-1.0810810810810811,720,609
22400760,2,121,0.0,0.0,609,488
22400760,2,106,1.0,0.5660377358490566,488,382
22400760,2,109,-3.0,-1.651376146788991,382,273
22400760,2,242,-3.0,-0.743801652892562,242,0
22400760,3,263,1.0,0.22813688212927757,720,457
22400760,3,108,5.0,2.7777777777777777,457,349
22400760,3,17,1.0,3.5294117647058822,333,316
22400760,3,19,0.0,0.0,316,297
22400760,3,50,2.0,2.4,297,247
22400760,3,66,-1.0,-0.9090909090909092,238,172
22400760,3,59,2.0,2.0338983050847457,172,113
22400760,3,24,-1.0,-2.5,113,89
22400760,3,55,-3.0,-3.2727272727272725,89,34
22400760,3,28,0.0,0.0,28,0
22400760,4,18,1.0,3.333333333333333,720,702
22400760,4,145,-2.0,-0.8275862068965517,638,493
22400760,4,14,-1.0,-4.285714285714286,474,460
22400760,4,135,-9.0,-4.0,460,325
22400760,4,57,3.0,3.1578947368421053,325,268
22400760,4,72,3.0,2.5,249,177
22400760,4,106,1.0,0.5660377358490566,177,71
22400761,1,266,5.0,1.1278195488721803,720,454
22400761,1,25,2.0,4.8,437,412
22400761,1,77,2.0,1.5584415584415585,397,320
22400761,1,24,2.0,5.0,309,285
22400761,1,12,-1.0,-5.0,285,273
22400761,1,52,-3.0,-3.4615384615384617,273,221
22400761,1,66,0.0,0.0,221,155
22400761,1,52,5.0,5.769230769230769,155,103
22400761,1,103,4.0,2.3300970873786406,103,0
22400761,2,195,7.0,2.1538461538461537,720,525
22400761,2,72,4.0,3.333333333333333,507,435
22400761,2,21,-2.0,-5.7142857142857135,414,393
22400761,2,187,3.0,0.9625668449197862,379,192
22400761,2,138,2.0,0.8695652173913043,192,54
22400761,2,11,2.0,10.90909090909091,46,35
22400761,2,35,-5.0,-8.571428571428571,35,0
22400761,3,300,4.0,0.8,720,420
22400761,3,56,0.0,0.0,420,364
22400761,3,138,5.0,2.1739130434782608,345,207
22400761,3,24,-2.0,-5.0,207,183
22400761,3,47,0.0,0.0,165,118
22400761,3,118,-2.0,-1.0169491525423728,118,0
22400761,4,167,1.0,0.3592814371257485,720,553
22400761,4,133,4.0,1.8045112781954886,553,420
22400761,4,34,2.0,3.5294117647058822,406,372
22400761,4,149,-2.0,-0.8053691275167785,368,219
22400761,4,219,7.0,1.917808219178082,219,0
22400762,1,270,0.0,0.0,720,450
22400762,1,49,-2.0,-2.4489795918367343,450,401
22400762,1,65,-5.0,-4.615384615384616,388,323
22400762,1,54,2.0,2.2222222222222223,323,269
22400762,1,37,3.0,4.864864864864865,263,226
22400762,1,18,0.0,0.0,212,194
22400762,1,17,0.0,0.0,194,177
22400762,1,164,9.0,3.292682926829268,164,0
22400762,2,74,-3.0,-2.4324324324324325,720,646
22400762,2,151,-1.0,-0.3973509933774834,646,495
22400762,2,1,0.0,0.0,472,471
22400762,2,62,0.0,0.0,452,390
22400762,2,159,-3.0,-1.1320754716981132,378,219
22400762,2,119,5.0,2.521008403361345,219,100
22400762,2,88,-5.0,-3.409090909090909,100,12
22400762,3,225,0.0,0.0,720,495
22400762,3,28,-2.0,-4.285714285714286,495,467
22400762,3,12,-2.0,-10.0,450,438
22400762,3,82,-5.0,-3.6585365853658534,438,356
22400762,3,114,6.0,3.1578947368421053,349,235
22400762,3,46,-2.0,-2.608695652173913,222,176
22400762,3,31,0.0,0.0,176,145
22400762,3,39,0.0,0.0,136,97
22400762,3,85,5.0,3.5294117647058822,92,7
22400762,3,5,0.0,0.0,7,2
22400762,3,2,0.0,0.0,2,0
22400762,4,86,2.0,1.3953488372093024,720,634
22400762,4,87,0.0,0.0,634,547
22400762,4,75,-1.0,-0.8,532,457
22400762,4,35,-2.0,-3.4285714285714284,457,422
22400762,4,179,-7.0,-2.346368715083799,412,233
22400762,4,67,1.0,0.8955223880597015,217,150
22400762,4,135,0.0,0.0,150,15
22400762,4,8,0.0,0.0,11,3
22400762,5,144,-4.0,-1.6666666666666665,300,156
22400762,5,120,-4.0,-2.0,141,21
22400762,5,1,0.0,0.0,12,11
22400762,5,1,0.0,0.0,10,9
22400762,5,2,0.0,0.0,2,0
22400763,1,302,14.0,2.781456953642384,720,418
22400763,1,60,-1.0,-1.0,399,339
22400763,1,57,5.0,5.263157894736842,339,282
22400763,1,21,0.0,0.0,264,243
22400763,1,79,0.0,0.0,230,151
22400763,1,114,0.0,0.0,139,25
22400763,1,25,-1.0,-2.4,25,0
22400763,2,244,3.0,0.7377049180327868,720,476
22400763,2,25,-3.0,-7.199999999999999,431,406
22400763,2,30,2.0,4.0,392,362
22400763,2,38,-3.0,-4.7368421052631575,362,324
22400763,2,31,2.0,3.870967741935484,313,282
22400763,2,94,-1.0,-0.6382978723404256,273,179
22400763,2,166,7.0,2.5301204819277108,166,0
22400763,3,182,-4.0,-1.3186813186813189,720,538
22400763,3,77,0.0,0.0,527,450
22400763,3,103,1.0,0.5825242718446602,438,335
22400763,3,51,2.0,2.3529411764705883,335,284
22400763,3,10,2.0,12.0,275,265
22400763,3,103,5.0,2.912621359223301,265,162
22400763,4,47,-2.0,-2.5531914893617023,720,673
22400763,4,76,5.0,3.9473684210526314,649,573
22400763,4,91,3.0,1.978021978021978,564,473
22400763,4,153,5.0,1.9607843137254903,471,318
22400763,4,22,0.0,0.0,318,296
22400763,4,34,2.0,3.5294117647058822,285,251
22400763,4,242,0.0,0.0,242,0
22400764,1,324,-7.0,-1.2962962962962963,720,396
22400764,1,65,0.0,0.0,396,331
22400764,1,41,4.0,5.853658536585366,331,290
22400764,1,50,0.0,0.0,270,220
22400764,1,13,0.0,0.0,207,194
22400764,1,55,2.0,2.1818181818181817,181,126
22400764,1,126,-5.0,-2.380952380952381,126,0
22400764,2,245,6.0,1.4693877551020407,720,475
22400764,2,56,0.0,0.0,458,402
22400764,2,70,3.0,2.5714285714285716,389,319
22400764,2,83,-3.0,-2.1686746987951806,317,234
22400764,2,20,-1.0,-3.0,234,214
22400764,2,44,4.0,5.454545454545455,214,170
22400764,2,157,0.0,0.0,170,13
22400764,3,304,-5.0,-0.9868421052631579,720,416
22400764,3,83,1.0,0.7228915662650602,404,321
22400764,3,91,0.0,0.0,321,230
22400764,3,64,2.0,1.875,211,147
22400764,3,68,-7.0,-6.1764705882352935,147,79
22400764,3,60,-1.0,-1.0,60,0
22400764,4,241,1.0,0.24896265560165975,720,479
22400764,4,58,1.0,1.0344827586206897,463,405
22400764,4,79,4.0,3.0379746835443036,386,307
22400764,4,22,0.0,0.0,267,245
22400764,4,196,0.0,0.0,196,0
22400765,1,292,-1.0,-0.2054794520547945,720,428
22400765,1,47,0.0,0.0,425,378
22400765,1,112,3.0,1.607142857142857,370,258
22400765,1,83,4.0,2.891566265060241,255,172
22400765,1,37,-1.0,-1.6216216216216217,165,128
22400765,1,107,-3.0,-1.6822429906542056,128,21
22400765,1,17,0.0,0.0,17,0
22400765,2,183,2.0,0.6557377049180327,720,537
22400765,2,28,2.0,4.285714285714286,537,509
22400765,2,168,-3.0,-1.0714285714285714,498,330
22400765,2,27,-4.0,-8.88888888888889,320,293
22400765,2,28,0.0,0.0,293,265
22400765,2,105,-3.0,-1.7142857142857142,254,149
22400765,2,41,1.0,1.4634146341463414,149,108
22400765,2,99,0.0,0.0,99,0
22400765,3,198,-1.0,-0.30303030303030304,720,522
22400765,3,23,-1.0,-2.608695652173913,510,487
22400765,3,167,1.0,0.3592814371257485,487,320
22400765,3,31,1.0,1.935483870967742,308,277
22400765,3,11,0.0,0.0,277,266
22400765,3,117,2.0,1.0256410256410258,266,149
22400765,3,13,0.0,0.0,149,136
22400765,3,132,-5.0,-2.272727272727273,136,4
22400765,3,4,0.0,0.0,4,0
22400765,4,40,-1.0,-1.5,720,680
22400765,4,53,2.0,2.2641509433962264,680,627
22400765,4,129,0.0,0.0,627,498
22400765,4,146,-6.0,-2.4657534246575343,485,339
22400765,4,74,-4.0,-3.2432432432432434,328,254
22400765,4,48,-3.0,-3.75,250,202
22400765,4,73,0.0,0.0,191,118
22400765,4,23,-2.0,-5.217391304347826,117,94
22400765,4,94,6.0,3.829787234042553,94,0
22400766,1,183,-2.0,-0.6557377049180327,720,537
22400766,1,102,-2.0,-1.1764705882352942,528,426
22400766,1,96,-4.0,-2.5,418,322
22400766,1,18,2.0,6.666666666666666,302,284
22400766,1,65,-3.0,-2.769230769230769,282,217
22400766,1,45,-1.0,-1.3333333333333335,199,154
22400766,1,64,-5.0,-4.6875,146,82
22400766,1,62,0.0,0.0,82,20
22400766,1,3,0.0,0.0,3,0
22400766,2,123,-7.0,-3.4146341463414633,720,597
22400766,2,26,2.0,4.615384615384616,581,555
22400766,2,32,-1.0,-1.875,537,505
22400766,2,90,-5.0,-3.333333333333333,505,415
22400766,2,77,-7.0,-5.454545454545455,403,326
22400766,2,60,-5.0,-5.0,306,246
22400766,2,30,-2.0,-4.0,237,207
22400766,2,157,-1.0,-0.3821656050955414,207,50
22400766,2,50,0.0,0.0,50,0
22400766,3,245,-1.0,-0.2448979591836735,720,475
22400766,3,95,4.0,2.526315789473684,456,361
22400766,3,241,-8.0,-1.991701244813278,349,108
22400766,3,98,-3.0,-1.836734693877551,98,0
22400766,4,34,-1.0,-1.7647058823529411,720,686
22400766,4,83,1.0,0.7228915662650602,668,585
22400766,4,22,2.0,5.454545454545455,567,545
22400766,4,67,0.0,0.0,585,518
22400766,4,41,-1.0,-1.4634146341463414,510,469
22400766,4,456,5.0,0.6578947368421052,456,0
22400767,1,333,-3.0,-0.5405405405405406,720,387
22400767,1,202,-3.0,-0.891089108910891,379,177
22400767,1,127,-4.0,-1.889763779527559,162,35
22400767,2,195,2.0,0.6153846153846154,720,525
22400767,2,18,0.0,0.0,525,507
22400767,2,45,-2.0,-2.666666666666667,501,456
22400767,2,27,-1.0,-2.2222222222222223,456,429
22400767,2,110,-6.0,-3.2727272727272725,423,313
22400767,2,27,1.0,2.2222222222222223,309,282
22400767,2,104,4.0,2.307692307692308,282,178
22400767,2,65,-3.0,-2.769230769230769,160,95
22400767,2,63,4.0,3.8095238095238093,95,32
22400767,2,4,0.0,0.0,23,19
22400767,2,17,0.0,0.0,17,0
22400767,3,354,-2.0,-0.3389830508474576,720,366
22400767,3,83,1.0,0.7228915662650602,366,283
22400767,3,6,-1.0,-10.0,283,277
22400767,3,131,0.0,0.0,265,134
22400767,3,49,1.0,1.2244897959183672,120,71
22400767,3,70,3.0,2.5714285714285716,71,1
22400767,3,1,0.0,0.0,1,0
22400767,4,202,4.0,1.188118811881188,720,518
22400767,4,116,-7.0,-3.620689655172414,499,383
22400767,4,124,3.0,1.4516129032258065,362,238
22400767,4,7,2.0,17.142857142857142,224,217
22400767,4,181,0.0,0.0,206,25
22400768,1,184,-3.0,-0.9782608695652174,720,536
22400768,1,104,6.0,3.4615384615384617,536,432
22400768,1,128,3.0,1.40625,432,304
22400768,1,122,4.0,1.9672131147540985,293,171
22400768,1,153,1.0,0.39215686274509803,153,0
22400768,2,110,3.0,1.6363636363636362,720,610
22400768,2,137,3.0,1.3138686131386863,601,464
22400768,2,108,-3.0,-1.6666666666666665,384,276
22400768,2,45,-2.0,-2.666666666666667,271,226
22400768,2,42,3.0,4.285714285714286,211,169
22400768,2,107,-3.0,-1.6822429906542056,169,62
22400768,2,62,5.0,4.838709677419355,62,0
22400768,3,227,1.0,0.2643171806167401,720,493
22400768,3,69,5.0,4.3478260869565215,481,412
22400768,3,183,-6.0,-1.9672131147540985,412,229
22400768,3,32,-2.0,-3.75,219,187
22400768,3,18,0.0,0.0,171,153
22400768,3,12,0.0,0.0,153,141
22400768,4,39,0.0,0.0,720,681
22400768,4,48,4.0,5.0,681,633
22400768,4,133,2.0,0.9022556390977443,628,495
22400768,4,15,2.0,8.0,482,467
22400768,4,65,-3.0,-2.769230769230769,467,402
22400768,4,5,-1.0,-12.0,390,385
22400768,4,12,1.0,5.0,373,361
22400768,4,154,-4.0,-1.5584415584415585,361,207
22400768,4,17,0.0,0.0,194,177
22400768,4,177,-6.0,-2.0338983050847457,177,0
22400769,1,337,6.0,1.0682492581602374,720,383
22400769,1,127,3.0,1.4173228346456692,381,254
22400769,1,79,4.0,3.0379746835443036,246,167
22400769,1,8,0.0,0.0,13,5
22400769,2,132,1.0,0.4545454545454546,720,588
22400769,2,82,3.0,2.195121951219512,588,506
22400769,2,72,-6.0,-5.0,492,420
22400769,2,14,-2.0,-8.571428571428571,366,352
22400769,2,97,2.0,1.2371134020618557,330,233
22400769,2,51,1.0,1.1764705882352942,219,168
22400769,2,156,1.0,0.3846153846153846,156,0
22400769,3,323,-6.0,-1.1145510835913313,720,397
22400769,3,215,3.0,0.8372093023255813,387,172
22400769,3,56,0.0,0.0,148,92
22400769,3,92,-3.0,-1.9565217391304348,92,0
22400769,4,153,2.0,0.7843137254901961,720,567
22400769,4,29,2.0,4.137931034482759,558,529
22400769,4,79,-1.0,-0.7594936708860759,518,439
22400769,4,168,1.0,0.3571428571428571,439,271
22400769,4,246,-3.0,-0.7317073170731707,271,25
22400769,4,11,0.0,0.0,11,0
22400770,1,292,4.0,0.821917808219178,720,428
22400770,1,107,0.0,0.0,415,308
22400770,1,74,0.0,0.0,296,222
22400770,1,67,2.0,1.791044776119403,203,136
22400770,1,129,6.0,2.7906976744186047,129,0
22400770,2,244,1.0,0.24590163934426232,720,476
22400770,2,45,-2.0,-2.666666666666667,476,431
22400770,2,43,-1.0,-1.3953488372093024,413,370
22400770,2,38,2.0,3.1578947368421053,370,332
22400770,2,94,-1.0,-0.6382978723404256,324,230
22400770,2,41,0.0,0.0,217,176
22400770,2,34,0.0,0.0,158,124
22400770,2,121,-5.0,-2.479338842975207,123,2
22400770,3,221,-4.0,-1.0859728506787332,720,499
22400770,3,18,0.0,0.0,479,461
22400770,3,47,0.0,0.0,448,401
22400770,3,22,1.0,2.7272727272727275,384,362
22400770,3,82,2.0,1.4634146341463414,362,280
22400770,3,2,0.0,0.0,261,259
22400770,3,56,2.0,2.142857142857143,241,185
22400770,3,72,3.0,2.5,185,113
22400770,3,10,2.0,12.0,113,103
22400770,3,103,1.0,0.5825242718446602,103,0
22400770,4,111,-2.0,-1.0810810810810811,720,609
22400770,4,222,10.0,2.7027027027027026,602,380
22400770,4,69,-1.0,-0.8695652173913043,367,298
22400770,4,66,0.0,0.0,296,230
22400770,4,63,2.0,1.9047619047619047,218,155
22400771,1,347,-6.0,-1.037463976945245,720,373
22400771,1,54,3.0,3.333333333333333,358,304
22400771,1,40,1.0,1.5,295,255
22400771,1,37,0.0,0.0,250,213
22400771,1,90,-2.0,-1.3333333333333335,205,115
22400771,1,38,-2.0,-3.1578947368421053,99,61
22400771,1,47,0.0,0.0,47,0
22400771,2,189,1.0,0.31746031746031744,720,531
22400771,2,38,5.0,7.894736842105263,516,478
22400771,2,123,0.0,0.0,458,335
22400771,2,115,-3.0,-1.5652173913043477,322,207
22400771,2,93,7.0,4.516129032258065,202,109
22400771,2,81,0.0,0.0,87,6
22400771,2,1,0.0,0.0,1,0
22400771,3,213,3.0,0.8450704225352113,720,507
22400771,3,47,4.0,5.1063829787234045,501,454
22400771,3,35,-2.0,-3.4285714285714284,441,406
22400771,3,170,-5.0,-1.7647058823529411,406,236
22400771,3,73,-1.0,-0.821917808219178,218,145
22400771,3,145,3.0,1.2413793103448276,145,0
22400771,4,86,-4.0,-2.7906976744186047,720,634
22400771,4,50,1.0,1.2,634,584
22400771,4,36,-3.0,-5.0,584,548
22400771,4,24,-1.0,-2.5,532,508
22400771,4,121,-2.0,-0.9917355371900827,508,387
22400771,4,109,2.0,1.1009174311926606,387,278
22400771,4,244,-1.0,-0.24590163934426232,267,23
22400771,4,7,0.0,0.0,7,0
22400771,5,189,-4.0,-1.2698412698412698,300,111
22400771,5,85,4.0,2.8235294117647056,101,16
22400771,5,1,0.0,0.0,15,14
22400771,5,14,-2.0,-8.571428571428571,14,0
22400772,1,340,-3.0,-0.5294117647058824,720,380
22400772,1,50,2.0,2.4,366,316
22400772,1,72,-2.0,-1.6666666666666665,316,244
22400772,1,48,0.0,0.0,244,196
22400772,1,25,0.0,0.0,183,158
22400772,1,78,-4.0,-3.0769230769230766,152,74
22400772,1,74,1.0,0.8108108108108109,74,0
22400772,2,50,0.0,0.0,720,670
22400772,2,97,4.0,2.4742268041237114,655,558
22400772,2,60,0.0,0.0,558,498
22400772,2,68,3.0,2.647058823529412,489,421
22400772,2,20,0.0,0.0,405,385
22400772,2,33,1.0,1.8181818181818183,373,340
22400772,2,147,-1.0,-0.40816326530612246,340,193
22400772,2,14,-1.0,-4.285714285714286,133,119
22400772,2,119,-5.0,-2.521008403361345,119,0
22400772,3,326,1.0,0.18404907975460122,720,394
22400772,3,27,0.0,0.0,374,347
22400772,3,122,4.0,1.9672131147540985,339,217
22400772,3,17,0.0,0.0,204,187
22400772,3,9,0.0,0.0,174,165
22400772,3,132,5.0,2.272727272727273,145,13
22400772,3,2,-2.0,-60.0,2,0
22400772,4,217,3.0,0.8294930875576038,720,503
22400772,4,55,-1.0,-1.0909090909090908,490,435
22400772,4,73,-7.0,-5.7534246575342465,429,356
22400772,4,161,0.0,0.0,338,177
22400772,4,8,-2.0,-15.0,172,164
22400772,4,85,4.0,2.8235294117647056,164,79
22400772,4,21,2.0,5.7142857142857135,64,43
22400772,4,8,0.0,0.0,37,29
22400772,4,8,-2.0,-15.0,25,17
22400772,4,12,0.0,0.0,12,0
22400773,1,292,5.0,1.0273972602739725,720,428
22400773,1,66,-4.0,-3.6363636363636367,428,362
22400773,1,15,0.0,0.0,344,329
22400773,1,155,0.0,0.0,310,155
22400773,1,140,1.0,0.42857142857142855,155,15
22400773,2,80,-1.0,-0.75,720,640
22400773,2,58,1.0,1.0344827586206897,640,582
22400773,2,70,3.0,2.5714285714285716,582,512
22400773,2,61,1.0,0.9836065573770493,491,430
22400773,2,33,3.0,5.454545454545455,423,390
22400773,2,110,-2.0,-1.0909090909090908,374,264
22400773,2,7,0.0,0.0,252,245
22400773,2,170,-5.0,-1.7647058823529411,237,67
22400773,2,37,-1.0,-1.6216216216216217,60,23
22400773,2,19,0.0,0.0,23,4
22400773,3,383,4.0,0.6266318537859008,720,337
22400773,3,126,-6.0,-2.8571428571428568,326,200
22400773,3,31,0.0,0.0,200,169
22400773,3,169,-4.0,-1.4201183431952662,169,0
22400773,4,108,8.0,4.444444444444445,720,612
22400773,4,78,-2.0,-1.5384615384615383,612,534
22400773,4,25,0.0,0.0,520,495
22400773,4,40,-1.0,-1.5,481,441
22400773,4,70,0.0,0.0,441,371
22400773,4,123,-1.0,-0.48780487804878053,364,241
22400773,4,98,-3.0,-1.836734693877551,241,143
22400773,4,55,2.0,2.1818181818181817,140,85
22400773,4,17,2.0,7.0588235294117645,85,68
22400773,4,48,0.0,0.0,55,7
22400773,4,5,-1.0,-12.0,7,2
22400773,4,1,0.0,0.0,1,0
22400773,5,276,3.0,0.6521739130434783,300,24
22400773,5,13,2.0,9.230769230769232,24,11
22400773,5,2,0.0,0.0,2,0
22400774,1,270,-5.0,-1.1111111111111112,720,450
22400774,1,33,-3.0,-5.454545454545455,450,417
22400774,1,52,-3.0,-3.4615384615384617,399,347
22400774,1,73,-5.0,-4.10958904109589,337,264
22400774,1,49,-4.0,-4.897959183673469,239,190
22400774,1,74,-4.0,-3.2432432432432434,175,101
22400774,1,101,1.0,0.594059405940594,101,0
22400774,2,197,-1.0,-0.3045685279187817,720,523
22400774,2,84,5.0,3.571428571428571,514,430
22400774,2,165,1.0,0.36363636363636365,430,265
22400774,2,77,0.0,0.0,265,188
22400774,2,102,-1.0,-0.5882352941176471,166,64
22400774,2,64,-2.0,-1.875,64,0
22400774,3,288,-9.0,-1.875,720,432
22400774,3,169,-1.0,-0.35502958579881655,416,247
22400774,3,35,2.0,3.4285714285714284,244,209
22400774,3,69,4.0,3.4782608695652173,198,129
22400774,3,129,9.0,4.186046511627907,129,0
22400774,4,134,-5.0,-2.2388059701492535,720,586
22400774,4,156,4.0,1.5384615384615383,569,413
22400774,4,106,2.0,1.1320754716981132,398,292
22400774,4,20,-2.0,-6.0,278,258
22400774,4,47,-3.0,-3.829787234042553,257,210
22400774,4,191,1.0,0.31413612565445026,191,0
22400775,1,318,0.0,0.0,720,402
22400775,1,26,1.0,2.307692307692308,382,356
22400775,1,50,2.0,2.4,356,306
22400775,1,105,0.0,0.0,293,188
22400775,1,87,2.0,1.3793103448275863,170,83
22400775,1,83,3.0,2.1686746987951806,83,0
22400775,2,96,1.0,0.625,720,624
22400775,2,42,5.0,7.142857142857142,624,582
22400775,2,69,-1.0,-0.8695652173913043,582,513
22400775,2,76,-1.0,-0.7894736842105263,453,377
22400775,2,35,-3.0,-5.142857142857143,377,342
22400775,2,70,-2.0,-1.7142857142857142,334,264
22400775,2,177,1.0,0.3389830508474576,264,87
22400775,2,87,-2.0,-1.3793103448275863,87,0
22400775,3,114,-3.0,-1.5789473684210527,720,606
22400775,3,59,-2.0,-2.0338983050847457,594,535
22400775,3,67,-2.0,-1.791044776119403,535,468
22400775,3,133,4.0,1.8045112781954886,454,321
22400775,3,21,-1.0,-2.8571428571428568,297,276
22400775,3,5,0.0,0.0,276,271
22400775,3,22,1.0,2.7272727272727275,259,237
22400775,3,103,-2.0,-1.1650485436893203,237,134
22400775,3,89,1.0,0.6741573033707865,134,45
22400775,3,45,0.0,0.0,45,0
22400775,4,144,-1.0,-0.41666666666666663,720,576
22400775,4,44,3.0,4.090909090909091,567,523
22400775,4,17,0.0,0.0,523,506
22400775,4,24,-2.0,-5.0,495,471
22400775,4,17,2.0,7.0588235294117645,471,454
22400775,4,75,-2.0,-1.6,437,362
22400775,4,89,2.0,1.348314606741573,345,256
22400775,4,76,3.0,2.3684210526315788,251,175
22400775,4,175,-8.0,-2.742857142857143,175,0
22400776,1,305,-7.0,-1.3770491803278688,720,415
22400776,1,97,0.0,0.0,409,312
22400776,1,154,-6.0,-2.3376623376623376,303,149
22400776,1,136,-2.0,-0.8823529411764706,136,0
22400776,2,204,-2.0,-0.5882352941176471,720,516
22400776,2,121,5.0,2.479338842975207,500,379
22400776,2,27,1.0,2.2222222222222223,368,341
22400776,2,109,-1.0,-0.5504587155963303,341,232
22400776,2,232,5.0,1.293103448275862,232,0
22400776,3,309,-6.0,-1.1650485436893203,720,411
22400776,3,142,2.0,0.8450704225352113,391,249
22400776,3,18,0.0,0.0,233,215
22400776,3,18,0.0,0.0,213,195
22400776,3,114,9.0,4.7368421052631575,183,69
22400776,3,58,-3.0,-3.103448275862069,69,11
22400776,4,318,-4.0,-0.7547169811320755,720,402
22400776,4,42,2.0,2.8571428571428568,402,360
22400776,4,83,2.0,1.4457831325301205,348,265
22400776,4,9,0.0,0.0,265,256
22400776,4,197,-2.0,-0.6091370558375634,256,59
22400776,4,47,-4.0,-5.1063829787234045,47,0
22400777,1,273,-5.0,-1.098901098901099,720,447
22400777,1,117,-4.0,-2.0512820512820515,434,317
22400777,1,49,-7.0,-8.571428571428571,310,261
22400777,1,49,-1.0,-1.2244897959183672,210,161
22400777,1,27,2.0,4.444444444444445,131,104
22400777,1,90,2.0,1.3333333333333335,90,0
22400777,2,118,4.0,2.0338983050847457,720,602
22400777,2,41,3.0,4.390243902439024,602,561
22400777,2,32,3.0,5.625,552,520
22400777,2,65,0.0,0.0,514,449
22400777,2,111,-7.0,-3.7837837837837833,449,338
22400777,2,73,2.0,1.643835616438356,320,247
22400777,2,87,3.0,2.0689655172413794,225,138
22400777,2,119,2.0,1.0084033613445378,121,2
22400777,2,2,0.0,0.0,2,0
22400777,3,252,-3.0,-0.7142857142857142,720,468
22400777,3,132,1.0,0.4545454545454546,446,314
22400777,3,113,-2.0,-1.0619469026548671,314,201
22400777,3,16,0.0,0.0,189,173
22400777,3,24,-3.0,-7.5,160,136
22400777,3,113,3.0,1.592920353982301,113,0
22400777,4,120,1.0,0.5,720,600
22400777,4,30,-2.0,-4.0,600,570
22400777,4,14,0.0,0.0,570,556
22400777,4,61,4.0,3.934426229508197,556,495
22400777,4,165,5.0,1.8181818181818183,476,311
22400777,4,67,-2.0,-1.791044776119403,277,210
22400778,1,277,-4.0,-0.8664259927797834,720,443
22400778,1,66,-2.0,-1.8181818181818183,443,377
22400778,1,4,-2.0,-30.0,364,360
22400778,1,132,-1.0,-0.4545454545454546,346,214
22400778,1,214,-1.0,-0.2803738317757009,214,0
22400778,2,166,2.0,0.7228915662650602,720,554
22400778,2,53,1.0,1.1320754716981132,530,477
22400778,2,25,-2.0,-4.8,477,452
22400778,2,10,2.0,12.0,452,442
22400778,2,26,0.0,0.0,442,416
22400778,2,84,-5.0,-3.571428571428571,414,330
22400778,2,80,-1.0,-0.75,322,242
22400778,2,83,3.0,2.1686746987951806,223,140
22400778,2,52,3.0,3.4615384615384617,127,75
22400778,2,65,5.0,4.615384615384616,65,0
22400778,3,284,0.0,0.0,720,436
22400778,3,188,0.0,0.0,421,233
22400778,3,10,0.0,0.0,161,151
22400778,3,106,-1.0,-0.5660377358490566,141,35
22400778,3,30,-3.0,-6.0,30,0
22400778,4,91,8.0,5.2747252747252755,720,629
22400778,4,10,5.0,30.0,581,571
22400778,4,135,8.0,3.555555555555556,557,422
22400778,4,99,-1.0,-0.6060606060606061,400,301
22400778,4,65,2.0,1.8461538461538463,290,225
22400778,4,28,0.0,0.0,216,188
22400778,4,188,4.0,1.2765957446808511,188,0
22400779,1,315,-3.0,-0.5714285714285715,720,405
22400779,1,148,2.0,0.8108108108108109,405,257
22400779,1,52,1.0,1.153846153846154,257,205
22400779,1,47,5.0,6.382978723404255,197,150
22400779,1,94,-3.0,-1.9148936170212765,136,42
22400779,1,42,1.0,1.4285714285714284,42,0
22400779,2,144,1.0,0.41666666666666663,720,576
22400779,2,26,2.0,4.615384615384616,557,531
22400779,2,54,2.0,2.2222222222222223,511,457
22400779,2,72,-2.0,-1.6666666666666665,441,369
22400779,2,15,0.0,0.0,363,348
22400779,2,207,1.0,0.2898550724637681,344,137
22400779,2,125,-8.0,-3.84,125,0
22400779,3,229,7.0,1.8340611353711789,720,491
22400779,3,124,-2.0,-0.967741935483871,469,345
22400779,3,85,3.0,2.1176470588235294,345,260
22400779,3,16,-1.0,-3.75,260,244
22400779,3,130,-4.0,-1.8461538461538463,244,114
22400779,3,1,0.0,0.0,114,113
22400779,3,21,-5.0,-14.285714285714285,96,75
22400779,4,84,6.0,4.285714285714286,720,636
22400779,4,67,-1.0,-0.8955223880597015,626,559
22400779,4,14,0.0,0.0,544,530
22400779,4,144,0.0,0.0,530,386
22400779,4,50,4.0,4.8,375,325
22400779,4,97,-1.0,-0.6185567010309279,313,216
22400779,4,39,0.0,0.0,208,169
22400779,4,169,3.0,1.0650887573964498,169,0
22400780,1,266,6.0,1.3533834586466165,720,454
22400780,1,100,3.0,1.7999999999999998,443,343
22400780,1,47,4.0,5.1063829787234045,322,275
22400780,1,29,1.0,2.0689655172413794,275,246
22400780,1,80,3.0,2.25,246,166
22400780,1,160,0.0,0.0,160,0
22400780,2,124,8.0,3.870967741935484,720,596
22400780,2,47,-3.0,-3.829787234042553,585,538
22400780,2,44,-1.0,-1.3636363636363638,521,477
22400780,2,141,3.0,1.2765957446808511,477,336
22400780,2,6,-3.0,-30.0,325,319
22400780,2,61,-6.0,-5.9016393442622945,302,241
22400780,2,98,1.0,0.6122448979591836,230,132
22400780,2,47,2.0,2.5531914893617023,132,85
22400780,2,85,7.0,4.9411764705882355,85,0
22400780,3,337,-2.0,-0.3560830860534125,720,383
22400780,3,55,2.0,2.1818181818181817,377,322
22400780,3,63,1.0,0.9523809523809523,322,259
22400780,3,41,3.0,4.390243902439024,247,206
22400780,3,92,-1.0,-0.6521739130434783,206,114
22400780,3,86,-5.0,-3.488372093023256,114,28
22400780,3,28,1.0,2.142857142857143,28,0
22400780,4,220,-6.0,-1.6363636363636362,720,500
22400780,4,94,5.0,3.1914893617021276,500,406
22400780,4,19,0.0,0.0,406,387
22400780,4,88,0.0,0.0,374,286
22400780,4,280,-3.0,-0.6428571428571429,280,0
22400781,1,317,3.0,0.5678233438485805,720,403
22400781,1,14,0.0,0.0,394,380
22400781,1,15,0.0,0.0,380,365
22400781,1,93,-1.0,-0.6451612903225807,365,272
22400781,1,95,1.0,0.631578947368421,272,177
22400781,1,66,2.0,1.8181818181818183,165,99
22400781,2,167,2.0,0.718562874251497,720,553
22400781,2,82,-3.0,-2.195121951219512,545,463
22400781,2,47,-4.0,-5.1063829787234045,463,416
22400781,2,18,0.0,0.0,398,380
22400781,2,83,3.0,2.1686746987951806,369,286
22400781,2,209,4.0,1.1483253588516746,416,207
22400781,2,61,2.0,1.9672131147540985,207,146
22400781,3,346,6.0,1.0404624277456647,720,374
22400781,3,63,6.0,5.7142857142857135,374,311
22400781,3,55,2.0,2.1818181818181817,300,245
22400781,3,70,2.0,1.7142857142857142,245,175
22400781,3,112,-2.0,-1.0714285714285714,166,54
22400781,3,30,0.0,0.0,54,24
22400781,3,24,0.0,0.0,24,0
22400781,4,102,1.0,0.5882352941176471,720,618
22400781,4,23,0.0,0.0,618,595
22400781,4,49,-3.0,-3.673469387755102,595,546
22400781,4,81,3.0,2.2222222222222223,545,464
22400781,4,151,2.0,0.7947019867549668,452,301
22400781,4,16,-1.0,-3.75,296,280
22400781,4,280,-10.0,-2.142857142857143,280,0
22400782,1,366,3.0,0.49180327868852464,720,354
22400782,1,9,0.0,0.0,354,345
22400782,1,65,1.0,0.9230769230769231,331,266
22400782,1,78,-3.0,-2.307692307692308,266,188
22400782,1,40,-2.0,-3.0,163,123
22400782,1,8,0.0,0.0,98,90
22400782,1,78,-1.0,-0.7692307692307692,79,1
22400782,1,1,0.0,0.0,1,0
22400782,2,197,6.0,1.8274111675126905,720,523
22400782,2,38,2.0,3.1578947368421053,514,476
22400782,2,87,-1.0,-0.6896551724137931,452,365
22400782,2,140,0.0,0.0,362,222
22400782,2,41,1.0,1.4634146341463414,186,145
22400782,2,125,-7.0,-3.36,145,20
22400782,2,7,-2.0,-17.142857142857142,7,0
22400782,3,208,7.0,2.019230769230769,720,512
22400782,3,119,5.0,2.521008403361345,496,377
22400782,3,1,0.0,0.0,362,361
22400782,3,46,0.0,0.0,340,294
22400782,3,66,-5.0,-4.545454545454546,273,207
22400782,3,34,-2.0,-3.5294117647058822,197,163
22400782,3,39,0.0,0.0,163,124
22400782,3,55,-1.0,-1.0909090909090908,112,57
22400782,3,51,-2.0,-2.3529411764705883,51,0
22400782,4,94,4.0,2.5531914893617023,720,626
22400782,4,146,1.0,0.410958904109589,614,468
22400782,4,17,-2.0,-7.0588235294117645,465,448
22400782,4,27,2.0,4.444444444444445,448,421
22400782,4,15,0.0,0.0,421,406
22400782,4,35,2.0,3.4285714285714284,394,359
22400782,4,13,-2.0,-9.230769230769232,348,335
22400782,4,77,-5.0,-3.8961038961038956,335,258
22400782,4,213,-3.0,-0.8450704225352113,250,37
22400782,4,12,1.0,5.0,37,25
22400782,4,10,0.0,0.0,10,0
22400783,1,477,-5.0,-0.628930817610063,720,243
22400783,1,57,0.0,0.0,217,160
22400783,1,148,-5.0,-2.027027027027027,149,1
22400783,2,118,2.0,1.0169491525423728,720,602
22400783,2,82,0.0,0.0,602,520
22400783,2,22,0.0,0.0,520,498
22400783,2,90,3.0,2.0,487,397
22400783,2,1,0.0,0.0,390,389
22400783,2,47,0.0,0.0,374,327
22400783,2,104,4.0,2.307692307692308,327,223
22400783,2,17,0.0,0.0,187,170
22400783,2,54,0.0,0.0,157,103
22400783,2,103,2.0,1.1650485436893203,103,0
22400783,3,294,15.0,3.0612244897959187,720,426
22400783,3,14,0.0,0.0,402,388
22400783,3,33,4.0,7.272727272727273,385,352
22400783,3,53,-2.0,-2.2641509433962264,352,299
22400783,3,70,0.0,0.0,299,229
22400783,3,33,2.0,3.6363636363636367,221,188
22400783,3,24,-2.0,-5.0,180,156
22400783,3,155,0.0,0.0,156,1
22400783,4,72,2.0,1.6666666666666665,720,648
22400783,4,109,3.0,1.651376146788991,648,539
22400783,4,75,-3.0,-2.4,539,464
22400783,4,40,-2.0,-3.0,464,424
22400783,4,118,-4.0,-2.0338983050847457,424,306
22400783,4,37,1.0,1.6216216216216217,291,254
22400783,4,96,-3.0,-1.875,254,158
22400783,4,85,-4.0,-2.8235294117647056,142,57
22400783,4,44,-1.0,-1.3636363636363638,44,0
22400784,1,317,4.0,0.7570977917981072,720,403
22400784,1,30,3.0,6.0,388,358
22400784,1,19,0.0,0.0,354,335
22400784,1,31,-5.0,-9.67741935483871,323,292
22400784,1,4,-1.0,-15.0,270,266
22400784,1,16,0.0,0.0,266,250
22400784,1,49,3.0,3.673469387755102,233,184
22400784,1,14,-2.0,-8.571428571428571,165,151
22400784,1,54,1.0,1.1111111111111112,132,78
22400784,1,70,-5.0,-4.285714285714286,78,8
22400784,1,3,0.0,0.0,3,0
22400784,2,229,-6.0,-1.5720524017467248,720,491
22400784,2,38,0.0,0.0,469,431
22400784,2,22,3.0,8.181818181818182,421,399
22400784,2,119,-1.0,-0.5042016806722689,386,267
22400784,2,34,-4.0,-7.0588235294117645,267,233
22400784,2,34,2.0,3.5294117647058822,233,199
22400784,2,50,-2.0,-2.4,195,145
22400784,2,65,3.0,2.769230769230769,145,80
22400784,3,347,-7.0,-1.2103746397694524,720,373
22400784,3,105,0.0,0.0,373,268
22400784,3,34,-1.0,-1.7647058823529411,262,228
22400784,3,93,5.0,3.2258064516129035,228,135
22400784,3,23,0.0,0.0,135,112
22400784,3,81,4.0,2.962962962962963,101,20
22400784,3,20,0.0,0.0,20,0
22400784,4,79,3.0,2.278481012658228,720,641
22400784,4,89,3.0,2.0224719101123596,641,552
22400784,4,46,2.0,2.608695652173913,539,493
22400784,4,71,1.0,0.8450704225352113,493,422
22400784,4,132,1.0,0.4545454545454546,414,282
22400784,4,40,0.0,0.0,276,236
22400784,4,22,0.0,0.0,222,200
22400784,4,192,2.0,0.625,192,0
22400785,1,350,0.0,0.0,720,370
22400785,1,68,-1.0,-0.8823529411764706,360,292
22400785,1,34,0.0,0.0,280,246
22400785,1,1,0.0,0.0,230,229
22400785,1,79,4.0,3.0379746835443036,215,136
22400785,1,116,0.0,0.0,116,0
22400785,2,247,2.0,0.4858299595141701,720,473
22400785,2,105,-8.0,-4.571428571428572,398,293
22400785,2,100,-7.0,-4.2,279,179
22400785,2,169,3.0,1.0650887573964498,169,0
22400785,3,445,2.0,0.26966292134831465,720,275
22400785,3,4,0.0,0.0,275,271
22400785,3,112,1.0,0.5357142857142857,253,141
22400785,4,204,4.0,1.1764705882352942,720,516
22400785,4,108,-1.0,-0.5555555555555556,516,408
22400785,4,264,-10.0,-2.272727272727273,408,144
22400785,4,134,7.0,3.134328358208955,144,10
22400785,4,1,-1.0,-60.0,8,7
22400785,4,2,-1.0,-30.0,7,5
22400785,4,5,0.0,0.0,5,0
22400785,5,218,7.0,1.926605504587156,300,82
22400785,5,75,2.0,1.6,75,0
22400786,1,294,0.0,0.0,720,426
22400786,1,43,0.0,0.0,426,383
22400786,1,14,0.0,0.0,369,355
22400786,1,22,0.0,0.0,347,325
22400786,1,69,1.0,0.8695652173913043,325,256
22400786,1,82,0.0,0.0,243,161
22400786,1,57,0.0,0.0,161,104
22400786,1,98,-3.0,-1.836734693877551,98,0
22400786,2,112,4.0,2.142857142857143,720,608
22400786,2,77,2.0,1.5584415584415585,608,531
22400786,2,9,-2.0,-13.333333333333332,531,522
22400786,2,69,-3.0,-2.608695652173913,522,453
22400786,2,90,-3.0,-2.0,453,363
22400786,2,53,1.0,1.1320754716981132,348,295
22400786,2,89,2.0,1.348314606741573,292,203
22400786,2,26,0.0,0.0,203,177
22400786,2,102,-1.0,-0.5882352941176471,177,75
22400786,2,63,0.0,0.0,75,12
22400786,2,3,0.0,0.0,3,0
22400786,3,273,4.0,0.8791208791208791,720,447
22400786,3,48,-7.0,-8.75,447,399
22400786,3,45,-2.0,-2.666666666666667,399,354
22400786,3,81,5.0,3.7037037037037033,339,258
22400786,3,13,0.0,0.0,242,229
22400786,3,49,3.0,3.673469387755102,221,172
22400786,3,144,1.0,0.41666666666666663,172,28
22400786,3,28,-2.0,-4.285714285714286,28,0
22400786,4,178,-2.0,-0.6741573033707865,720,542
22400786,4,61,0.0,0.0,537,476
22400786,4,28,-5.0,-10.714285714285715,469,441
22400786,4,196,5.0,1.5306122448979593,441,245
22400786,4,114,3.0,1.5789473684210527,223,109
22400786,4,57,-4.0,-4.2105263157894735,109,52
22400786,4,24,0.0,0.0,52,28
22400786,4,8,1.0,7.5,16,8
22400786,4,5,0.0,0.0,5,0
22400787,1,403,3.0,0.4466501240694789,720,317
22400787,1,59,4.0,4.067796610169491,220,161
22400787,1,106,4.0,2.2641509433962264,161,55
22400787,1,55,1.0,1.0909090909090908,55,0
22400787,2,247,-1.0,-0.24291497975708504,720,473
22400787,2,70,3.0,2.5714285714285716,469,399
22400787,2,68,-5.0,-4.411764705882353,399,331
22400787,2,93,1.0,0.6451612903225807,323,230
22400787,2,130,2.0,0.9230769230769231,230,100
22400787,2,100,-3.0,-1.7999999999999998,100,0
22400787,3,121,-3.0,-1.487603305785124,720,599
22400787,3,224,1.0,0.26785714285714285,599,375
22400787,3,154,2.0,0.7792207792207793,375,221
22400787,3,75,5.0,4.0,213,138
22400787,3,6,0.0,0.0,138,132
22400787,3,120,-4.0,-2.0,120,0
22400787,4,155,4.0,1.5483870967741935,720,565
22400787,4,73,3.0,2.4657534246575343,548,475
22400787,4,15,0.0,0.0,475,460
22400787,4,108,0.0,0.0,447,339
22400787,4,47,1.0,1.2765957446808511,332,285
22400787,4,51,0.0,0.0,277,226
22400787,4,88,2.0,1.3636363636363638,210,122
22400787,4,104,-4.0,-2.307692307692308,104,0
22400788,1,322,-5.0,-0.9316770186335404,720,398
22400788,1,43,-5.0,-6.976744186046512,389,346
22400788,1,115,4.0,2.0869565217391304,346,231
22400788,1,100,-1.0,-0.6,231,131
22400788,1,40,3.0,4.5,111,71
22400788,1,29,4.0,8.275862068965518,60,31
22400788,1,31,0.0,0.0,31,0
22400788,2,171,1.0,0.3508771929824561,720,549
22400788,2,24,-1.0,-2.5,544,520
22400788,2,49,1.0,1.2244897959183672,520,471
22400788,2,96,5.0,3.125,398,302
22400788,2,34,2.0,3.5294117647058822,302,268
22400788,2,25,3.0,7.199999999999999,268,243
22400788,2,98,8.0,4.897959183673469,232,134
22400788,2,73,-1.0,-0.821917808219178,134,61
22400788,2,32,-1.0,-1.875,61,29
22400788,3,288,1.0,0.20833333333333331,720,432
22400788,3,83,-4.0,-2.891566265060241,424,341
22400788,3,9,0.0,0.0,341,332
22400788,3,24,-1.0,-2.5,322,298
22400788,3,52,-2.0,-2.307692307692308,298,246
22400788,3,9,-2.0,-13.333333333333332,230,221
22400788,3,67,0.0,0.0,221,154
22400788,3,89,3.0,2.0224719101123596,153,64
22400788,3,58,2.0,2.0689655172413794,62,4
22400788,3,2,0.0,0.0,2,0
22400788,4,43,2.0,2.7906976744186047,720,677
22400788,4,113,-1.0,-0.5309734513274336,677,564
22400788,4,24,-2.0,-5.0,551,527
22400788,4,78,-1.0,-0.7692307692307692,503,425
22400788,4,30,0.0,0.0,417,387
22400788,4,10,-1.0,-6.0,376,366
22400788,4,24,2.0,5.0,357,333
22400788,4,29,1.0,2.0689655172413794,326,297
22400788,4,206,5.0,1.4563106796116505,297,91
22400788,4,83,-4.0,-2.891566265060241,83,0
22400789,1,408,0.0,0.0,720,312
22400789,1,24,-1.0,-2.5,312,288
22400789,1,80,4.0,3.0,274,194
22400789,1,46,-2.0,-2.608695652173913,174,128
22400789,1,108,-3.0,-1.6666666666666665,128,20
22400789,1,20,0.0,0.0,20,0
22400789,2,220,-4.0,-1.0909090909090908,720,500
22400789,2,77,1.0,0.7792207792207793,464,387
22400789,2,30,2.0,4.0,372,342
22400789,2,9,0.0,0.0,342,333
22400789,2,103,-2.0,-1.1650485436893203,326,223
22400789,2,70,2.0,1.7142857142857142,223,153
22400789,2,153,-6.0,-2.3529411764705883,153,0
22400789,3,308,-8.0,-1.5584415584415585,720,412
22400789,3,72,3.0,2.5,397,325
22400789,3,111,-4.0,-2.1621621621621623,316,205
22400789,3,184,-1.0,-0.32608695652173914,187,3
22400789,4,194,4.0,1.2371134020618557,720,526
22400789,4,76,-1.0,-0.7894736842105263,526,450
22400789,4,10,2.0,12.0,450,440
22400789,4,150,-6.0,-2.4,440,290
22400789,4,242,4.0,0.9917355371900827,276,34
22400789,4,16,0.0,0.0,16,0
22400790,1,278,9.0,1.9424460431654675,720,442
22400790,1,29,1.0,2.0689655172413794,426,397
22400790,1,166,4.0,1.4457831325301205,397,231
22400790,1,27,2.0,4.444444444444445,231,204
22400790,1,191,-1.0,-0.31413612565445026,191,0
22400790,2,140,3.0,1.2857142857142858,720,580
22400790,2,67,1.0,0.8955223880597015,543,476
22400790,2,75,-4.0,-3.2,476,401
22400790,2,39,-1.0,-1.5384615384615383,386,347
22400790,2,39,1.0,1.5384615384615383,347,308
22400790,2,131,-5.0,-2.290076335877863,308,177
22400790,2,88,-2.0,-1.3636363636363638,165,77
22400790,2,77,-3.0,-2.3376623376623376,77,0
22400790,3,322,-4.0,-0.7453416149068323,720,398
22400790,3,65,0.0,0.0,398,333
22400790,3,54,-3.0,-3.333333333333333,326,272
22400790,3,44,0.0,0.0,272,228
22400790,3,75,1.0,0.8,205,130
22400790,3,58,-2.0,-2.0689655172413794,130,72
22400790,4,147,4.0,1.6326530612244898,720,573
22400790,4,124,-3.0,-1.4516129032258065,558,434
22400790,4,387,0.0,0.0,434,47
22400791,1,273,-1.0,-0.21978021978021978,720,447
22400791,1,27,2.0,4.444444444444445,440,413
22400791,1,152,4.0,1.5789473684210527,413,261
22400791,1,25,-2.0,-4.8,261,236
22400791,1,70,0.0,0.0,225,155
22400791,1,143,-1.0,-0.4195804195804196,143,0
22400791,2,170,1.0,0.3529411764705882,720,550
22400791,2,28,-1.0,-2.142857142857143,537,509
22400791,2,31,0.0,0.0,503,472
22400791,2,91,0.0,0.0,472,381
22400791,2,23,-2.0,-5.217391304347826,368,345
22400791,2,23,3.0,7.826086956521739,326,303
22400791,2,39,-3.0,-4.615384615384616,290,251
22400791,2,66,3.0,2.7272727272727275,238,172
22400791,2,154,7.0,2.7272727272727275,165,11
22400791,3,201,3.0,0.8955223880597015,720,519
22400791,3,112,-3.0,-1.607142857142857,504,392
22400791,3,15,0.0,0.0,392,377
22400791,3,145,-8.0,-3.310344827586207,364,219
22400791,3,136,-1.0,-0.4411764705882353,140,4
22400791,4,174,-6.0,-2.0689655172413794,720,546
22400791,4,33,2.0,3.6363636363636367,546,513
22400791,4,38,0.0,0.0,503,465
22400791,4,46,2.0,2.608695652173913,465,419
22400791,4,66,-4.0,-3.6363636363636367,414,348
22400791,4,27,-3.0,-6.666666666666666,327,300
22400791,4,71,-4.0,-3.380281690140845,289,218
22400791,4,19,0.0,0.0,206,187
22400791,4,179,8.0,2.681564245810056,179,0
22400792,1,367,1.0,0.16348773841961853,720,353
22400792,1,83,-1.0,-0.7228915662650602,335,252
22400792,1,17,0.0,0.0,242,225
22400792,1,36,-3.0,-5.0,225,189
22400792,1,51,3.0,3.5294117647058822,183,132
22400792,1,87,-3.0,-2.0689655172413794,113,26
22400792,2,200,3.0,0.8999999999999999,720,520
22400792,2,11,1.0,5.454545454545455,505,494
22400792,2,126,4.0,1.9047619047619047,494,368
22400792,2,93,-1.0,-0.6451612903225807,357,264
22400792,2,26,0.0,0.0,261,235
22400792,2,21,0.0,0.0,225,204
22400792,2,19,0.0,0.0,204,185
22400792,2,86,0.0,0.0,178,92
22400792,2,92,-1.0,-0.6521739130434783,92,0
22400792,3,201,3.0,0.8955223880597015,720,519
22400792,3,207,-5.0,-1.4492753623188406,499,292
22400792,3,75,-1.0,-0.8,283,208
22400792,3,183,4.0,1.3114754098360655,201,18
22400792,3,1,0.0,0.0,1,0
22400792,4,119,3.0,1.5126050420168067,720,601
22400792,4,27,1.0,2.2222222222222223,601,574
22400792,4,105,-1.0,-0.5714285714285715,574,469
22400792,4,56,0.0,0.0,452,396
22400792,4,9,-4.0,-26.666666666666664,379,370
22400792,4,42,3.0,4.285714285714286,370,328
22400792,4,86,2.0,1.3953488372093024,307,221
22400792,4,199,-1.0,-0.30150753768844224,221,22
22400792,4,6,0.0,0.0,6,0
22400792,5,105,5.0,2.8571428571428568,300,195
22400792,5,35,0.0,0.0,178,143
22400792,5,24,2.0,5.0,139,115
22400792,5,96,-5.0,-3.125,104,8
22400793,1,287,-6.0,-1.2543554006968642,720,433
22400793,1,34,-2.0,-3.5294117647058822,433,399
22400793,1,89,2.0,1.348314606741573,379,290
22400793,1,77,0.0,0.0,367,290
22400793,1,15,0.0,0.0,289,274
22400793,1,90,-2.0,-1.3333333333333335,270,180
22400793,1,41,2.0,2.926829268292683,173,132
22400793,2,51,-1.0,-1.1764705882352942,720,669
22400793,2,95,0.0,0.0,669,574
22400793,2,37,2.0,3.2432432432432434,563,526
22400793,2,46,0.0,0.0,516,470
22400793,2,56,2.0,2.142857142857143,449,393
22400793,2,130,5.0,2.307692307692308,377,247
22400793,2,59,-2.0,-2.0338983050847457,236,177
22400793,3,269,-5.0,-1.1152416356877324,720,451
22400793,3,65,-5.0,-4.615384615384616,436,371
22400793,3,30,-3.0,-6.0,359,329
22400793,3,71,-1.0,-0.8450704225352113,329,258
22400793,3,15,1.0,4.0,242,227
22400793,3,88,-1.0,-0.6818181818181819,227,139
22400793,3,124,0.0,0.0,124,0
22400793,4,196,-1.0,-0.3061224489795918,720,524
22400793,4,30,0.0,0.0,524,494
22400793,4,37,2.0,3.2432432432432434,486,449
22400793,4,13,0.0,0.0,432,419
22400793,4,21,-1.0,-2.8571428571428568,408,387
22400793,4,27,3.0,6.666666666666666,387,360
22400793,4,283,7.0,1.4840989399293285,360,77
22400793,4,48,3.0,3.75,74,26
22400794,1,273,-1.0,-0.21978021978021978,720,447
22400794,1,35,4.0,6.857142857142857,400,365
22400794,1,224,0.0,0.0,363,139
22400794,2,311,-6.0,-1.157556270096463,720,409
22400794,2,127,7.0,3.3070866141732282,399,272
22400794,2,154,-2.0,-0.7792207792207793,272,118
22400794,2,118,-1.0,-0.5084745762711864,118,0
22400794,3,97,-3.0,-1.8556701030927836,720,623
22400794,3,165,0.0,0.0,616,451
22400794,3,120,2.0,1.0,443,323
22400794,3,151,-2.0,-0.7947019867549668,309,158
22400794,3,17,0.0,0.0,135,118
22400794,4,147,6.0,2.4489795918367343,720,573
22400794,4,64,-2.0,-1.875,562,498
22400794,4,64,0.0,0.0,486,422
22400794,4,32,2.0,3.75,407,375
22400794,4,76,0.0,0.0,358,282
22400794,4,220,-2.0,-0.5454545454545454,282,62
22400794,4,62,5.0,4.838709677419355,62,0
22400795,1,351,3.0,0.5128205128205129,720,369
22400795,1,108,0.0,0.0,360,252
22400795,1,60,4.0,4.0,252,192
22400795,1,34,2.0,3.5294117647058822,192,158
22400795,1,148,0.0,0.0,148,0
22400795,2,125,4.0,1.92,720,595
22400795,2,29,-1.0,-2.0689655172413794,578,549
22400795,2,93,0.0,0.0,537,444
22400795,2,65,-4.0,-3.6923076923076925,426,361
22400795,2,11,-2.0,-10.90909090909091,337,326
22400795,2,110,-2.0,-1.0909090909090908,326,216
22400795,2,201,4.0,1.1940298507462686,201,0
22400795,3,210,4.0,1.142857142857143,720,510
22400795,3,323,-1.0,-0.18575851393188855,494,171
22400795,3,24,3.0,7.5,44,20
22400795,4,112,-3.0,-1.607142857142857,720,608
22400795,4,15,0.0,0.0,608,593
22400795,4,58,-6.0,-6.206896551724138,593,535
22400795,4,56,-1.0,-1.0714285714285714,514,458
22400795,4,35,2.0,3.4285714285714284,449,414
22400795,4,31,3.0,5.806451612903226,396,365
22400795,4,22,0.0,0.0,329,307
22400795,4,296,2.0,0.40540540540540543,296,0
22400796,1,280,-2.0,-0.42857142857142855,720,440
22400796,1,25,0.0,0.0,440,415
22400796,1,50,-2.0,-2.4,415,365
22400796,1,57,-4.0,-4.2105263157894735,365,308
22400796,1,108,3.0,1.6666666666666665,290,182
22400796,1,139,-7.0,-3.0215827338129495,178,39
22400796,1,29,-2.0,-4.137931034482759,29,0
22400796,2,84,-2.0,-1.4285714285714284,720,636
22400796,2,72,0.0,0.0,616,544
22400796,2,37,-3.0,-4.864864864864865,544,507
22400796,2,3,0.0,0.0,486,483
22400796,2,23,0.0,0.0,483,460
22400796,2,51,-2.0,-2.3529411764705883,460,409
22400796,2,24,3.0,7.5,386,362
22400796,2,88,1.0,0.6818181818181819,351,263
22400796,2,42,2.0,2.8571428571428568,263,221
22400796,2,54,2.0,2.2222222222222223,221,167
22400796,2,167,0.0,0.0,167,0
22400796,3,286,-3.0,-0.6293706293706294,720,434
22400796,3,60,4.0,4.0,428,368
22400796,3,41,0.0,0.0,366,325
22400796,3,12,0.0,0.0,307,295
22400796,3,25,0.0,0.0,289,264
22400796,3,50,1.0,1.2,228,178
22400796,3,88,-4.0,-2.7272727272727275,168,80
22400796,3,80,5.0,3.75,80,0
22400796,4,174,-4.0,-1.3793103448275863,720,546
22400796,4,73,3.0,2.4657534246575343,542,469
22400796,4,2,0.0,0.0,444,442
22400796,4,57,-2.0,-2.1052631578947367,430,373
22400796,4,50,0.0,0.0,362,312
22400796,4,15,0.0,0.0,312,297
22400796,4,20,3.0,9.0,291,271
22400796,4,223,1.0,0.26905829596412556,247,24
22400796,4,8,-1.0,-7.5,24,16
22400796,4,4,0.0,0.0,9,5
22400796,4,5,-1.0,-12.0,5,0
22400797,1,356,11.0,1.8539325842696628,720,364
22400797,1,25,0.0,0.0,364,339
22400797,1,62,-2.0,-1.935483870967742,331,269
22400797,1,80,0.0,0.0,269,189
22400797,1,94,3.0,1.9148936170212765,189,95
22400797,1,95,-2.0,-1.263157894736842,95,0
22400797,2,189,5.0,1.5873015873015872,720,531
22400797,2,20,2.0,6.0,521,501
22400797,2,7,1.0,8.571428571428571,486,479
22400797,2,75,-3.0,-2.4,479,404
22400797,2,3,0.0,0.0,393,390
22400797,2,36,1.0,1.6666666666666665,383,347
22400797,2,84,2.0,1.4285714285714284,347,263
22400797,2,84,0.0,0.0,230,146
22400797,2,136,6.0,2.647058823529412,136,0
22400797,3,247,-1.0,-0.24291497975708504,720,473
22400797,3,147,1.0,0.40816326530612246,462,315
22400797,3,62,1.0,0.967741935483871,303,241
22400797,3,163,2.0,0.7361963190184049,226,63
22400797,3,12,0.0,0.0,63,51
22400797,3,51,0.0,0.0,51,0
22400797,4,179,6.0,2.011173184357542,720,541
22400797,4,76,1.0,0.7894736842105263,525,449
22400797,4,185,0.0,0.0,449,264
22400797,4,264,3.0,0.6818181818181819,264,0
22400798,1,293,-1.0,-0.20477815699658702,720,427
22400798,1,50,2.0,2.4,427,377
22400798,1,103,-6.0,-3.4951456310679614,357,254
22400798,1,54,0.0,0.0,254,200
22400798,1,57,0.0,0.0,187,130
22400798,1,63,2.0,1.9047619047619047,115,52
22400798,1,17,0.0,0.0,40,23
22400798,1,23,3.0,7.826086956521739,23,0
22400798,2,199,3.0,0.9045226130653266,720,521
22400798,2,72,-2.0,-1.6666666666666665,510,438
22400798,2,24,1.0,2.5,429,405
22400798,2,42,1.0,1.4285714285714284,405,363
22400798,2,12,0.0,0.0,363,351
22400798,2,210,4.0,1.142857142857143,351,141
22400798,2,79,-1.0,-0.7594936708860759,141,62
22400798,3,102,7.0,4.11764705882353,720,618
22400798,3,135,2.0,0.888888888888889,618,483
22400798,3,53,2.0,2.2641509433962264,460,407
22400798,3,26,3.0,6.923076923076923,394,368
22400798,3,86,-1.0,-0.6976744186046512,352,266
22400798,3,24,-2.0,-5.0,266,242
22400798,3,31,-2.0,-3.870967741935484,217,186
22400798,3,186,-7.0,-2.2580645161290325,186,0
22400798,4,192,5.0,1.5625,720,528
22400798,4,155,-2.0,-0.7741935483870968,510,355
22400798,4,40,0.0,0.0,344,304
22400798,4,51,-1.0,-1.1764705882352942,304,253
22400798,4,33,-2.0,-3.6363636363636367,243,210
22400798,4,188,-5.0,-1.5957446808510638,198,10
22400798,4,10,0.0,0.0,10,0
22400799,1,272,7.0,1.5441176470588234,720,448
22400799,1,53,0.0,0.0,448,395
22400799,1,39,3.0,4.615384615384616,395,356
22400799,1,35,2.0,3.4285714285714284,351,316
22400799,1,24,-2.0,-5.0,296,272
22400799,1,78,3.0,2.307692307692308,266,188
22400799,1,165,1.0,0.36363636363636365,174,9
22400799,2,160,-1.0,-0.375,720,560
22400799,2,139,3.0,1.2949640287769786,560,421
22400799,2,29,0.0,0.0,421,392
22400799,2,184,0.0,0.0,387,203
22400799,2,51,-1.0,-1.1764705882352942,203,152
22400799,2,53,-3.0,-3.3962264150943398,152,99
22400799,2,99,-2.0,-1.2121212121212122,99,0
22400799,3,316,-13.0,-2.4683544303797467,720,404
22400799,3,19,0.0,0.0,392,373
22400799,3,17,1.0,3.5294117647058822,358,341
22400799,3,76,-3.0,-2.3684210526315788,341,265
22400799,3,42,2.0,2.8571428571428568,255,213
22400799,3,158,1.0,0.37974683544303794,198,40
22400799,3,2,-2.0,-60.0,35,33
22400799,4,132,-5.0,-2.272727272727273,720,588
22400799,4,127,0.0,0.0,571,444
22400799,4,39,-3.0,-4.615384615384616,439,400
22400799,4,54,4.0,4.444444444444445,396,342
22400799,4,126,2.0,0.9523809523809523,342,216
22400799,4,85,6.0,4.235294117647059,216,131
22400799,4,76,-1.0,-0.7894736842105263,114,38
22400799,4,33,0.0,0.0,33,0
22400800,1,312,-10.0,-1.923076923076923,720,408
22400800,1,144,-2.0,-0.8333333333333333,392,248
22400800,1,41,0.0,0.0,235,194
22400800,1,8,0.0,0.0,184,176
22400800,1,83,-2.0,-1.4457831325301205,159,76
22400800,1,76,1.0,0.7894736842105263,76,0
22400800,2,271,3.0,0.6642066420664207,720,449
22400800,2,71,-2.0,-1.6901408450704225,449,378
22400800,2,74,0.0,0.0,366,292
22400800,2,109,-1.0,-0.5504587155963303,276,167
22400800,2,152,1.0,0.39473684210526316,158,6
22400800,2,1,0.0,0.0,1,0
22400800,3,340,4.0,0.7058823529411764,720,380
22400800,3,74,4.0,3.2432432432432434,380,306
22400800,3,24,-2.0,-5.0,287,263
22400800,3,65,4.0,3.6923076923076925,252,187
22400800,3,63,-1.0,-0.9523809523809523,182,119
22400800,3,119,-3.0,-1.5126050420168067,119,0
22400800,4,175,-3.0,-1.0285714285714287,720,545
22400800,4,62,-2.0,-1.935483870967742,545,483
22400800,4,85,4.0,2.8235294117647056,474,389
22400800,4,67,3.0,2.6865671641791042,367,300
22400800,4,12,0.0,0.0,292,280
22400800,4,42,-2.0,-2.8571428571428568,277,235
22400800,4,228,4.0,1.0526315789473684,228,0
22400800,5,164,-5.0,-1.8292682926829267,300,136
22400800,5,113,-2.0,-1.0619469026548671,113,0
22400801,1,205,-1.0,-0.2926829268292683,720,515
22400801,1,84,7.0,5.0,513,429
22400801,1,190,9.0,2.8421052631578947,417,227
22400801,1,8,1.0,7.5,227,219
22400801,1,102,-7.0,-4.11764705882353,219,117
22400801,1,88,2.0,1.3636363636363638,117,29
22400801,1,16,-1.0,-3.75,29,13
22400801,1,6,0.0,0.0,6,0
22400801,2,138,-4.0,-1.7391304347826086,720,582
22400801,2,95,-3.0,-1.8947368421052633,568,473
22400801,2,38,0.0,0.0,456,418
22400801,2,207,0.0,0.0,418,211
22400801,2,168,0.0,0.0,203,35
22400801,3,139,-2.0,-0.8633093525179857,720,581
22400801,3,150,4.0,1.6,578,428
22400801,3,122,0.0,0.0,428,306
22400801,3,19,-1.0,-3.1578947368421053,293,274
22400801,3,57,-2.0,-2.1052631578947367,274,217
22400801,3,42,-1.0,-1.4285714285714284,198,156
22400801,3,88,7.0,4.7727272727272725,134,46
22400801,3,26,-1.0,-2.307692307692308,46,20
22400801,3,20,0.0,0.0,20,0
22400801,4,162,0.0,0.0,720,558
22400801,4,22,0.0,0.0,558,536
22400801,4,1,0.0,0.0,519,518
22400801,4,10,-2.0,-12.0,511,501
22400801,4,36,0.0,0.0,501,465
22400801,4,108,0.0,0.0,465,357
22400801,4,83,0.0,0.0,335,252
22400801,4,212,3.0,0.8490566037735849,237,25
22400801,4,16,1.0,3.75,25,9
22400801,4,6,0.0,0.0,6,0
22400802,1,322,-9.0,-1.6770186335403727,720,398
22400802,1,41,-2.0,-2.926829268292683,390,349
22400802,1,34,2.0,3.5294117647058822,349,315
22400802,1,130,0.0,0.0,301,171
22400802,1,55,2.0,2.1818181818181817,159,104
22400802,1,83,1.0,0.7228915662650602,86,3
22400802,1,3,2.0,40.0,3,0
22400802,2,260,10.0,2.307692307692308,720,460
22400802,2,46,1.0,1.3043478260869565,460,414
22400802,2,51,2.0,2.3529411764705883,402,351
22400802,2,123,3.0,1.4634146341463414,346,223
22400802,2,38,0.0,0.0,216,178
22400802,2,164,-8.0,-2.926829268292683,178,14
22400802,3,159,-6.0,-2.2641509433962264,720,561
22400802,3,93,-3.0,-1.935483870967742,546,453
22400802,3,66,4.0,3.6363636363636367,448,382
22400802,3,75,1.0,0.8,381,306
22400802,3,28,-1.0,-2.142857142857143,298,270
22400802,3,43,3.0,4.186046511627907,270,227
22400802,3,59,-6.0,-6.101694915254238,220,161
22400802,3,51,1.0,1.1764705882352942,161,110
22400802,3,61,-1.0,-0.9836065573770493,110,49
22400802,3,49,-3.0,-3.673469387755102,49,0
22400802,4,195,4.0,1.2307692307692308,720,525
22400802,4,37,-1.0,-1.6216216216216217,525,488
22400802,4,62,-2.0,-1.935483870967742,488,426
22400802,4,32,0.0,0.0,422,390
22400802,4,118,-2.0,-1.0169491525423728,390,272
22400802,4,47,0.0,0.0,248,201
22400802,4,32,0.0,0.0,190,158
22400803,1,309,6.0,1.1650485436893203,720,411
22400803,1,78,2.0,1.5384615384615383,411,333
22400803,1,99,4.0,2.4242424242424243,331,232
22400803,1,61,0.0,0.0,219,158
22400803,1,80,2.0,1.5,148,68
22400803,1,47,-1.0,-1.2765957446808511,48,1
22400803,1,1,0.0,0.0,1,0
22400803,2,133,-1.0,-0.45112781954887216,720,587
22400803,2,62,-2.0,-1.935483870967742,574,512
22400803,2,40,-3.0,-4.5,512,472
22400803,2,92,-5.0,-3.260869565217391,456,364
22400803,2,87,2.0,1.3793103448275863,346,259
22400803,2,16,3.0,11.25,249,233
22400803,2,88,-5.0,-3.409090909090909,219,131
22400803,2,20,2.0,6.0,107,87
22400803,2,87,5.0,3.4482758620689653,87,0
22400803,3,66,-1.0,-0.9090909090909092,720,654
22400803,3,111,0.0,0.0,654,543
22400803,3,39,-4.0,-6.153846153846153,535,496
22400803,3,47,1.0,1.2765957446808511,478,431
22400803,3,39,5.0,7.692307692307692,431,392
22400803,3,34,-4.0,-7.0588235294117645,392,358
22400803,3,57,6.0,6.315789473684211,344,287
22400803,3,85,1.0,0.7058823529411764,278,193
22400803,3,193,0.0,0.0,193,0
22400803,4,159,6.0,2.2641509433962264,720,561
22400803,4,94,-2.0,-1.2765957446808511,561,467
22400803,4,20,0.0,0.0,455,435
22400803,4,28,-2.0,-4.285714285714286,423,395
22400803,4,68,2.0,1.7647058823529411,371,303
22400803,4,247,4.0,0.9716599190283401,303,56
22400803,4,23,2.0,5.217391304347826,51,28
22400803,4,18,-2.0,-6.666666666666666,18,0
22400804,1,321,-1.0,-0.18691588785046728,720,399
22400804,1,88,-2.0,-1.3636363636363638,399,311
22400804,1,60,-1.0,-1.0,296,236
22400804,1,49,-1.0,-1.2244897959183672,223,174
22400804,1,142,2.0,0.8450704225352113,165,23
22400804,1,23,0.0,0.0,23,0
22400804,2,116,1.0,0.5172413793103449,720,604
22400804,2,185,-3.0,-0.972972972972973,590,405
22400804,2,75,-1.0,-0.8,379,304
22400804,2,85,-2.0,-1.4117647058823528,304,219
22400804,2,24,0.0,0.0,219,195
22400804,2,133,-6.0,-2.706766917293233,195,62
22400804,2,25,4.0,9.6,55,30
22400804,3,307,1.0,0.19543973941368079,720,413
22400804,3,79,2.0,1.5189873417721518,410,331
22400804,3,39,0.0,0.0,328,289
22400804,3,77,4.0,3.116883116883117,289,212
22400804,3,128,0.0,0.0,201,73
22400804,4,165,-1.0,-0.36363636363636365,720,555
22400804,4,87,-3.0,-2.0689655172413794,546,459
22400804,4,11,-1.0,-5.454545454545455,450,439
22400804,4,102,-1.0,-0.5882352941176471,439,337
22400804,4,160,1.0,0.375,323,163
22400804,4,1,-1.0,-60.0,163,162
22400804,4,153,-1.0,-0.39215686274509803,153,0
22400805,1,201,-1.0,-0.29850746268656714,720,519
22400805,1,67,3.0,2.6865671641791042,506,439
22400805,1,37,0.0,0.0,431,394
22400805,1,68,-2.0,-1.7647058823529411,386,318
22400805,1,16,0.0,0.0,305,289
22400805,1,18,1.0,3.333333333333333,281,263
22400805,1,45,-1.0,-1.3333333333333335,263,218
22400805,1,38,0.0,0.0,218,180
22400805,2,99,-3.0,-1.8181818181818183,720,621
22400805,2,39,0.0,0.0,603,564
22400805,2,31,-2.0,-3.870967741935484,551,520
22400805,2,35,-2.0,-3.4285714285714284,503,468
22400805,2,37,-1.0,-1.6216216216216217,453,416
22400805,2,98,2.0,1.2244897959183672,401,303
22400805,2,91,-2.0,-1.3186813186813189,294,203
22400805,2,79,2.0,1.5189873417721518,190,111
22400805,2,9,0.0,0.0,9,0
22400805,3,282,3.0,0.6382978723404256,720,438
22400805,3,28,-2.0,-4.285714285714286,438,410
22400805,3,29,-5.0,-10.344827586206897,390,361
22400805,3,28,2.0,4.285714285714286,349,321
22400805,3,34,0.0,0.0,308,274
22400805,3,54,3.0,3.333333333333333,262,208
22400805,3,57,0.0,0.0,208,151
22400805,3,106,-2.0,-1.1320754716981132,147,41
22400805,3,16,0.0,0.0,41,25
22400805,3,13,0.0,0.0,13,0
22400805,4,67,-4.0,-3.582089552238806,720,653
22400805,4,136,0.0,0.0,653,517
22400805,4,127,0.0,0.0,495,368
22400805,4,24,2.0,5.0,356,332
22400805,4,114,2.0,1.0526315789473684,329,215
22400805,4,19,0.0,0.0,196,177
22400805,4,149,-3.0,-1.2080536912751678,215,66
22400806,1,306,1.0,0.19607843137254902,720,414
22400806,1,69,3.0,2.608695652173913,406,337
22400806,1,52,2.0,2.307692307692308,328,276
22400806,1,59,3.0,3.050847457627119,265,206
22400806,1,187,1.0,0.32085561497326204,187,0
22400806,2,94,2.0,1.2765957446808511,720,626
22400806,2,66,-8.0,-7.272727272727273,626,560
22400806,2,179,0.0,0.0,552,373
22400806,2,92,3.0,1.9565217391304348,373,281
22400806,2,93,-4.0,-2.580645161290323,281,188
22400806,2,93,-6.0,-3.870967741935484,179,86
22400806,2,83,1.0,0.7228915662650602,86,3
22400806,2,3,0.0,0.0,3,0
22400806,3,79,-4.0,-3.0379746835443036,720,641
22400806,3,237,-1.0,-0.2531645569620253,633,396
22400806,3,54,0.0,0.0,381,327
22400806,3,49,1.0,1.2244897959183672,327,278
22400806,3,69,1.0,0.8695652173913043,276,207
22400806,3,207,8.0,2.318840579710145,207,0
22400806,4,98,-7.0,-4.285714285714286,720,622
22400806,4,121,1.0,0.49586776859504134,607,486
22400806,4,13,0.0,0.0,463,450
22400806,4,98,-2.0,-1.2244897959183672,434,336
22400806,4,19,1.0,3.1578947368421053,336,317
22400806,4,124,3.0,1.4516129032258065,317,193
22400806,4,20,2.0,6.0,150,130
22400806,4,25,0.0,0.0,130,105
22400806,4,45,-3.0,-4.0,105,60
22400806,4,47,-1.0,-1.2765957446808511,60,13
22400806,4,10,2.0,12.0,10,0
22400807,1,376,-7.0,-1.1170212765957446,720,344
22400807,1,68,-1.0,-0.8823529411764706,344,276
22400807,1,164,-2.0,-0.7317073170731707,276,112
22400807,1,85,-1.0,-0.7058823529411764,102,17
22400807,1,17,-1.0,-3.5294117647058822,17,0
22400807,2,87,0.0,0.0,720,633
22400807,2,58,2.0,2.0689655172413794,611,553
22400807,2,14,0.0,0.0,545,531
22400807,2,25,-2.0,-4.8,524,499
22400807,2,84,-2.0,-1.4285714285714284,499,415
22400807,2,65,0.0,0.0,401,336
22400807,2,37,0.0,0.0,336,299
22400807,2,35,-1.0,-1.7142857142857142,297,262
22400807,2,70,-5.0,-4.285714285714286,262,192
22400807,2,64,4.0,3.75,180,116
22400807,2,93,2.0,1.2903225806451615,93,0
22400807,3,397,-3.0,-0.4534005037783375,720,323
22400807,3,20,2.0,6.0,306,286
22400807,3,284,2.0,0.4225352112676056,286,2
22400807,4,193,-1.0,-0.31088082901554404,720,527
22400807,4,34,2.0,3.5294117647058822,527,493
22400807,4,35,2.0,3.4285714285714284,473,438
22400807,4,150,1.0,0.4,417,267
22400807,4,74,5.0,4.054054054054054,264,190
22400807,4,176,-5.0,-1.7045454545454546,176,0
22400808,1,316,1.0,0.18987341772151897,720,404
22400808,1,66,-1.0,-0.9090909090909092,395,329
22400808,1,27,-6.0,-13.333333333333332,324,297
22400808,1,34,-3.0,-5.294117647058824,251,217
22400808,1,104,0.0,0.0,214,110
22400808,1,110,5.0,2.7272727272727275,110,0
22400808,2,190,-1.0,-0.3157894736842105,720,530
22400808,2,41,-1.0,-1.4634146341463414,515,474
22400808,2,6,0.0,0.0,474,468
22400808,2,89,0.0,0.0,460,371
22400808,2,117,2.0,1.0256410256410258,371,254
22400808,2,28,-2.0,-4.285714285714286,187,159
22400808,2,119,0.0,0.0,142,23
22400808,3,338,1.0,0.17751479289940827,720,382
22400808,3,30,-2.0,-4.0,382,352
22400808,3,228,-6.0,-1.5789473684210527,343,115
22400808,3,90,3.0,2.0,102,12
22400808,3,12,0.0,0.0,12,0
22400808,4,86,0.0,0.0,720,634
22400808,4,29,0.0,0.0,628,599
22400808,4,126,-6.0,-2.8571428571428568,577,451
22400808,4,63,1.0,0.9523809523809523,430,367
22400808,4,104,-4.0,-2.307692307692308,359,255
22400808,4,43,-2.0,-2.7906976744186047,242,199
22400808,4,131,-4.0,-1.83206106870229,190,59
22400808,4,46,0.0,0.0,46,0
22400809,1,349,-4.0,-0.6876790830945558,720,371
22400809,1,75,0.0,0.0,371,296
22400809,1,38,-3.0,-4.7368421052631575,296,258
22400809,1,120,0.0,0.0,245,125
22400809,1,125,0.0,0.0,125,0
22400809,2,164,3.0,1.097560975609756,720,556
22400809,2,129,-5.0,-2.3255813953488373,542,413
22400809,2,34,-2.0,-3.5294117647058822,409,375
22400809,2,34,2.0,3.5294117647058822,360,326
22400809,2,23,0.0,0.0,318,295
22400809,2,36,1.0,1.6666666666666665,288,252
22400809,2,23,0.0,0.0,237,214
22400809,2,35,-1.0,-1.7142857142857142,209,174
22400809,3,97,2.0,1.2371134020618557,720,623
22400809,3,229,3.0,0.7860262008733624,623,394
22400809,3,32,0.0,0.0,383,351
22400809,3,114,0.0,0.0,351,237
22400809,3,65,-1.0,-0.9230769230769231,237,172
22400809,3,151,-1.0,-0.3973509933774834,151,0
22400809,4,138,2.0,0.8695652173913043,720,582
22400809,4,56,4.0,4.285714285714286,571,515
22400809,4,65,3.0,2.769230769230769,509,444
22400809,4,45,-1.0,-1.3333333333333335,434,389
22400809,4,97,1.0,0.6185567010309279,384,287
22400809,4,273,1.0,0.21978021978021978,273,0
22400810,1,242,4.0,0.9917355371900827,720,478
22400810,1,50,5.0,6.0,478,428
22400810,1,112,-8.0,-4.285714285714286,428,316
22400810,1,65,4.0,3.6923076923076925,316,251
22400810,1,35,-1.0,-1.7142857142857142,251,216
22400810,1,181,3.0,0.9944751381215469,216,35
22400810,1,35,5.0,8.571428571428571,35,0
22400810,2,51,-2.0,-2.3529411764705883,720,669
22400810,2,180,2.0,0.6666666666666667,669,489
22400810,2,98,-1.0,-0.6122448979591836,482,384
22400810,2,98,3.0,1.836734693877551,384,286
22400810,2,89,3.0,2.0224719101123596,270,181
22400810,2,7,2.0,17.142857142857142,160,153
22400810,2,68,5.0,4.411764705882353,153,85
22400810,2,85,6.0,4.235294117647059,85,0
22400810,3,298,-2.0,-0.40268456375838924,720,422
22400810,3,12,0.0,0.0,414,402
22400810,3,72,2.0,1.6666666666666665,391,319
22400810,3,109,9.0,4.954128440366973,319,210
22400810,3,107,0.0,0.0,199,92
22400810,3,92,0.0,0.0,92,0
22400810,4,61,0.0,0.0,720,659
22400810,4,15,1.0,4.0,649,634
22400810,4,114,2.0,1.0526315789473684,634,520
22400810,4,150,6.0,2.4,509,359
22400810,4,346,0.0,0.0,346,0
22400811,1,401,11.0,1.6458852867830422,720,319
22400811,1,28,-2.0,-4.285714285714286,300,272
22400811,1,78,4.0,3.0769230769230766,272,194
22400811,1,135,7.0,3.111111111111111,184,49
22400811,1,45,0.0,0.0,49,4
22400811,1,1,0.0,0.0,1,0
22400811,2,272,-8.0,-1.7647058823529411,720,448
22400811,2,55,2.0,2.1818181818181817,446,391
22400811,2,9,0.0,0.0,376,367
22400811,2,57,0.0,0.0,350,293
22400811,2,133,4.0,1.8045112781954886,281,148
22400811,2,51,-1.0,-1.1764705882352942,138,87
22400811,2,87,5.0,3.4482758620689653,87,0
22400811,3,179,0.0,0.0,720,541
22400811,3,182,-1.0,-0.3296703296703297,535,353
22400811,3,205,-9.0,-2.6341463414634143,342,137
22400811,3,130,-2.0,-0.9230769230769231,130,0
22400811,4,75,0.0,0.0,720,645
22400811,4,125,7.0,3.36,633,508
22400811,4,120,2.0,1.0,490,370
22400811,4,106,1.0,0.5660377358490566,358,252
22400811,4,234,-7.0,-1.794871794871795,234,0
22400812,1,256,0.0,0.0,720,464
22400812,1,129,6.0,2.7906976744186047,459,330
22400812,1,18,2.0,6.666666666666666,314,296
22400812,1,462,-1.0,-0.12987012987012986,683,221
22400812,1,154,6.0,2.3376623376623376,154,0
22400812,2,129,1.0,0.46511627906976744,720,591
22400812,2,34,2.0,3.5294117647058822,572,538
22400812,2,24,1.0,2.5,524,500
22400812,2,64,-2.0,-1.875,500,436
22400812,2,42,-1.0,-1.4285714285714284,426,384
22400812,2,108,-1.0,-0.5555555555555556,384,276
22400812,2,11,-2.0,-10.90909090909091,264,253
22400812,2,63,-1.0,-0.9523809523809523,247,184
22400812,2,87,4.0,2.7586206896551726,184,97
22400812,3,129,3.0,1.3953488372093024,720,591
22400812,3,94,-4.0,-2.5531914893617023,575,481
22400812,3,40,1.0,1.5,481,441
22400812,3,118,0.0,0.0,441,323
22400812,3,17,-1.0,-3.5294117647058822,323,306
22400812,3,68,3.0,2.647058823529412,306,238
22400812,3,116,1.0,0.5172413793103449,229,113
22400812,3,92,3.0,1.9565217391304348,97,5
22400812,3,5,0.0,0.0,5,0
22400812,4,211,4.0,1.137440758293839,720,509
22400812,4,85,-3.0,-2.1176470588235294,504,419
22400812,4,35,3.0,5.142857142857143,419,384
22400812,4,32,0.0,0.0,351,319
22400812,4,319,-4.0,-0.7523510971786833,319,0
22400813,1,370,2.0,0.32432432432432434,720,350
22400813,1,90,2.0,1.3333333333333335,350,260
22400813,1,86,0.0,0.0,250,164
22400813,1,30,-1.0,-2.0,164,134
22400813,1,39,-1.0,-1.5384615384615383,123,84
22400813,1,84,3.0,2.142857142857143,84,0
22400813,2,49,-2.0,-2.4489795918367343,720,671
22400813,2,154,4.0,1.5584415584415585,654,500
22400813,2,31,1.0,1.935483870967742,500,469
22400813,2,25,-2.0,-4.8,469,444
22400813,2,27,-2.0,-4.444444444444445,426,399
22400813,2,196,4.0,1.2244897959183672,379,183
22400813,2,30,3.0,6.0,170,140
22400813,2,116,0.0,0.0,123,7
22400813,2,3,0.0,0.0,3,0
22400813,3,159,5.0,1.8867924528301887,720,561
22400813,3,83,1.0,0.7228915662650602,542,459
22400813,3,42,0.0,0.0,459,417
22400813,3,128,3.0,1.40625,417,289
22400813,3,38,0.0,0.0,289,251
22400813,3,103,1.0,0.5825242718446602,244,141
22400813,3,42,1.0,1.4285714285714284,141,99
22400813,3,65,1.0,0.9230769230769231,99,34
22400813,3,34,0.0,0.0,34,0
22400813,4,200,-3.0,-0.8999999999999999,720,520
22400813,4,15,0.0,0.0,520,505
22400813,4,87,0.0,0.0,489,402
22400813,4,111,-1.0,-0.5405405405405406,401,290
22400813,4,89,3.0,2.0224719101123596,278,189
22400813,4,179,1.0,0.335195530726257,187,8
22400814,1,70,3.0,2.5714285714285716,720,650
22400814,1,16,1.0,3.75,490,474
22400814,1,61,-2.0,-1.9672131147540985,474,413
22400814,1,239,-5.0,-1.2552301255230125,406,167
22400814,2,105,5.0,2.8571428571428568,720,615
22400814,2,52,0.0,0.0,615,563
22400814,2,58,-1.0,-1.0344827586206897,563,505
22400814,2,20,0.0,0.0,497,477
22400814,2,85,-1.0,-0.7058823529411764,469,384
22400814,2,13,0.0,0.0,384,371
22400814,2,172,1.0,0.3488372093023256,302,130
22400814,2,121,-3.0,-1.487603305785124,121,0
22400814,3,95,0.0,0.0,720,625
22400814,3,81,2.0,1.4814814814814814,616,535
22400814,3,122,5.0,2.4590163934426226,527,405
22400814,3,65,-2.0,-1.8461538461538463,405,340
22400814,3,105,1.0,0.5714285714285715,340,235
22400814,3,64,-2.0,-1.875,235,171
22400814,3,21,0.0,0.0,164,143
22400814,3,140,-6.0,-2.5714285714285716,143,3
22400814,4,126,-2.0,-0.9523809523809523,720,594
22400814,4,25,0.0,0.0,594,569
22400814,4,76,3.0,2.3684210526315788,556,480
22400814,4,108,0.0,0.0,405,297
22400814,4,55,3.0,3.2727272727272725,284,229
22400814,4,14,0.0,0.0,215,201
22400814,4,132,4.0,1.8181818181818183,193,61
22400814,4,28,-2.0,-4.285714285714286,61,33
22400814,4,14,-2.0,-8.571428571428571,29,15
22400814,4,5,2.0,24.0,11,6
22400815,1,277,4.0,0.8664259927797834,720,443
22400815,1,129,-4.0,-1.8604651162790697,443,314
22400815,1,75,2.0,1.6,314,239
22400815,1,6,0.0,0.0,239,233
22400815,1,60,-3.0,-3.0,215,155
22400815,1,149,0.0,0.0,155,6
22400815,1,6,0.0,0.0,6,0
22400815,2,121,-2.0,-0.9917355371900827,720,599
22400815,2,27,2.0,4.444444444444445,581,554
22400815,2,26,0.0,0.0,537,511
22400815,2,42,4.0,5.7142857142857135,495,453
22400815,2,1,0.0,0.0,439,438
22400815,2,140,0.0,0.0,511,371
22400815,2,21,0.0,0.0,365,344
22400815,2,77,0.0,0.0,344,267
22400815,2,17,-2.0,-7.0588235294117645,265,248
22400815,2,126,2.0,0.9523809523809523,230,104
22400815,2,23,-1.0,-2.608695652173913,85,62
22400815,2,52,4.0,4.615384615384616,52,0
22400815,3,112,3.0,1.607142857142857,720,608
22400815,3,72,8.0,6.666666666666666,584,512
22400815,3,88,5.0,3.409090909090909,498,410
22400815,3,54,-3.0,-3.333333333333333,402,348
22400815,3,66,-4.0,-3.6363636363636367,346,280
22400815,3,112,2.0,1.0714285714285714,263,151
22400815,3,44,0.0,0.0,151,107
22400815,3,91,-1.0,-0.6593406593406594,93,2
22400815,4,152,4.0,1.5789473684210527,720,568
22400815,4,73,0.0,0.0,555,482
22400815,4,18,0.0,0.0,476,458
22400815,4,5,0.0,0.0,445,440
22400815,4,74,1.0,0.8108108108108109,434,360
22400815,4,92,4.0,2.608695652173913,353,261
22400815,4,261,-2.0,-0.45977011494252873,261,0
22400816,1,298,4.0,0.8053691275167785,720,422
22400816,1,34,-2.0,-3.5294117647058822,405,371
22400816,1,125,1.0,0.48,371,246
22400816,1,8,1.0,7.5,246,238
22400816,1,68,-1.0,-0.8823529411764706,238,170
22400816,1,48,2.0,2.5,154,106
22400816,1,89,0.0,0.0,98,9
22400816,2,173,3.0,1.0404624277456647,720,547
22400816,2,67,-4.0,-3.582089552238806,535,468
22400816,2,79,-2.0,-1.5189873417721518,461,382
22400816,2,120,-1.0,-0.5,380,260
22400816,2,53,4.0,4.528301886792453,249,196
22400816,2,94,3.0,1.9148936170212765,179,85
22400816,2,81,4.0,2.962962962962963,85,4
22400816,2,4,-1.0,-15.0,4,0
22400816,3,322,-4.0,-0.7453416149068323,720,398
22400816,3,66,-7.0,-6.363636363636364,398,332
22400816,3,108,1.0,0.5555555555555556,319,211
22400816,3,87,5.0,3.4482758620689653,190,103
22400816,3,11,0.0,0.0,103,92
22400816,3,57,-3.0,-3.1578947368421053,92,35
22400816,3,16,0.0,0.0,29,13
22400816,3,8,0.0,0.0,8,0
22400816,4,174,4.0,1.3793103448275863,720,546
22400816,4,87,0.0,0.0,546,459
22400816,4,42,-1.0,-1.4285714285714284,459,417
22400816,4,98,-5.0,-3.0612244897959187,417,319
22400816,4,234,13.0,3.333333333333333,307,73
22400816,4,58,0.0,0.0,58,0
22400817,1,316,-3.0,-0.569620253164557,720,404
22400817,1,13,-1.0,-4.615384615384616,394,381
22400817,1,93,5.0,3.2258064516129035,360,267
22400817,1,96,-5.0,-3.125,252,156
22400817,1,74,-2.0,-1.6216216216216217,149,75
22400817,1,25,-1.0,-2.4,68,43
22400817,1,34,-1.0,-1.7647058823529411,43,9
22400817,1,9,0.0,0.0,9,0
22400817,2,100,1.0,0.6,720,620
22400817,2,161,3.0,1.1180124223602486,620,459
22400817,2,21,0.0,0.0,459,438
22400817,2,26,0.0,0.0,424,398
22400817,2,165,2.0,0.7272727272727273,384,219
22400817,2,114,-6.0,-3.1578947368421053,219,105
22400817,2,53,4.0,4.528301886792453,105,52
22400817,2,10,3.0,18.0,52,42
22400817,2,9,0.0,0.0,42,33
22400817,2,21,-2.0,-5.7142857142857135,25,4
22400817,2,4,-1.0,-15.0,4,0
22400817,3,293,4.0,0.8191126279863481,720,427
22400817,3,47,0.0,0.0,427,380
22400817,3,47,-3.0,-3.829787234042553,380,333
22400817,3,26,2.0,4.615384615384616,325,299
22400817,3,41,2.0,2.926829268292683,299,258
22400817,3,69,-2.0,-1.7391304347826086,243,174
22400817,3,7,0.0,0.0,174,167
22400817,3,157,-2.0,-0.7643312101910829,157,0
22400817,4,76,4.0,3.1578947368421053,720,644
22400817,4,23,2.0,5.217391304347826,644,621
22400817,4,36,4.0,6.666666666666666,596,560
22400817,4,37,1.0,1.6216216216216217,545,508
22400817,4,52,0.0,0.0,495,443
22400817,4,141,0.0,0.0,443,302
22400817,4,288,4.0,0.8333333333333333,288,0
22400818,1,328,7.0,1.2804878048780488,720,392
22400818,1,41,0.0,0.0,392,351
22400818,1,57,0.0,0.0,339,282
22400818,1,36,-2.0,-3.333333333333333,273,237
22400818,1,56,1.0,1.0714285714285714,225,169
22400818,1,156,-3.0,-1.153846153846154,158,2
22400818,2,194,-5.0,-1.5463917525773194,720,526
22400818,2,47,0.0,0.0,514,467
22400818,2,18,0.0,0.0,455,437
22400818,2,30,0.0,0.0,431,401
22400818,2,45,-1.0,-1.3333333333333335,387,342
22400818,2,16,-3.0,-11.25,339,323
22400818,2,150,-1.0,-0.4,323,173
22400818,2,163,2.0,0.7361963190184049,163,0
22400818,3,238,1.0,0.25210084033613445,720,482
22400818,3,23,1.0,2.608695652173913,469,446
22400818,3,80,4.0,3.0,446,366
22400818,3,45,2.0,2.666666666666667,366,321
22400818,3,52,-4.0,-4.615384615384616,314,262
22400818,3,8,0.0,0.0,245,237
22400818,3,37,3.0,4.864864864864865,223,186
22400818,3,37,-4.0,-6.486486486486487,184,147
22400818,3,110,7.0,3.818181818181818,135,25
22400818,3,20,-1.0,-3.0,25,5
22400818,3,5,2.0,24.0,5,0
22400818,4,63,0.0,0.0,720,657
22400818,4,68,5.0,4.411764705882353,657,589
22400818,4,77,2.0,1.5584415584415585,589,512
22400818,4,53,3.0,3.3962264150943398,503,450
22400818,4,89,2.0,1.348314606741573,450,361
22400818,4,50,-1.0,-1.2,361,311
22400818,4,39,2.0,3.0769230769230766,311,272
22400818,4,181,8.0,2.6519337016574585,272,91
22400818,4,80,-1.0,-0.75,80,0
22400819,1,287,3.0,0.6271777003484321,720,433
22400819,1,44,-3.0,-4.090909090909091,411,367
22400819,1,76,6.0,4.7368421052631575,367,291
22400819,1,39,-3.0,-4.615384615384616,273,234
22400819,1,53,3.0,3.3962264150943398,229,176
22400819,1,48,2.0,2.5,176,128
22400819,1,90,-2.0,-1.3333333333333335,118,28
22400819,1,21,1.0,2.8571428571428568,28,7
22400819,1,7,0.0,0.0,7,0
22400819,2,217,-3.0,-0.8294930875576038,720,503
22400819,2,52,0.0,0.0,503,451
22400819,2,21,1.0,2.8571428571428568,451,430
22400819,2,18,2.0,6.666666666666666,430,412
22400819,2,102,2.0,1.1764705882352942,389,287
22400819,2,65,-5.0,-4.615384615384616,287,222
22400819,2,10,-1.0,-6.0,206,196
22400819,2,52,-3.0,-3.4615384615384617,196,144
22400819,2,113,1.0,0.5309734513274336,144,31
22400819,2,26,0.0,0.0,31,5
22400819,3,117,-7.0,-3.58974358974359,720,603
22400819,3,283,7.0,1.4840989399293285,603,320
22400819,3,87,3.0,2.0689655172413794,311,224
22400819,3,96,2.0,1.25,210,114
22400819,3,33,-2.0,-3.6363636363636367,114,81
22400819,3,55,0.0,0.0,81,26
22400819,3,17,-1.0,-3.5294117647058822,26,9
22400819,3,9,0.0,0.0,9,0
22400819,4,152,1.0,0.39473684210526316,720,568
22400819,4,68,3.0,2.647058823529412,537,469
22400819,4,38,-2.0,-3.1578947368421053,455,417
22400819,4,21,0.0,0.0,389,368
22400819,4,55,-1.0,-1.0909090909090908,368,313
22400819,4,39,-3.0,-4.615384615384616,313,274
22400819,4,68,-1.0,-0.8823529411764706,267,199
22400819,4,157,-3.0,-1.1464968152866242,199,42
22400819,4,15,1.0,4.0,42,27
22400819,4,1,0.0,0.0,27,26
22400819,4,3,1.0,20.0,23,20
22400819,4,5,-1.0,-12.0,20,15
22400819,4,6,1.0,10.0,15,9
22400819,4,5,0.0,0.0,5,0
22400820,1,360,4.0,0.6666666666666667,720,360
22400820,1,82,-4.0,-2.926829268292683,359,277
22400820,1,67,-4.0,-3.582089552238806,277,210
22400820,1,42,0.0,0.0,197,155
22400820,1,16,-1.0,-3.75,144,128
22400820,1,127,0.0,0.0,128,1
22400820,1,1,0.0,0.0,1,0
22400820,2,106,-2.0,-1.1320754716981132,720,614
22400820,2,94,-6.0,-3.829787234042553,614,520
22400820,2,64,-2.0,-1.875,500,436
22400820,2,69,2.0,1.7391304347826086,436,367
22400820,2,79,1.0,0.7594936708860759,364,285
22400820,2,54,3.0,3.333333333333333,276,222
22400820,2,120,6.0,3.0,222,102
22400820,2,102,1.0,0.5882352941176471,102,0
22400820,3,310,2.0,0.3870967741935484,720,410
22400820,3,21,3.0,8.571428571428571,390,369
22400820,3,84,-1.0,-0.7142857142857142,358,274
22400820,3,79,-6.0,-4.556962025316456,270,191
22400820,3,138,-1.0,-0.43478260869565216,182,44
22400820,3,27,-2.0,-4.444444444444445,44,17
22400820,4,211,9.0,2.5592417061611377,720,509
22400820,4,11,0.0,0.0,491,480
22400820,4,22,0.0,0.0,464,442
22400820,4,109,-4.0,-2.2018348623853212,432,323
22400820,4,150,-1.0,-0.4,314,164
22400820,4,93,-1.0,-0.6451612903225807,164,71
22400820,4,71,-1.0,-0.8450704225352113,71,0
22400821,1,313,3.0,0.5750798722044728,720,407
22400821,1,188,-5.0,-1.5957446808510638,407,219
22400821,1,104,3.0,1.7307692307692308,201,97
22400821,1,78,5.0,3.846153846153846,78,0
22400821,2,124,-7.0,-3.3870967741935485,720,596
22400821,2,43,-1.0,-1.3953488372093024,573,530
22400821,2,37,-3.0,-4.864864864864865,521,484
22400821,2,20,1.0,3.0,456,436
22400821,2,68,-1.0,-0.8823529411764706,436,368
22400821,2,37,1.0,1.6216216216216217,368,331
22400821,2,191,3.0,0.9424083769633508,323,132
22400821,2,18,0.0,0.0,111,93
22400821,2,61,-2.0,-1.9672131147540985,86,25
22400821,2,25,3.0,7.199999999999999,25,0
22400821,3,254,-4.0,-0.9448818897637795,720,466
22400821,3,39,0.0,0.0,466,427
22400821,3,116,2.0,1.0344827586206897,421,305
22400821,3,52,4.0,4.615384615384616,299,247
22400821,3,100,-1.0,-0.6,237,137
22400821,3,27,2.0,4.444444444444445,137,110
22400821,3,34,8.0,14.117647058823529,110,76
22400821,4,128,2.0,0.9375,720,592
22400821,4,118,-7.0,-3.5593220338983054,585,467
22400821,4,9,0.0,0.0,467,458
22400821,4,82,4.0,2.926829268292683,445,363
22400821,4,132,2.0,0.9090909090909092,359,227
22400821,4,4,-1.0,-15.0,218,214
22400821,4,93,0.0,0.0,214,121
22400821,4,35,1.0,1.7142857142857142,121,86
22400822,1,430,-10.0,-1.3953488372093024,720,290
22400822,1,70,1.0,0.8571428571428571,279,209
22400822,1,8,-2.0,-15.0,198,190
22400822,1,29,3.0,6.206896551724138,190,161
22400822,1,131,-1.0,-0.4580152671755725,156,25
22400822,2,66,2.0,1.8181818181818183,720,654
22400822,2,76,-3.0,-2.3684210526315788,647,571
22400822,2,21,-2.0,-5.7142857142857135,558,537
22400822,2,27,-1.0,-2.2222222222222223,537,510
22400822,2,82,4.0,2.926829268292683,510,428
22400822,2,54,1.0,1.1111111111111112,407,353
22400822,2,77,-1.0,-0.7792207792207793,353,276
22400822,2,64,0.0,0.0,276,212
22400822,2,83,4.0,2.891566265060241,194,111
22400822,2,101,-1.0,-0.594059405940594,101,0
22400822,3,293,-3.0,-0.6143344709897611,720,427
22400822,3,157,0.0,0.0,413,256
22400822,3,106,0.0,0.0,256,150
22400822,3,148,-6.0,-2.4324324324324325,150,2
22400822,3,2,0.0,0.0,2,0
22400822,4,198,4.0,1.2121212121212122,720,522
22400822,4,78,2.0,1.5384615384615383,522,444
22400822,4,64,2.0,1.875,431,367
22400822,4,367,-2.0,-0.32697547683923706,367,0
22400823,1,116,-4.0,-2.0689655172413794,720,604
22400823,1,98,0.0,0.0,604,506
22400823,1,93,-3.0,-1.935483870967742,495,402
22400823,1,48,3.0,3.75,386,338
22400823,1,65,1.0,0.9230769230769231,338,273
22400823,1,39,-2.0,-3.0769230769230766,259,220
22400823,1,86,-1.0,-0.6976744186046512,220,134
22400823,1,131,-1.0,-0.4580152671755725,134,3
22400823,1,3,0.0,0.0,3,0
22400823,2,172,-7.0,-2.4418604651162794,720,548
22400823,2,60,1.0,1.0,529,469
22400823,2,102,-2.0,-1.1764705882352942,469,367
22400823,2,69,-3.0,-2.608695652173913,355,286
22400823,2,75,0.0,0.0,277,202
22400823,2,51,0.0,0.0,187,136
22400823,2,110,2.0,1.0909090909090908,131,21
22400823,2,21,-2.0,-5.7142857142857135,21,0
22400823,3,40,-3.0,-4.5,720,680
22400823,3,238,-8.0,-2.0168067226890756,674,436
22400823,3,62,-2.0,-1.935483870967742,424,362
22400823,3,22,2.0,5.454545454545455,354,332
22400823,3,25,-1.0,-2.4,325,300
22400823,3,132,-5.0,-2.272727272727273,300,168
22400823,3,21,0.0,0.0,157,136
22400823,3,59,2.0,2.0338983050847457,130,71
22400823,3,61,-3.0,-2.9508196721311473,61,0
22400823,4,124,-7.0,-3.3870967741935485,720,596
22400823,4,23,4.0,10.434782608695652,585,562
22400823,4,123,-3.0,-1.4634146341463414,545,422
22400823,4,99,-4.0,-2.4242424242424243,422,323
22400823,4,59,1.0,1.0169491525423728,315,256
22400823,4,256,13.0,3.046875,256,0
22400824,1,161,6.0,2.236024844720497,720,559
22400824,1,114,5.0,2.631578947368421,535,421
22400824,1,60,0.0,0.0,398,338
22400824,1,43,0.0,0.0,333,290
22400824,1,20,3.0,9.0,284,264
22400824,1,85,-5.0,-3.5294117647058822,260,175
22400824,1,153,1.0,0.39215686274509803,158,5
22400824,2,111,-3.0,-1.6216216216216217,720,609
22400824,2,31,0.0,0.0,591,560
22400824,2,13,0.0,0.0,537,524
22400824,2,50,2.0,2.4,508,458
22400824,2,62,1.0,0.967741935483871,458,396
22400824,2,53,-2.0,-2.2641509433962264,396,343
22400824,2,80,1.0,0.75,343,263
22400824,2,43,2.0,2.7906976744186047,243,200
22400824,2,56,-1.0,-1.0714285714285714,191,135
22400824,2,123,2.0,0.9756097560975611,123,0
22400824,3,320,-9.0,-1.6875,720,400
22400824,3,80,-2.0,-1.5,388,308
22400824,3,9,2.0,13.333333333333332,299,290
22400824,3,57,-4.0,-4.2105263157894735,290,233
22400824,3,66,1.0,0.9090909090909092,233,167
22400824,3,144,1.0,0.41666666666666663,167,23
22400824,3,23,0.0,0.0,23,0
22400824,4,110,1.0,0.5454545454545454,720,610
22400824,4,34,1.0,1.7647058823529411,590,556
22400824,4,95,-5.0,-3.1578947368421053,458,363
22400824,4,22,2.0,5.454545454545455,341,319
22400824,4,58,-2.0,-2.0689655172413794,297,239
22400824,4,217,7.0,1.935483870967742,230,13
22400825,1,352,0.0,0.0,720,368
22400825,1,49,-3.0,-3.673469387755102,354,305
22400825,1,126,-1.0,-0.47619047619047616,292,166
22400825,1,45,-3.0,-4.0,166,121
22400825,1,100,3.0,1.7999999999999998,100,0
22400825,2,229,0.0,0.0,720,491
22400825,2,30,0.0,0.0,472,442
22400825,2,176,-2.0,-0.6818181818181819,428,252
22400825,2,44,-2.0,-2.7272727272727275,237,193
22400825,2,117,4.0,2.0512820512820515,180,63
22400825,2,63,1.0,0.9523809523809523,63,0
22400825,3,357,5.0,0.8403361344537815,720,363
22400825,3,61,-2.0,-1.9672131147540985,342,281
22400825,3,71,-3.0,-2.535211267605634,273,202
22400825,3,109,3.0,1.651376146788991,200,91
22400825,3,82,1.0,0.7317073170731707,91,9
22400825,4,196,-1.0,-0.3061224489795918,720,524
22400825,4,55,4.0,4.363636363636363,514,459
22400825,4,50,-1.0,-1.2,439,389
22400825,4,71,-2.0,-1.6901408450704225,389,318
22400825,4,318,6.0,1.1320754716981132,318,0
22400826,1,321,4.0,0.7476635514018691,720,399
22400826,1,79,1.0,0.7594936708860759,385,306
22400826,1,114,-2.0,-1.0526315789473684,296,182
22400826,1,18,-1.0,-3.333333333333333,170,152
22400826,1,152,0.0,0.0,152,0
22400826,2,116,3.0,1.5517241379310345,720,604
22400826,2,71,2.0,1.6901408450704225,593,522
22400826,2,130,4.0,1.8461538461538463,515,385
22400826,2,9,-1.0,-6.666666666666666,385,376
22400826,2,52,4.0,4.615384615384616,376,324
22400826,2,98,0.0,0.0,311,213
22400826,2,17,0.0,0.0,213,196
22400826,2,28,2.0,4.285714285714286,173,145
22400826,2,145,6.0,2.4827586206896552,145,0
22400826,3,192,0.0,0.0,720,528
22400826,3,74,2.0,1.6216216216216217,519,445
22400826,3,85,-2.0,-1.4117647058823528,445,360
22400826,3,51,-1.0,-1.1764705882352942,344,293
22400826,3,50,3.0,3.5999999999999996,293,243
22400826,3,35,-2.0,-3.4285714285714284,224,189
22400826,3,27,2.0,4.444444444444445,189,162
22400826,3,162,3.0,1.1111111111111112,162,0
22400826,4,236,-5.0,-1.271186440677966,720,484
22400826,4,45,1.0,1.3333333333333335,476,431
22400826,4,210,-2.0,-0.5714285714285715,431,221
22400826,4,51,-3.0,-3.5294117647058822,221,170
22400826,4,115,-9.0,-4.695652173913044,149,34
22400826,4,7,-2.0,-17.142857142857142,18,11
22400826,4,3,0.0,0.0,3,0
22400826,5,177,-3.0,-1.0169491525423728,300,123
22400826,5,46,0.0,0.0,108,62
22400826,5,40,2.0,3.0,62,22
22400826,5,3,0.0,0.0,13,10
22400826,5,4,-1.0,-15.0,10,6
22400826,5,2,0.0,0.0,2,0
22400827,1,239,0.0,0.0,720,481
22400827,1,33,0.0,0.0,469,436
22400827,1,163,0.0,0.0,431,268
22400827,1,73,2.0,1.643835616438356,252,179
22400827,1,172,4.0,1.3953488372093024,172,0
22400827,2,123,1.0,0.48780487804878053,720,597
22400827,2,18,0.0,0.0,578,560
22400827,2,34,0.0,0.0,544,510
22400827,2,167,0.0,0.0,503,336
22400827,2,76,-4.0,-3.1578947368421053,336,260
22400827,2,81,-4.0,-2.962962962962963,251,170
22400827,2,155,-7.0,-2.7096774193548385,155,0
22400827,3,268,1.0,0.22388059701492538,720,452
22400827,3,45,-2.0,-2.666666666666667,446,401
22400827,3,41,0.0,0.0,401,360
22400827,3,14,-1.0,-4.285714285714286,347,333
22400827,3,5,2.0,24.0,272,267
22400827,3,83,-1.0,-0.7228915662650602,255,172
22400827,4,160,2.0,0.75,720,560
22400827,4,28,3.0,6.428571428571428,560,532
22400827,4,25,0.0,0.0,521,496
22400827,4,57,-5.0,-5.263157894736842,486,429
22400827,4,59,1.0,1.0169491525423728,427,368
22400827,4,39,-1.0,-1.5384615384615383,352,313
22400827,4,133,-1.0,-0.45112781954887216,301,168
22400827,4,139,5.0,2.158273381294964,153,14
22400827,4,8,1.0,7.5,11,3
22400828,1,244,0.0,0.0,720,476
22400828,1,88,8.0,5.454545454545455,470,382
22400828,1,181,2.0,0.6629834254143646,375,194
22400828,1,11,-1.0,-5.454545454545455,194,183
22400828,1,100,3.0,1.7999999999999998,183,83
22400828,1,58,1.0,1.0344827586206897,58,0
22400828,2,84,0.0,0.0,720,636
22400828,2,35,2.0,3.4285714285714284,636,601
22400828,2,54,1.0,1.1111111111111112,599,545
22400828,2,46,2.0,2.608695652173913,539,493
22400828,2,149,0.0,0.0,474,325
22400828,2,2,0.0,0.0,310,308
22400828,2,98,1.0,0.6122448979591836,294,196
22400828,2,122,0.0,0.0,187,65
22400828,2,19,2.0,6.315789473684211,59,40
22400828,2,7,0.0,0.0,23,16
22400828,2,15,1.0,4.0,16,1
22400828,2,1,0.0,0.0,1,0
22400828,3,201,-8.0,-2.388059701492537,720,519
22400828,3,96,1.0,0.625,519,423
22400828,3,83,1.0,0.7228915662650602,417,334
22400828,3,64,-2.0,-1.875,334,270
22400828,3,109,0.0,0.0,263,154
22400828,3,26,2.0,4.615384615384616,133,107
22400828,3,99,3.0,1.8181818181818183,99,0
22400828,4,129,5.0,2.3255813953488373,720,591
22400828,4,65,7.0,6.461538461538462,577,512
22400828,4,107,9.0,5.046728971962617,506,399
22400828,4,179,4.0,1.340782122905028,390,211
22400828,4,198,1.0,0.30303030303030304,198,0
22400829,1,334,-3.0,-0.5389221556886228,720,386
22400829,1,21,0.0,0.0,373,352
22400829,1,19,-4.0,-12.631578947368421,333,314
22400829,1,113,1.0,0.5309734513274336,304,191
22400829,1,37,-2.0,-3.2432432432432434,188,151
22400829,1,29,0.0,0.0,136,107
22400829,1,100,2.0,1.2,100,0
22400829,2,118,6.0,3.050847457627119,720,602
22400829,2,12,0.0,0.0,602,590
22400829,2,102,1.0,0.5882352941176471,583,481
22400829,2,52,-1.0,-1.153846153846154,470,418
22400829,2,125,-2.0,-0.96,405,280
22400829,2,270,-6.0,-1.3333333333333335,270,0
22400829,3,235,0.0,0.0,720,485
22400829,3,66,-2.0,-1.8181818181818183,465,399
22400829,3,6,0.0,0.0,386,380
22400829,3,105,1.0,0.5714285714285715,369,264
22400829,3,35,0.0,0.0,250,215
22400829,3,21,0.0,0.0,199,178
22400829,3,83,-1.0,-0.7228915662650602,168,85
22400829,3,47,3.0,3.829787234042553,85,38
22400829,3,30,-3.0,-6.0,38,8
22400829,3,1,0.0,0.0,1,0
22400829,4,221,2.0,0.5429864253393666,720,499
22400829,4,35,0.0,0.0,489,454
22400829,4,29,-2.0,-4.137931034482759,437,408
22400829,4,92,-3.0,-1.9565217391304348,397,305
22400829,4,95,2.0,1.263157894736842,296,201
22400829,4,78,-5.0,-3.846153846153846,186,108
22400829,4,100,2.0,1.2,100,0
22400830,1,267,0.0,0.0,720,453
22400830,1,25,0.0,0.0,438,413
22400830,1,111,-8.0,-4.324324324324325,413,302
22400830,1,29,0.0,0.0,283,254
22400830,1,16,0.0,0.0,239,223
22400830,1,202,-6.0,-1.782178217821782,202,0
22400830,2,107,0.0,0.0,720,613
22400830,2,19,0.0,0.0,613,594
22400830,2,47,-1.0,-1.2765957446808511,580,533
22400830,2,55,-3.0,-3.2727272727272725,533,478
22400830,2,1,0.0,0.0,466,465
22400830,2,50,4.0,4.8,443,393
22400830,2,71,4.0,3.380281690140845,377,306
22400830,2,53,0.0,0.0,293,240
22400830,2,232,3.0,0.7758620689655172,232,0
22400830,3,263,-5.0,-1.1406844106463878,720,457
22400830,3,148,-2.0,-0.8108108108108109,444,296
22400830,3,26,-1.0,-2.307692307692308,280,254
22400830,3,30,-2.0,-4.0,254,224
22400830,3,85,-6.0,-4.235294117647059,222,137
22400830,3,137,4.0,1.751824817518248,137,0
22400830,4,217,-3.0,-0.8294930875576038,720,503
22400830,4,109,-3.0,-1.651376146788991,487,378
22400830,4,130,-8.0,-3.6923076923076925,362,232
22400830,4,222,-2.0,-0.5405405405405406,222,0
22400831,1,340,7.0,1.2352941176470589,720,380
22400831,1,82,1.0,0.7317073170731707,372,290
22400831,1,99,2.0,1.2121212121212122,290,191
22400831,1,44,0.0,0.0,176,132
22400831,1,42,0.0,0.0,120,78
22400831,1,59,-1.0,-1.0169491525423728,59,0
22400831,2,200,-3.0,-0.8999999999999999,720,520
22400831,2,32,0.0,0.0,520,488
22400831,2,38,6.0,9.473684210526315,474,436
22400831,2,96,-1.0,-0.625,418,322
22400831,2,97,-3.0,-1.8556701030927836,322,225
22400831,2,58,-3.0,-3.103448275862069,215,157
22400831,2,150,-4.0,-1.6,152,2
22400831,2,1,0.0,0.0,1,0
22400831,3,374,0.0,0.0,720,346
22400831,3,123,2.0,0.9756097560975611,346,223
22400831,3,17,-1.0,-3.5294117647058822,210,193
22400831,3,93,-4.0,-2.580645161290323,193,100
22400831,3,100,3.0,1.7999999999999998,100,0
22400831,4,194,1.0,0.30927835051546393,720,526
22400831,4,67,2.0,1.791044776119403,509,442
22400831,4,10,2.0,12.0,430,420
22400831,4,136,-5.0,-2.2058823529411766,403,267
22400831,4,51,0.0,0.0,267,216
22400831,4,208,1.0,0.2884615384615385,216,8
22400831,4,5,0.0,0.0,8,3
22400831,4,3,0.0,0.0,3,0
22400832,1,342,1.0,0.17543859649122806,720,378
22400832,1,15,0.0,0.0,367,352
22400832,1,69,3.0,2.608695652173913,352,283
22400832,1,52,0.0,0.0,273,221
22400832,1,23,0.0,0.0,202,179
22400832,1,92,-5.0,-3.260869565217391,170,78
22400832,1,78,2.0,1.5384615384615383,78,0
22400832,2,218,-3.0,-0.8256880733944955,720,502
22400832,2,125,-4.0,-1.92,491,366
22400832,2,70,0.0,0.0,358,288
22400832,2,49,0.0,0.0,288,239
22400832,2,60,3.0,3.0,220,160
22400832,2,148,2.0,0.8108108108108109,148,0
22400832,3,294,-1.0,-0.20408163265306123,720,426
22400832,3,90,4.0,2.666666666666667,426,336
22400832,3,39,2.0,3.0769230769230766,325,286
22400832,3,46,-5.0,-6.521739130434782,270,224
22400832,3,67,2.0,1.791044776119403,210,143
22400832,3,70,8.0,6.857142857142857,143,73
22400832,3,48,-1.0,-1.25,48,0
22400832,4,121,-3.0,-1.487603305785124,720,599
22400832,4,66,1.0,0.9090909090909092,587,521
22400832,4,72,-2.0,-1.6666666666666665,521,449
22400832,4,65,0.0,0.0,449,384
22400832,4,88,2.0,1.3636363636363638,384,296
22400832,4,42,1.0,1.4285714285714284,292,250
22400832,4,12,0.0,0.0,250,238
22400832,4,62,-2.0,-1.935483870967742,231,169
22400832,4,136,-1.0,-0.4411764705882353,169,33
22400832,4,11,0.0,0.0,27,16
22400832,4,7,3.0,25.71428571428571,16,9
22400832,5,191,-4.0,-1.256544502617801,300,109
22400832,5,73,3.0,2.4657534246575343,88,15
22400832,5,6,0.0,0.0,8,2
22400833,1,362,-12.0,-1.9889502762430937,720,358
22400833,1,112,0.0,0.0,337,225
22400833,1,13,-1.0,-4.615384615384616,206,193
22400833,1,121,-1.0,-0.49586776859504134,170,49
22400833,1,42,2.0,2.8571428571428568,49,7
22400833,1,7,-2.0,-17.142857142857142,7,0
22400833,2,188,-1.0,-0.3191489361702128,720,532
22400833,2,26,2.0,4.615384615384616,525,499
22400833,2,15,-2.0,-8.0,488,473
22400833,2,54,6.0,6.666666666666666,451,397
22400833,2,146,-2.0,-0.821917808219178,397,251
22400833,2,104,6.0,3.4615384615384617,241,137
22400833,2,114,5.0,2.631578947368421,124,10
22400833,3,275,-3.0,-0.6545454545454545,720,445
22400833,3,35,0.0,0.0,445,410
22400833,3,122,-2.0,-0.9836065573770493,394,272
22400833,3,63,2.0,1.9047619047619047,267,204
22400833,3,14,-1.0,-4.285714285714286,203,189
22400833,3,95,1.0,0.631578947368421,189,94
22400833,3,94,1.0,0.6382978723404256,94,0
22400833,4,158,2.0,0.7594936708860759,720,562
22400833,4,36,6.0,10.0,562,526
22400833,4,26,1.0,2.307692307692308,502,476
22400833,4,65,3.0,2.769230769230769,476,411
22400833,4,31,-2.0,-3.870967741935484,411,380
22400833,4,40,-1.0,-1.5,380,340
22400833,4,47,0.0,0.0,340,293
22400833,4,107,3.0,1.6822429906542056,284,177
22400833,4,23,1.0,2.608695652173913,158,135
22400833,4,21,0.0,0.0,135,114
22400833,4,80,-3.0,-2.25,103,23
22400833,4,16,2.0,7.5,16,0
22400834,1,283,5.0,1.0600706713780919,720,437
22400834,1,97,-6.0,-3.711340206185567,428,331
22400834,1,12,0.0,0.0,315,303
22400834,1,28,2.0,4.285714285714286,173,145
22400834,1,136,2.0,0.8823529411764706,136,0
22400834,2,367,2.0,0.32697547683923706,720,353
22400834,2,52,3.0,3.4615384615384617,342,290
22400834,2,5,1.0,12.0,280,275
22400834,2,77,-1.0,-0.7792207792207793,275,198
22400834,2,194,-3.0,-0.9278350515463918,198,4
22400834,3,291,7.0,1.443298969072165,720,429
22400834,3,37,3.0,4.864864864864865,419,382
22400834,3,16,3.0,11.25,327,311
22400834,3,60,0.0,0.0,289,229
22400834,3,65,1.0,0.9230769230769231,229,164
22400834,3,53,1.0,1.1320754716981132,161,108
22400834,3,89,0.0,0.0,89,0
22400834,4,113,5.0,2.6548672566371683,720,607
22400834,4,90,0.0,0.0,592,502
22400834,4,156,4.0,1.5384615384615383,494,338
22400834,4,301,-2.0,-0.39867109634551495,326,25
22400835,1,238,3.0,0.7563025210084033,720,482
22400835,1,125,-1.0,-0.48,472,347
22400835,1,107,5.0,2.803738317757009,347,240
22400835,1,29,-1.0,-2.0689655172413794,240,211
22400835,1,79,0.0,0.0,211,132
22400835,1,12,1.0,5.0,119,107
22400835,1,107,1.0,0.5607476635514018,107,0
22400835,2,212,1.0,0.2830188679245283,720,508
22400835,2,78,0.0,0.0,508,430
22400835,2,18,-2.0,-6.666666666666666,410,392
22400835,2,116,6.0,3.103448275862069,377,261
22400835,2,56,2.0,2.142857142857143,261,205
22400835,2,186,-7.0,-2.2580645161290325,186,0
22400835,3,196,-2.0,-0.6122448979591836,720,524
22400835,3,24,2.0,5.0,524,500
22400835,3,17,0.0,0.0,490,473
22400835,3,102,-6.0,-3.5294117647058822,464,362
22400835,3,21,2.0,5.7142857142857135,354,333
22400835,3,32,-2.0,-3.75,317,285
22400835,3,139,1.0,0.43165467625899284,285,146
22400835,3,64,-2.0,-1.875,133,69
22400835,3,10,0.0,0.0,59,49
22400835,3,31,0.0,0.0,31,0
22400835,4,272,2.0,0.4411764705882353,720,448
22400835,4,184,2.0,0.6521739130434783,429,245
22400835,4,139,4.0,1.7266187050359714,229,90
22400835,4,90,2.0,1.3333333333333335,90,0
22400836,1,387,1.0,0.15503875968992248,720,333
22400836,1,50,-2.0,-2.4,318,268
22400836,1,71,-3.0,-2.535211267605634,268,197
22400836,1,174,11.0,3.7931034482758625,174,0
22400836,2,226,6.0,1.592920353982301,720,494
22400836,2,92,-3.0,-1.9565217391304348,487,395
22400836,2,77,-6.0,-4.675324675324675,379,302
22400836,2,42,4.0,5.7142857142857135,279,237
22400836,2,59,-4.0,-4.067796610169491,222,163
22400836,2,15,0.0,0.0,147,132
22400836,3,330,6.0,1.0909090909090908,720,390
22400836,3,75,2.0,1.6,367,292
22400836,3,63,1.0,0.9523809523809523,280,217
22400836,3,198,1.0,0.30303030303030304,198,0
22400836,4,193,8.0,2.4870466321243523,720,527
22400836,4,55,-1.0,-1.0909090909090908,517,462
22400836,4,88,1.0,0.6818181818181819,453,365
22400836,4,58,2.0,2.0689655172413794,338,280
22400836,4,96,1.0,0.625,259,163
22400836,4,50,2.0,2.4,145,95
22400837,1,340,5.0,0.8823529411764706,720,380
22400837,1,23,0.0,0.0,363,340
22400837,1,43,2.0,2.7906976744186047,333,290
22400837,1,22,3.0,8.181818181818182,290,268
22400837,1,106,-3.0,-1.6981132075471699,260,154
22400837,1,90,-1.0,-0.6666666666666667,145,55
22400837,1,35,-2.0,-3.4285714285714284,35,0
22400837,2,23,0.0,0.0,720,697
22400837,2,48,-4.0,-5.0,677,629
22400837,2,100,0.0,0.0,610,510
22400837,2,27,0.0,0.0,507,480
22400837,2,35,1.0,1.7142857142857142,470,435
22400837,2,112,1.0,0.5357142857142857,435,323
22400837,2,72,2.0,1.6666666666666665,306,234
22400837,2,22,0.0,0.0,219,197
22400837,2,15,0.0,0.0,197,182
22400837,2,142,4.0,1.6901408450704225,169,27
22400837,2,27,2.0,4.444444444444445,27,0
22400837,3,222,-3.0,-0.8108108108108109,720,498
22400837,3,173,2.0,0.6936416184971098,498,325
22400837,3,103,1.0,0.5825242718446602,311,208
22400837,3,55,5.0,5.454545454545455,196,141
22400837,3,24,0.0,0.0,126,102
22400837,3,88,2.0,1.3636363636363638,88,0
22400837,4,46,0.0,0.0,720,674
22400837,4,61,-2.0,-1.9672131147540985,662,601
22400837,4,107,-2.0,-1.1214953271028036,601,494
22400837,4,101,0.0,0.0,494,393
22400837,4,3,0.0,0.0,382,379
22400837,4,64,0.0,0.0,363,299
22400837,4,121,5.0,2.479338842975207,284,163
22400837,4,150,1.0,0.4,150,0
22400838,1,296,11.0,2.22972972972973,720,424
22400838,1,150,6.0,2.4,414,264
22400838,1,95,-3.0,-1.8947368421052633,260,165
22400838,1,56,2.0,2.142857142857143,146,90
22400838,1,73,-2.0,-1.643835616438356,75,2
22400838,1,2,0.0,0.0,2,0
22400838,2,107,-1.0,-0.5607476635514018,720,613
22400838,2,57,2.0,2.1052631578947367,597,540
22400838,2,15,-2.0,-8.0,537,522
22400838,2,97,5.0,3.092783505154639,522,425
22400838,2,117,2.0,1.0256410256410258,407,290
22400838,2,93,0.0,0.0,275,182
22400838,2,112,3.0,1.607142857142857,163,51
22400838,2,8,1.0,7.5,41,33
22400838,2,33,0.0,0.0,33,0
22400838,3,176,-6.0,-2.0454545454545454,720,544
22400838,3,200,3.0,0.8999999999999999,521,321
22400838,3,128,2.0,0.9375,321,193
22400838,3,148,-1.0,-0.40540540540540543,190,42
22400838,3,42,0.0,0.0,42,0
22400838,4,43,0.0,0.0,720,677
22400838,4,32,-2.0,-3.75,677,645
22400838,4,161,-1.0,-0.37267080745341613,626,465
22400838,4,425,-2.0,-0.2823529411764706,457,32
22400838,4,5,0.0,0.0,27,22
22400838,4,1,0.0,0.0,22,21
22400838,4,21,0.0,0.0,21,0
22400839,1,302,0.0,0.0,720,418
22400839,1,3,0.0,0.0,418,415
22400839,1,33,0.0,0.0,405,372
22400839,1,111,-3.0,-1.6216216216216217,372,261
22400839,1,3,0.0,0.0,260,257
22400839,1,65,3.0,2.769230769230769,257,192
22400839,1,56,-4.0,-4.285714285714286,192,136
22400839,1,25,1.0,2.4,124,99
22400839,1,85,-4.0,-2.8235294117647056,94,9
22400839,2,221,2.0,0.5429864253393666,720,499
22400839,2,49,4.0,4.897959183673469,487,438
22400839,2,59,0.0,0.0,424,365
22400839,2,154,2.0,0.7792207792207793,355,201
22400839,2,33,2.0,3.6363636363636367,201,168
22400839,2,140,-5.0,-2.142857142857143,151,11
22400839,3,256,6.0,1.40625,720,464
22400839,3,80,-2.0,-1.5,464,384
22400839,3,15,1.0,4.0,384,369
22400839,3,30,-4.0,-8.0,369,339
22400839,3,74,0.0,0.0,339,265
22400839,3,106,-3.0,-1.6981132075471699,255,149
22400839,3,15,0.0,0.0,149,134
22400839,3,101,-3.0,-1.782178217821782,134,33
22400839,3,33,-1.0,-1.8181818181818183,33,0
22400839,4,154,0.0,0.0,720,566
22400839,4,103,2.0,1.1650485436893203,566,463
22400839,4,78,0.0,0.0,455,377
22400839,4,113,3.0,1.592920353982301,377,264
22400839,4,33,0.0,0.0,243,210
22400839,4,146,0.0,0.0,201,55
22400839,4,12,-1.0,-5.0,55,43
22400839,4,5,0.0,0.0,43,38
22400839,4,1,0.0,0.0,35,34
22400839,4,33,2.0,3.6363636363636367,33,0
22400840,1,314,8.0,1.5286624203821657,720,406
22400840,1,51,0.0,0.0,395,344
22400840,1,19,0.0,0.0,327,308
22400840,1,1,0.0,0.0,292,291
22400840,1,39,-5.0,-7.692307692307692,277,238
22400840,1,231,-1.0,-0.2597402597402597,238,7
22400840,1,4,0.0,0.0,4,0
22400840,2,196,-6.0,-1.836734693877551,720,524
22400840,2,45,-2.0,-2.666666666666667,511,466
22400840,2,38,-2.0,-3.1578947368421053,460,422
22400840,2,101,-1.0,-0.594059405940594,414,313
22400840,2,104,2.0,1.153846153846154,313,209
22400840,2,154,4.0,1.5584415584415585,209,55
22400840,2,47,4.0,5.1063829787234045,47,0
22400840,3,244,-2.0,-0.49180327868852464,720,476
22400840,3,52,0.0,0.0,476,424
22400840,3,61,-2.0,-1.9672131147540985,413,352
22400840,3,17,3.0,10.588235294117649,341,324
22400840,3,13,-1.0,-4.615384615384616,324,311
22400840,3,92,1.0,0.6521739130434783,304,212
22400840,3,15,-1.0,-4.0,212,197
22400840,3,176,-5.0,-1.7045454545454546,197,21
22400840,3,1,0.0,0.0,1,0
22400840,4,203,-4.0,-1.1822660098522169,720,517
22400840,4,64,-6.0,-5.625,512,448
22400840,4,16,-2.0,-7.5,436,420
22400840,4,69,-6.0,-5.217391304347826,405,336
22400840,4,79,1.0,0.7594936708860759,336,257
22400840,4,220,3.0,0.8181818181818181,257,37
22400840,4,17,1.0,3.5294117647058822,37,20
22400840,4,1,-1.0,-60.0,20,19
22400840,4,19,0.0,0.0,19,0
22400841,1,329,5.0,0.9118541033434651,720,391
22400841,1,179,-2.0,-0.670391061452514,373,194
22400841,1,37,0.0,0.0,181,144
22400841,1,38,-2.0,-3.1578947368421053,144,106
22400841,1,12,1.0,5.0,98,86
22400841,1,86,3.0,2.0930232558139537,86,0
22400841,2,124,1.0,0.4838709677419355,720,596
22400841,2,52,-5.0,-5.769230769230769,581,529
22400841,2,33,0.0,0.0,529,496
22400841,2,22,2.0,5.454545454545455,472,450
22400841,2,111,3.0,1.6216216216216217,428,317
22400841,2,18,-2.0,-6.666666666666666,314,296
22400841,2,112,-2.0,-1.0714285714285714,280,168
22400841,2,7,-2.0,-17.142857142857142,168,161
22400841,2,92,-3.0,-1.9565217391304348,143,51
22400841,2,8,0.0,0.0,38,30
22400841,2,18,0.0,0.0,30,12
22400841,2,12,0.0,0.0,12,0
22400841,3,343,1.0,0.1749271137026239,720,377
22400841,3,97,0.0,0.0,377,280
22400841,3,21,-2.0,-5.7142857142857135,280,259
22400841,3,45,2.0,2.666666666666667,253,208
22400841,3,208,10.0,2.8846153846153846,208,0
22400841,4,196,2.0,0.6122448979591836,720,524
22400841,4,31,3.0,5.806451612903226,524,493
22400841,4,65,3.0,2.769230769230769,468,403
22400841,4,52,-4.0,-4.615384615384616,398,346
22400841,4,151,0.0,0.0,325,174
22400841,4,131,5.0,2.290076335877863,174,43
22400841,4,30,0.0,0.0,30,0
22400842,1,288,-5.0,-1.0416666666666667,720,432
22400842,1,154,0.0,0.0,424,270
22400842,1,61,3.0,2.9508196721311473,248,187
22400842,1,16,-1.0,-3.75,187,171
22400842,1,144,0.0,0.0,171,27
22400842,2,50,-2.0,-2.4,720,670
22400842,2,110,-5.0,-2.7272727272727275,637,527
22400842,2,113,4.0,2.1238938053097343,515,402
22400842,2,180,9.0,3.0,383,203
22400842,2,177,2.0,0.6779661016949152,201,24
22400842,2,4,0.0,0.0,4,0
22400842,3,349,0.0,0.0,720,371
22400842,3,50,2.0,2.4,354,304
22400842,3,66,3.0,2.7272727272727275,304,238
22400842,3,7,0.0,0.0,217,210
22400842,3,19,-3.0,-9.473684210526315,200,181
22400842,3,164,-3.0,-1.097560975609756,164,0
22400842,4,48,-2.0,-2.5,720,672
22400842,4,67,-2.0,-1.791044776119403,650,583
22400842,4,146,-1.0,-0.410958904109589,575,429
22400842,4,8,2.0,15.0,423,415
22400842,4,14,0.0,0.0,392,378
22400842,4,168,3.0,1.0714285714285714,373,205
22400842,4,84,0.0,0.0,197,113
22400842,4,99,-1.0,-0.6060606060606061,113,14
22400842,4,12,1.0,5.0,12,0
22400843,1,339,4.0,0.7079646017699115,720,381
22400843,1,22,2.0,5.454545454545455,239,217
22400843,1,32,3.0,5.625,217,185
22400843,1,174,0.0,0.0,174,0
22400843,2,116,-1.0,-0.5172413793103449,720,604
22400843,2,109,-2.0,-1.1009174311926606,565,456
22400843,2,209,-5.0,-1.4354066985645932,432,223
22400843,2,28,2.0,4.285714285714286,212,184
22400843,2,168,-1.0,-0.3571428571428571,184,16
22400843,3,226,6.0,1.592920353982301,720,494
22400843,3,71,-1.0,-0.8450704225352113,494,423
22400843,3,44,-3.0,-4.090909090909091,423,379
22400843,3,42,1.0,1.4285714285714284,379,337
22400843,3,36,0.0,0.0,329,293
22400843,3,53,2.0,2.2641509433962264,286,233
22400843,3,129,-2.0,-0.9302325581395349,217,88
22400843,4,157,-2.0,-0.7643312101910829,720,563
22400843,4,95,-3.0,-1.8947368421052633,552,457
22400843,4,48,2.0,2.5,436,388
22400843,4,196,-1.0,-0.3061224489795918,388,192
22400843,4,32,0.0,0.0,192,160
22400843,4,146,2.0,0.821917808219178,146,0
22400844,1,305,9.0,1.7704918032786885,720,415
22400844,1,70,2.0,1.7142857142857142,408,338
22400844,1,43,0.0,0.0,327,284
22400844,1,123,-2.0,-0.9756097560975611,284,161
22400844,1,161,0.0,0.0,161,0
22400844,2,206,0.0,0.0,720,514
22400844,2,25,1.0,2.4,514,489
22400844,2,83,0.0,0.0,489,406
22400844,2,20,1.0,3.0,406,386
22400844,2,79,3.0,2.278481012658228,386,307
22400844,2,26,0.0,0.0,307,281
22400844,2,94,-3.0,-1.9148936170212765,281,187
22400844,2,83,3.0,2.1686746987951806,187,104
22400844,2,104,4.0,2.307692307692308,104,0
22400844,3,349,2.0,0.3438395415472779,720,371
22400844,3,101,3.0,1.782178217821782,371,270
22400844,3,135,1.0,0.4444444444444445,270,135
22400844,4,205,-3.0,-0.8780487804878049,720,515
22400844,4,52,0.0,0.0,504,452
22400844,4,74,0.0,0.0,440,366
22400844,4,96,-2.0,-1.25,366,270
22400844,4,258,-10.0,-2.3255813953488373,258,0
22400845,1,290,5.0,1.0344827586206897,720,430
22400845,1,32,2.0,3.75,421,389
22400845,1,71,0.0,0.0,377,306
22400845,1,38,0.0,0.0,289,251
22400845,1,80,-2.0,-1.5,235,155
22400845,1,149,4.0,1.610738255033557,155,6
22400845,2,174,0.0,0.0,720,546
22400845,2,63,6.0,5.7142857142857135,546,483
22400845,2,45,2.0,2.666666666666667,469,424
22400845,2,24,-1.0,-2.5,419,395
22400845,2,78,-3.0,-2.307692307692308,395,317
22400845,2,113,0.0,0.0,312,199
22400845,2,83,2.0,1.4457831325301205,189,106
22400845,3,282,-10.0,-2.127659574468085,720,438
22400845,3,22,0.0,0.0,429,407
22400845,3,122,-8.0,-3.934426229508197,399,277
22400845,3,104,1.0,0.576923076923077,277,173
22400845,3,24,0.0,0.0,165,141
22400845,3,128,2.0,0.9375,128,0
22400845,4,109,-5.0,-2.7522935779816518,720,611
22400845,4,107,1.0,0.5607476635514018,609,502
22400845,4,71,-4.0,-3.380281690140845,502,431
22400845,4,131,4.0,1.83206106870229,416,285
22400845,4,159,5.0,1.8867924528301887,274,115
22400845,4,75,-2.0,-1.6,115,40
22400845,4,19,0.0,0.0,40,21
22400845,4,16,2.0,7.5,20,4
22400845,4,2,0.0,0.0,2,0
22400846,1,357,5.0,0.8403361344537815,720,363
22400846,1,197,-6.0,-1.8274111675126905,351,154
22400846,1,137,2.0,0.875912408759124,234,97
22400846,1,86,-4.0,-2.7906976744186047,88,2
22400846,2,318,-1.0,-0.18867924528301888,720,402
22400846,2,13,0.0,0.0,388,375
22400846,2,112,0.0,0.0,368,256
22400846,2,113,-1.0,-0.5309734513274336,241,128
22400846,2,123,2.0,0.9756097560975611,123,0
22400846,3,333,6.0,1.0810810810810811,720,387
22400846,3,169,3.0,1.0650887573964498,371,202
22400846,3,48,0.0,0.0,202,154
22400846,3,27,-1.0,-2.2222222222222223,154,127
22400846,3,14,-1.0,-4.285714285714286,127,113
22400846,3,102,1.0,0.5882352941176471,113,11
22400846,3,2,0.0,0.0,2,0
22400846,4,297,3.0,0.6060606060606061,720,423
22400846,4,123,3.0,1.4634146341463414,423,300
22400846,4,100,1.0,0.6,300,200
22400846,4,186,0.0,0.0,186,0
22400847,1,210,4.0,1.142857142857143,720,510
22400847,1,105,0.0,0.0,510,405
22400847,1,51,0.0,0.0,405,354
22400847,1,20,0.0,0.0,354,334
22400847,1,31,-2.0,-3.870967741935484,321,290
22400847,1,13,0.0,0.0,270,257
22400847,1,7,-2.0,-17.142857142857142,237,230
22400847,1,61,2.0,1.9672131147540985,215,154
22400847,1,154,-8.0,-3.116883116883117,154,0
22400847,2,156,-5.0,-1.923076923076923,720,564
22400847,2,197,6.0,1.8274111675126905,564,367
22400847,2,50,-2.0,-2.4,349,299
22400847,2,109,5.0,2.7522935779816518,299,190
22400847,2,35,-2.0,-3.4285714285714284,166,131
22400847,2,38,1.0,1.5789473684210527,121,83
22400847,2,73,-2.0,-1.643835616438356,73,0
22400847,3,271,-4.0,-0.8856088560885609,720,449
22400847,3,34,2.0,3.5294117647058822,436,402
22400847,3,39,0.0,0.0,382,343
22400847,3,72,-1.0,-0.8333333333333333,338,266
22400847,3,30,2.0,4.0,252,222
22400847,3,13,0.0,0.0,222,209
22400847,3,192,2.0,0.625,192,0
22400847,4,120,3.0,1.5,720,600
22400847,4,69,-1.0,-0.8695652173913043,586,517
22400847,4,59,-2.0,-2.0338983050847457,517,458
22400847,4,139,1.0,0.43165467625899284,445,306
22400847,4,46,4.0,5.217391304347826,295,249
22400847,4,107,-4.0,-2.2429906542056073,249,142
22400847,4,107,4.0,2.2429906542056073,128,21
22400847,4,7,-1.0,-8.571428571428571,20,13
22400847,4,10,0.0,0.0,10,0
22400848,1,334,1.0,0.17964071856287425,720,386
22400848,1,86,-2.0,-1.3953488372093024,383,297
22400848,1,24,2.0,5.0,284,260
22400848,1,95,-5.0,-3.1578947368421053,246,151
22400848,1,22,1.0,2.7272727272727275,151,129
22400848,1,111,0.0,0.0,116,5
22400848,1,1,-2.0,-120.0,1,0
22400848,2,117,-6.0,-3.0769230769230766,720,603
22400848,2,30,-3.0,-6.0,603,573
22400848,2,62,2.0,1.935483870967742,551,489
22400848,2,47,2.0,2.5531914893617023,483,436
22400848,2,18,0.0,0.0,425,407
22400848,2,186,11.0,3.548387096774194,398,212
22400848,3,320,3.0,0.5625,720,400
22400848,3,23,0.0,0.0,400,377
22400848,3,130,-3.0,-1.3846153846153846,368,238
22400848,3,175,0.0,0.0,223,48
22400848,3,36,0.0,0.0,36,0
22400848,4,68,0.0,0.0,720,652
22400848,4,77,-8.0,-6.233766233766234,637,560
22400848,4,61,0.0,0.0,560,499
22400848,4,92,1.0,0.6521739130434783,492,400
22400848,4,143,1.0,0.4195804195804196,389,246
22400848,4,175,-1.0,-0.34285714285714286,235,60
22400848,4,22,0.0,0.0,52,30
22400848,4,11,-1.0,-5.454545454545455,29,18
22400848,4,18,-2.0,-6.666666666666666,18,0
22400849,1,201,2.0,0.5970149253731343,720,519
22400849,1,112,5.0,2.678571428571429,519,407
22400849,1,73,1.0,0.821917808219178,407,334
22400849,1,50,2.0,2.4,325,275
22400849,1,98,0.0,0.0,269,171
22400849,1,46,2.0,2.608695652173913,160,114
22400849,1,98,0.0,0.0,100,2
22400849,2,174,2.0,0.6896551724137931,720,546
22400849,2,215,0.0,0.0,720,505
22400849,2,49,-4.0,-4.897959183673469,497,448
22400849,2,82,1.0,0.7317073170731707,448,366
22400849,2,65,0.0,0.0,366,301
22400849,2,100,-3.0,-1.7999999999999998,243,143
22400849,2,131,-5.0,-2.290076335877863,131,0
22400849,3,88,4.0,2.7272727272727275,720,632
22400849,3,124,1.0,0.4838709677419355,612,488
22400849,3,36,0.0,0.0,483,447
22400849,3,103,-2.0,-1.1650485436893203,435,332
22400849,3,11,0.0,0.0,332,321
22400849,3,77,-4.0,-3.116883116883117,321,244
22400849,3,54,1.0,1.1111111111111112,238,184
22400849,3,56,-1.0,-1.0714285714285714,176,120
22400849,3,83,-1.0,-0.7228915662650602,104,21
22400849,3,21,0.0,0.0,21,0
22400849,4,164,3.0,1.097560975609756,720,556
22400849,4,83,-5.0,-3.6144578313253013,556,473
22400849,4,7,-1.0,-8.571428571428571,473,466
22400849,4,21,-2.0,-5.7142857142857135,466,445
22400849,4,58,-1.0,-1.0344827586206897,428,370
22400849,4,60,-2.0,-2.0,370,310
22400849,4,56,2.0,2.142857142857143,300,244
22400849,4,140,3.0,1.2857142857142858,244,104
22400849,4,1,0.0,0.0,49,48
22400849,4,44,0.0,0.0,44,0
22400850,1,215,-1.0,-0.27906976744186046,720,505
22400850,1,121,-12.0,-5.950413223140496,505,384
22400850,1,59,-1.0,-1.0169491525423728,379,320
22400850,1,77,1.0,0.7792207792207793,320,243
22400850,1,66,6.0,5.454545454545455,243,177
22400850,1,177,1.0,0.3389830508474576,177,0
22400850,2,245,4.0,0.979591836734694,720,475
22400850,2,49,3.0,3.673469387755102,463,414
22400850,2,189,-2.0,-0.6349206349206349,402,213
22400850,2,92,2.0,1.3043478260869565,213,121
22400850,2,47,1.0,1.2765957446808511,110,63
22400850,2,56,-2.0,-2.142857142857143,63,7
22400850,2,7,0.0,0.0,7,0
22400850,3,299,-6.0,-1.2040133779264215,720,421
22400850,3,33,-3.0,-5.454545454545455,404,371
22400850,3,80,-5.0,-3.75,357,277
22400850,3,91,-2.0,-1.3186813186813189,277,186
22400850,3,50,2.0,2.4,183,133
22400850,3,54,2.0,2.2222222222222223,133,79
22400850,3,60,-2.0,-2.0,60,0
22400850,4,308,2.0,0.38961038961038963,720,412
22400850,4,153,-4.0,-1.5686274509803921,404,251
22400850,4,18,-1.0,-3.333333333333333,234,216
22400850,4,6,0.0,0.0,216,210
22400851,1,225,-9.0,-2.4,720,495
22400851,1,124,3.0,1.4516129032258065,479,355
22400851,1,47,-6.0,-7.659574468085106,346,299
22400851,1,87,1.0,0.6896551724137931,283,196
22400851,1,37,-1.0,-1.6216216216216217,184,147
22400851,1,117,-3.0,-1.5384615384615383,140,23
22400851,1,23,-3.0,-7.826086956521739,23,0
22400851,2,148,1.0,0.40540540540540543,720,572
22400851,2,120,4.0,2.0,562,442
22400851,2,82,-3.0,-2.195121951219512,429,347
22400851,2,62,0.0,0.0,347,285
22400851,2,120,1.0,0.5,285,165
22400851,2,62,0.0,0.0,165,103
22400851,2,50,6.0,7.199999999999999,103,53
22400851,2,33,1.0,1.8181818181818183,33,0
22400851,3,244,-2.0,-0.49180327868852464,720,476
22400851,3,50,0.0,0.0,461,411
22400851,3,21,-2.0,-5.7142857142857135,404,383
22400851,3,143,-3.0,-1.2587412587412588,383,240
22400851,3,29,-2.0,-4.137931034482759,232,203
22400851,3,138,-10.0,-4.3478260869565215,190,52
22400851,3,52,0.0,0.0,52,0
22400851,4,187,4.0,1.2834224598930482,720,533
22400851,4,103,4.0,2.3300970873786406,525,422
22400851,4,35,1.0,1.7142857142857142,422,387
22400851,4,107,2.0,1.1214953271028036,387,280
22400851,4,71,-2.0,-1.6901408450704225,277,206
22400851,4,12,0.0,0.0,192,180
22400851,4,49,-1.0,-1.2244897959183672,170,121
22400851,4,39,1.0,1.5384615384615383,121,82
22400851,4,82,-3.0,-2.195121951219512,82,0
22400852,1,289,19.0,3.9446366782006916,720,431
22400852,1,22,0.0,0.0,412,390
22400852,1,76,-2.0,-1.5789473684210527,386,310
22400852,1,31,1.0,1.935483870967742,303,272
22400852,1,87,-1.0,-0.6896551724137931,272,185
22400852,1,46,-2.0,-2.608695652173913,105,59
22400852,1,15,0.0,0.0,59,44
22400852,1,36,-1.0,-1.6666666666666665,36,0
22400852,2,112,-3.0,-1.607142857142857,720,608
22400852,2,118,-3.0,-1.5254237288135595,591,473
22400852,2,9,0.0,0.0,463,454
22400852,2,160,0.0,0.0,452,292
22400852,2,65,3.0,2.769230769230769,260,195
22400852,2,72,1.0,0.8333333333333333,183,111
22400852,2,102,1.0,0.5882352941176471,102,0
22400852,3,117,2.0,1.0256410256410258,720,603
22400852,3,140,2.0,0.8571428571428571,582,442
22400852,3,1,0.0,0.0,429,428
22400852,3,97,-2.0,-1.2371134020618557,414,317
22400852,3,132,0.0,0.0,307,175
22400852,3,135,-6.0,-2.666666666666667,167,32
22400852,3,32,2.0,3.75,32,0
22400852,4,171,-2.0,-0.7017543859649122,720,549
22400852,4,27,-4.0,-8.88888888888889,549,522
22400852,4,98,-4.0,-2.4489795918367343,502,404
22400852,4,57,0.0,0.0,384,327
22400852,4,18,-1.0,-3.333333333333333,307,289
22400852,4,136,0.0,0.0,253,117
22400852,4,68,-1.0,-0.8823529411764706,117,49
22400852,4,27,-1.0,-2.2222222222222223,49,22
22400852,4,22,0.0,0.0,22,0
22400853,1,240,-4.0,-1.0,720,480
22400853,1,42,-2.0,-2.8571428571428568,471,429
22400853,1,122,-1.0,-0.49180327868852464,429,307
22400853,1,37,-1.0,-1.6216216216216217,297,260
22400853,1,177,3.0,1.0169491525423728,255,78
22400853,1,61,-4.0,-3.934426229508197,61,0
22400853,2,84,0.0,0.0,720,636
22400853,2,62,-2.0,-1.935483870967742,619,557
22400853,2,89,-2.0,-1.348314606741573,557,468
22400853,2,52,-3.0,-3.4615384615384617,459,407
22400853,2,103,2.0,1.1650485436893203,399,296
22400853,2,81,-3.0,-2.2222222222222223,296,215
22400853,2,36,-2.0,-3.333333333333333,215,179
22400853,2,158,-3.0,-1.139240506329114,158,0
22400853,3,97,-3.0,-1.8556701030927836,720,623
22400853,3,332,7.0,1.2650602409638554,623,291
22400853,3,26,1.0,2.307692307692308,277,251
22400853,3,183,-1.0,-0.32786885245901637,251,68
22400853,3,47,5.0,6.382978723404255,68,21
22400853,4,68,-4.0,-3.5294117647058822,720,652
22400853,4,3,-1.0,-20.0,639,636
22400853,4,32,-1.0,-1.875,620,588
22400853,4,147,-6.0,-2.4489795918367343,588,441
22400853,4,57,-3.0,-3.1578947368421053,421,364
22400853,4,17,3.0,10.588235294117649,364,347
22400853,4,241,-1.0,-0.24896265560165975,588,347
22400853,4,99,0.0,0.0,338,239
22400853,4,22,-2.0,-5.454545454545455,189,167
22400854,1,329,-5.0,-0.9118541033434651,720,391
22400854,1,50,-1.0,-1.2,373,323
22400854,1,142,-1.0,-0.4225352112676056,315,173
22400854,1,69,-1.0,-0.8695652173913043,160,91
22400854,1,61,2.0,1.9672131147540985,73,12
22400854,1,9,0.0,0.0,9,0
22400854,2,251,2.0,0.47808764940239046,720,469
22400854,2,97,-8.0,-4.948453608247423,456,359
22400854,2,119,0.0,0.0,352,233
22400854,2,69,0.0,0.0,215,146
22400854,2,130,8.0,3.6923076923076925,130,0
22400854,3,86,-8.0,-5.5813953488372094,720,634
22400854,3,308,3.0,0.5844155844155844,626,318
22400854,3,39,3.0,4.615384615384616,269,230
22400854,3,73,0.0,0.0,230,157
22400854,3,92,2.0,1.3043478260869565,155,63
22400854,4,139,5.0,2.158273381294964,720,581
22400854,4,97,-4.0,-2.4742268041237114,572,475
22400854,4,185,-5.0,-1.6216216216216217,475,290
22400854,4,48,0.0,0.0,278,230
22400854,4,33,2.0,3.6363636363636367,220,187
22400854,4,169,1.0,0.35502958579881655,175,6
22400854,4,3,0.0,0.0,3,0
22400855,1,275,0.0,0.0,720,445
22400855,1,63,0.0,0.0,433,370
22400855,1,231,-1.0,-0.2597402597402597,359,128
22400855,1,120,0.0,0.0,120,0
22400855,2,52,0.0,0.0,720,668
22400855,2,20,-2.0,-6.0,652,632
22400855,2,57,-5.0,-5.263157894736842,613,556
22400855,2,128,2.0,0.9375,556,428
22400855,2,111,0.0,0.0,354,243
22400855,2,129,-3.0,-1.3953488372093024,224,95
22400855,2,95,4.0,2.526315789473684,95,0
22400855,3,283,2.0,0.42402826855123676,720,437
22400855,3,35,-3.0,-5.142857142857143,437,402
22400855,3,14,-1.0,-4.285714285714286,367,353
22400855,3,23,0.0,0.0,353,330
22400855,3,26,-2.0,-4.615384615384616,330,304
22400855,3,80,0.0,0.0,297,217
22400855,3,31,0.0,0.0,217,186
22400855,3,167,-2.0,-0.718562874251497,171,4
22400855,3,4,2.0,30.0,4,0
22400855,4,9,-1.0,-6.666666666666666,720,711
22400855,4,74,-5.0,-4.054054054054054,711,637
22400855,4,148,3.0,1.2162162162162162,621,473
22400855,4,102,5.0,2.941176470588235,453,351
22400855,4,14,1.0,4.285714285714286,334,320
22400855,4,26,2.0,4.615384615384616,320,294
22400855,4,67,2.0,1.791044776119403,294,227
22400855,4,211,0.0,0.0,218,7
22400855,5,54,0.0,0.0,300,246
22400855,5,98,2.0,1.2244897959183672,238,140
22400855,5,128,5.0,2.34375,128,0
22400856,1,224,6.0,1.607142857142857,720,496
22400856,1,48,-1.0,-1.25,485,437
22400856,1,38,-2.0,-3.1578947368421053,437,399
22400856,1,84,-1.0,-0.7142857142857142,385,301
22400856,1,112,2.0,1.0714285714285714,301,189
22400856,1,68,-2.0,-1.7647058823529411,169,101
22400856,1,65,3.0,2.769230769230769,101,36
22400856,1,36,0.0,0.0,36,0
22400856,2,160,-4.0,-1.5,720,560
22400856,2,202,0.0,0.0,557,355
22400856,2,22,2.0,5.454545454545455,340,318
22400856,2,128,-2.0,-0.9375,307,179
22400856,2,24,0.0,0.0,179,155
22400856,2,82,-1.0,-0.7317073170731707,142,60
22400856,2,45,0.0,0.0,46,1
22400856,3,281,4.0,0.8540925266903914,720,439
22400856,3,66,2.0,1.8181818181818183,439,373
22400856,3,48,0.0,0.0,351,303
22400856,3,36,0.0,0.0,288,252
22400856,3,65,-1.0,-0.9230769230769231,245,180
22400856,3,139,-3.0,-1.2949640287769786,162,23
22400856,3,4,0.0,0.0,4,0
22400856,4,80,-4.0,-3.0,720,640
22400856,4,117,-3.0,-1.5384615384615383,628,511
22400856,4,67,5.0,4.477611940298507,503,436
22400856,4,19,0.0,0.0,436,417
22400856,4,102,2.0,1.1764705882352942,417,315
22400856,4,39,-2.0,-3.0769230769230766,300,261
22400856,4,54,0.0,0.0,247,193
22400856,4,153,0.0,0.0,186,33
22400856,4,1,0.0,0.0,24,23
22400856,4,1,0.0,0.0,5,4
22400857,1,318,12.0,2.2641509433962264,720,402
22400857,1,122,-6.0,-2.9508196721311473,402,280
22400857,1,63,0.0,0.0,276,213
22400857,1,35,2.0,3.4285714285714284,193,158
22400857,1,144,6.0,2.5,144,0
22400857,2,191,0.0,0.0,720,529
22400857,2,121,-5.0,-2.479338842975207,515,394
22400857,2,46,4.0,5.217391304347826,360,314
22400857,2,10,0.0,0.0,303,293
22400857,2,39,-2.0,-3.0769230769230766,277,238
22400857,2,161,0.0,0.0,238,77
22400857,2,73,4.0,3.287671232876712,77,4
22400857,3,405,1.0,0.14814814814814814,720,315
22400857,3,48,-2.0,-2.5,311,263
22400857,3,47,0.0,0.0,263,216
22400857,3,25,3.0,7.199999999999999,203,178
22400857,3,142,1.0,0.4225352112676056,165,23
22400857,3,3,0.0,0.0,23,20
22400857,3,3,0.0,0.0,3,0
22400857,4,99,3.0,1.8181818181818183,720,621
22400857,4,136,1.0,0.4411764705882353,606,470
22400857,4,18,0.0,0.0,470,452
22400857,4,154,-5.0,-1.9480519480519478,452,298
22400857,4,48,-1.0,-1.25,290,242
22400857,4,37,0.0,0.0,238,201
22400857,4,30,2.0,4.0,201,171
22400857,4,53,0.0,0.0,157,104
22400857,4,91,-4.0,-2.6373626373626378,91,0
22400858,1,230,2.0,0.5217391304347826,720,490
22400858,1,115,1.0,0.5217391304347826,479,364
22400858,1,141,-1.0,-0.425531914893617,356,215
22400858,1,10,0.0,0.0,107,97
22400858,1,97,-3.0,-1.8556701030927836,97,0
22400858,2,98,3.0,1.836734693877551,720,622
22400858,2,92,-4.0,-2.608695652173913,622,530
22400858,2,82,-4.0,-2.926829268292683,520,438
22400858,2,38,0.0,0.0,421,383
22400858,2,105,-2.0,-1.142857142857143,358,253
22400858,2,46,0.0,0.0,236,190
22400858,2,181,-2.0,-0.6629834254143646,181,0
22400858,3,230,9.0,2.347826086956522,720,490
22400858,3,84,7.0,5.0,477,393
22400858,3,55,7.0,7.636363636363636,384,329
22400858,3,62,0.0,0.0,310,248
22400858,3,87,-3.0,-2.0689655172413794,239,152
22400858,3,27,-4.0,-8.88888888888889,152,125
22400858,4,69,2.0,1.7391304347826086,720,651
22400858,4,43,-1.0,-1.3953488372093024,646,603
22400858,4,30,-2.0,-4.0,590,560
22400858,4,52,0.0,0.0,553,501
22400858,4,11,0.0,0.0,501,490
22400858,4,74,-2.0,-1.6216216216216217,478,404
22400858,4,22,0.0,0.0,404,382
22400858,4,58,4.0,4.137931034482759,382,324
22400858,4,42,2.0,2.8571428571428568,306,264
22400858,4,31,0.0,0.0,264,233
22400858,4,12,0.0,0.0,233,221
22400858,4,157,-8.0,-3.0573248407643314,201,44
22400858,4,28,2.0,4.285714285714286,28,0
22400859,1,483,-5.0,-0.6211180124223602,720,237
22400859,1,39,0.0,0.0,225,186
22400859,1,4,0.0,0.0,182,178
22400859,1,20,-1.0,-3.0,165,145
22400859,2,115,4.0,2.0869565217391304,720,605
22400859,2,80,1.0,0.75,591,511
22400859,2,172,1.0,0.3488372093023256,439,267
22400859,2,59,2.0,2.0338983050847457,258,199
22400859,2,35,1.0,1.7142857142857142,185,150
22400859,2,150,-2.0,-0.8,150,0
22400859,3,265,1.0,0.22641509433962265,720,455
22400859,3,43,-2.0,-2.7906976744186047,446,403
22400859,3,55,-2.0,-2.1818181818181817,400,345
22400859,3,52,-1.0,-1.153846153846154,345,293
22400859,3,125,-1.0,-0.48,293,168
22400859,3,27,2.0,4.444444444444445,168,141
22400859,3,33,-3.0,-5.454545454545455,141,108
22400859,3,83,3.0,2.1686746987951806,108,25
22400859,4,97,1.0,0.6185567010309279,720,623
22400859,4,26,0.0,0.0,619,593
22400859,4,100,-1.0,-0.6,593,493
22400859,4,36,0.0,0.0,489,453
22400859,4,29,2.0,4.137931034482759,453,424
22400859,4,2,0.0,0.0,410,408
22400859,4,93,-4.0,-2.580645161290323,394,301
22400859,4,113,2.0,1.0619469026548671,301,188
22400859,4,151,0.0,0.0,176,25
22400859,4,5,0.0,0.0,21,16
22400859,4,1,0.0,0.0,16,15
22400859,4,10,0.0,0.0,10,0
22400860,1,308,3.0,0.5844155844155844,720,412
22400860,1,15,-2.0,-8.0,400,385
22400860,1,99,-1.0,-0.6060606060606061,385,286
22400860,1,40,-5.0,-7.5,271,231
22400860,1,174,8.0,2.7586206896551726,220,46
22400860,1,38,-4.0,-6.315789473684211,40,2
22400860,2,310,-7.0,-1.3548387096774193,720,410
22400860,2,73,5.0,4.10958904109589,392,319
22400860,2,152,2.0,0.7894736842105263,301,149
22400860,2,88,2.0,1.3636363636363638,136,48
22400860,2,33,2.0,3.6363636363636367,33,0
22400860,3,456,-9.0,-1.1842105263157894,720,264
22400860,3,83,-3.0,-2.1686746987951806,249,166
22400860,3,26,0.0,0.0,149,123
22400860,3,113,1.0,0.5309734513274336,113,0
22400860,4,122,-5.0,-2.4590163934426226,720,598
22400860,4,134,4.0,1.791044776119403,591,457
22400860,4,94,-2.0,-1.2765957446808511,457,363
22400860,4,17,0.0,0.0,348,331
22400860,4,61,-2.0,-1.9672131147540985,330,269
22400860,4,144,-2.0,-0.8333333333333333,250,106
22400860,4,20,0.0,0.0,90,70
22400860,4,13,-1.0,-4.615384615384616,47,34
22400860,4,34,2.0,3.5294117647058822,34,0
22400861,1,330,15.0,2.7272727272727275,720,390
22400861,1,52,1.0,1.153846153846154,378,326
22400861,1,9,-1.0,-6.666666666666666,323,314
22400861,1,138,-1.0,-0.43478260869565216,314,176
22400861,1,74,0.0,0.0,159,85
22400861,1,81,2.0,1.4814814814814814,81,0
22400861,2,147,-4.0,-1.6326530612244898,720,573
22400861,2,3,-1.0,-20.0,565,562
22400861,2,74,4.0,3.2432432432432434,562,488
22400861,2,42,0.0,0.0,473,431
22400861,2,52,3.0,3.4615384615384617,431,379
22400861,2,26,2.0,4.615384615384616,379,353
22400861,2,68,-4.0,-3.5294117647058822,353,285
22400861,2,66,3.0,2.7272727272727275,285,219
22400861,2,25,2.0,4.8,219,194
22400861,2,17,0.0,0.0,194,177
22400861,2,152,-1.0,-0.39473684210526316,177,25
22400861,2,6,0.0,0.0,6,0
22400861,3,286,-7.0,-1.4685314685314685,720,434
22400861,3,53,0.0,0.0,430,377
22400861,3,128,2.0,0.9375,373,245
22400861,3,163,-7.0,-2.5766871165644174,245,82
22400861,3,82,-4.0,-2.926829268292683,82,0
22400861,4,222,3.0,0.8108108108108109,720,498
22400861,4,10,0.0,0.0,498,488
22400861,4,32,5.0,9.375,485,453
22400861,4,43,4.0,5.5813953488372094,399,356
22400861,4,68,-1.0,-0.8823529411764706,356,288
22400861,4,21,0.0,0.0,288,267
22400861,4,14,-1.0,-4.285714285714286,267,253
22400861,4,34,1.0,1.7647058823529411,253,219
22400861,4,53,0.0,0.0,219,166
22400861,4,155,1.0,0.3870967741935484,155,0
22400862,1,76,0.0,0.0,720,644
22400862,1,377,-11.0,-1.750663129973475,643,266
22400862,1,109,6.0,3.302752293577982,249,140
22400862,1,34,-2.0,-3.5294117647058822,140,106
22400862,1,106,4.0,2.2641509433962264,106,0
22400862,2,239,-5.0,-1.2552301255230125,720,481
22400862,2,96,4.0,2.5,475,379
22400862,2,68,3.0,2.647058823529412,379,311
22400862,2,27,-3.0,-6.666666666666666,308,281
22400862,2,81,4.0,2.962962962962963,269,188
22400862,2,122,-7.0,-3.4426229508196724,179,57
22400862,3,240,-2.0,-0.5,720,480
22400862,3,155,-4.0,-1.5483870967741935,469,314
22400862,3,138,3.0,1.3043478260869565,314,176
22400862,3,100,-3.0,-1.7999999999999998,176,76
22400862,3,68,-2.0,-1.7647058823529411,68,0
22400862,4,120,-4.0,-2.0,720,600
22400862,4,78,1.0,0.7692307692307692,600,522
22400862,4,110,0.0,0.0,522,412
22400862,4,8,3.0,22.5,404,396
22400862,4,62,-1.0,-0.967741935483871,374,312
22400862,4,95,-2.0,-1.263157894736842,298,203
22400862,4,59,-2.0,-2.0338983050847457,200,141
22400862,4,129,3.0,1.3953488372093024,129,0
22400863,1,165,7.0,2.5454545454545454,720,555
22400863,1,105,-4.0,-2.285714285714286,538,433
22400863,1,9,0.0,0.0,430,421
22400863,1,147,3.0,1.2244897959183672,404,257
22400863,1,30,2.0,4.0,243,213
22400863,1,31,-2.0,-3.870967741935484,209,178
22400863,1,164,-3.0,-1.097560975609756,170,6
22400863,1,6,0.0,0.0,6,0
22400863,2,144,-8.0,-3.333333333333333,720,576
22400863,2,48,-5.0,-6.25,566,518
22400863,2,83,-2.0,-1.4457831325301205,500,417
22400863,2,173,-1.0,-0.3468208092485549,411,238
22400863,2,37,-1.0,-1.6216216216216217,214,177
22400863,2,177,0.0,0.0,177,0
22400863,3,291,9.0,1.8556701030927836,720,429
22400863,3,58,0.0,0.0,414,356
22400863,3,71,4.0,3.380281690140845,352,281
22400863,3,34,-1.0,-1.7647058823529411,281,247
22400863,3,52,1.0,1.153846153846154,247,195
22400863,3,193,1.0,0.31088082901554404,195,2
22400863,4,257,-8.0,-1.867704280155642,720,463
22400863,4,101,2.0,1.188118811881188,463,362
22400863,4,52,1.0,1.153846153846154,362,310
22400863,4,17,-1.0,-3.5294117647058822,303,286
22400863,4,286,8.0,1.6783216783216783,286,0
22400864,1,305,0.0,0.0,720,415
22400864,1,66,2.0,1.8181818181818183,415,349
22400864,1,81,-4.0,-2.962962962962963,348,267
22400864,1,140,-5.0,-2.142857142857143,267,127
22400864,1,23,0.0,0.0,110,87
22400864,1,52,5.0,5.769230769230769,77,25
22400864,1,25,0.0,0.0,25,0
22400864,2,64,3.0,2.8125,720,656
22400864,2,163,3.0,1.1042944785276074,656,493
22400864,2,72,3.0,2.5,478,406
22400864,2,113,6.0,3.185840707964602,406,293
22400864,2,74,-4.0,-3.2432432432432434,293,219
22400864,2,88,1.0,0.6818181818181819,134,46
22400864,2,43,3.0,4.186046511627907,46,3
22400864,2,3,3.0,60.0,3,0
22400864,3,275,1.0,0.21818181818181817,720,445
22400864,3,103,-2.0,-1.1650485436893203,431,328
22400864,3,98,0.0,0.0,311,213
22400864,3,54,-2.0,-2.2222222222222223,206,152
22400864,3,131,0.0,0.0,152,21
22400864,4,118,5.0,2.542372881355932,720,602
22400864,4,75,0.0,0.0,592,517
22400864,4,47,-1.0,-1.2765957446808511,517,470
22400864,4,41,-2.0,-2.926829268292683,470,429
22400864,4,399,0.0,0.0,428,29
22400864,4,26,0.0,0.0,26,0
22400865,1,417,5.0,0.7194244604316546,720,303
22400865,1,94,3.0,1.9148936170212765,303,209
22400865,1,14,2.0,8.571428571428571,209,195
22400865,1,77,1.0,0.7792207792207793,195,118
22400865,1,118,-2.0,-1.0169491525423728,118,0
22400865,2,25,0.0,0.0,720,695
22400865,2,157,1.0,0.3821656050955414,683,526
22400865,2,100,6.0,3.5999999999999996,516,416
22400865,2,39,-3.0,-4.615384615384616,416,377
22400865,2,22,0.0,0.0,364,342
22400865,2,158,-4.0,-1.5189873417721518,342,184
22400865,2,110,-4.0,-2.1818181818181817,184,74
22400865,2,39,-3.0,-4.615384615384616,74,35
22400865,2,34,0.0,0.0,35,1
22400865,3,163,-8.0,-2.9447852760736195,720,557
22400865,3,81,0.0,0.0,538,457
22400865,3,21,0.0,0.0,448,427
22400865,3,63,0.0,0.0,427,364
22400865,3,88,1.0,0.6818181818181819,351,263
22400865,3,45,-4.0,-5.333333333333334,263,218
22400865,3,33,0.0,0.0,218,185
22400865,3,74,0.0,0.0,169,95
22400865,3,36,-1.0,-1.6666666666666665,86,50
22400865,3,50,-1.0,-1.2,50,0
22400865,4,227,4.0,1.0572687224669604,720,493
22400865,4,205,-2.0,-0.5853658536585366,493,288
22400865,4,288,3.0,0.625,288,0
22400866,1,336,-1.0,-0.17857142857142855,720,384
22400866,1,32,0.0,0.0,363,331
22400866,1,61,5.0,4.918032786885245,320,259
22400866,1,59,2.0,2.0338983050847457,239,180
22400866,1,23,0.0,0.0,180,157
22400866,1,105,1.0,0.5714285714285715,141,36
22400866,1,36,0.0,0.0,36,0
22400866,2,206,3.0,0.8737864077669903,720,514
22400866,2,38,1.0,1.5789473684210527,500,462
22400866,2,143,3.0,1.2587412587412588,462,319
22400866,2,67,-1.0,-0.8955223880597015,305,238
22400866,2,118,0.0,0.0,238,120
22400866,2,96,-3.0,-1.875,96,0
22400866,3,395,0.0,0.0,720,325
22400866,3,8,0.0,0.0,313,305
22400866,3,49,-1.0,-1.2244897959183672,294,245
22400866,3,43,2.0,2.7906976744186047,245,202
22400866,3,65,-3.0,-2.769230769230769,187,122
22400866,3,103,-6.0,-3.4951456310679614,103,0
22400866,4,259,4.0,0.9266409266409267,720,461
22400866,4,84,-1.0,-0.7142857142857142,448,364
22400866,4,324,3.0,0.5555555555555556,357,33
22400866,4,31,0.0,0.0,31,0
22400867,1,271,-1.0,-0.22140221402214022,720,449
22400867,1,10,0.0,0.0,422,412
22400867,1,168,1.0,0.3571428571428571,412,244
22400867,1,65,0.0,0.0,230,165
22400867,1,41,0.0,0.0,154,113
22400867,1,104,4.0,2.307692307692308,104,0
22400867,2,176,4.0,1.3636363636363638,720,544
22400867,2,58,2.0,2.0689655172413794,533,475
22400867,2,17,-1.0,-3.5294117647058822,475,458
22400867,2,36,0.0,0.0,458,422
22400867,2,78,2.0,1.5384615384615383,409,331
22400867,2,58,0.0,0.0,318,260
22400867,2,40,-8.0,-12.0,246,206
22400867,2,115,-5.0,-2.608695652173913,194,79
22400867,2,58,-2.0,-2.0689655172413794,58,0
22400867,3,46,1.0,1.3043478260869565,720,674
22400867,3,63,-5.0,-4.761904761904762,674,611
22400867,3,148,8.0,3.2432432432432434,595,447
22400867,3,67,-5.0,-4.477611940298507,431,364
22400867,3,41,-4.0,-5.853658536585366,364,323
22400867,3,129,0.0,0.0,323,194
22400867,3,20,3.0,9.0,189,169
22400867,3,154,4.0,1.5584415584415585,154,0
22400867,4,40,3.0,4.5,720,680
22400867,4,182,2.0,0.6593406593406594,680,498
22400867,4,1,0.0,0.0,492,491
22400867,4,104,2.0,1.153846153846154,479,375
22400867,4,157,0.0,0.0,375,218
22400867,4,17,2.0,7.0588235294117645,218,201
22400867,4,33,0.0,0.0,201,168
22400867,4,94,0.0,0.0,168,74
22400867,4,43,1.0,1.3953488372093024,58,15
22400867,4,1,-1.0,-60.0,13,12
22400867,4,7,-1.0,-8.571428571428571,8,1
22400867,4,1,0.0,0.0,1,0
22400867,5,161,0.0,0.0,300,139
22400867,5,109,0.0,0.0,139,30
22400867,5,24,2.0,5.0,28,4
22400868,1,264,1.0,0.2272727272727273,720,456
22400868,1,96,8.0,5.0,456,360
22400868,1,5,0.0,0.0,350,345
22400868,1,80,-2.0,-1.5,340,260
22400868,1,67,-2.0,-1.791044776119403,252,185
22400868,1,169,0.0,0.0,169,0
22400868,2,129,-9.0,-4.186046511627907,720,591
22400868,2,32,0.0,0.0,574,542
22400868,2,28,2.0,4.285714285714286,542,514
22400868,2,53,2.0,2.2641509433962264,504,451
22400868,2,110,3.0,1.6363636363636362,428,318
22400868,2,32,3.0,5.625,318,286
22400868,2,61,-1.0,-0.9836065573770493,282,221
22400868,2,33,-2.0,-3.6363636363636367,207,174
22400868,2,174,4.0,1.3793103448275863,174,0
22400868,3,266,-1.0,-0.22556390977443608,720,454
22400868,3,22,4.0,10.90909090909091,438,416
22400868,3,51,-1.0,-1.1764705882352942,400,349
22400868,3,117,4.0,2.0512820512820515,349,232
22400868,3,54,-1.0,-1.1111111111111112,213,159
22400868,3,153,-4.0,-1.5686274509803921,159,6
22400868,3,1,0.0,0.0,1,0
22400868,4,146,7.0,2.8767123287671232,720,574
22400868,4,57,-2.0,-2.1052631578947367,571,514
22400868,4,73,0.0,0.0,496,423
22400868,4,20,0.0,0.0,423,403
22400868,4,102,1.0,0.5882352941176471,386,284
22400868,4,188,5.0,1.5957446808510638,272,84
22400868,4,22,2.0,5.454545454545455,84,62
22400868,4,48,0.0,0.0,48,0
22400869,1,508,6.0,0.7086614173228346,720,212
22400869,1,148,0.0,0.0,202,54
22400869,2,362,-2.0,-0.3314917127071823,720,358
22400869,2,25,0.0,0.0,344,319
22400869,2,33,2.0,3.6363636363636367,300,267
22400869,2,151,7.0,2.781456953642384,267,116
22400869,2,36,1.0,1.6666666666666665,103,67
22400869,2,67,0.0,0.0,67,0
22400869,3,414,-3.0,-0.43478260869565216,720,306
22400869,3,57,-1.0,-1.0526315789473684,299,242
22400869,3,20,0.0,0.0,234,214
22400869,3,23,-2.0,-5.217391304347826,193,170
22400869,3,55,-3.0,-3.2727272727272725,157,102
22400869,3,102,-2.0,-1.1764705882352942,102,0
22400869,4,100,1.0,0.6,720,620
22400869,4,100,4.0,2.4,611,511
22400869,4,101,-1.0,-0.594059405940594,463,362
22400869,4,61,-5.0,-4.918032786885245,362,301
22400869,4,253,-3.0,-0.7114624505928854,279,26
22400869,5,176,-3.0,-1.0227272727272727,300,124
22400869,5,10,-1.0,-6.0,124,114
22400869,5,39,-2.0,-3.0769230769230766,114,75
22400869,5,22,0.0,0.0,64,42
22400869,5,12,0.0,0.0,42,30
22400869,5,3,3.0,60.0,30,27
22400870,1,327,3.0,0.5504587155963303,720,393
22400870,1,7,0.0,0.0,375,368
22400870,1,118,-2.0,-1.0169491525423728,365,247
22400870,1,35,-3.0,-5.142857142857143,247,212
22400870,1,46,-1.0,-1.3043478260869565,212,166
22400870,1,119,-3.0,-1.5126050420168067,166,47
22400870,1,39,2.0,3.0769230769230766,47,8
22400870,1,2,0.0,0.0,2,0
22400870,2,172,-2.0,-0.6976744186046512,720,548
22400870,2,85,3.0,2.1176470588235294,548,463
22400870,2,20,1.0,3.0,463,443
22400870,2,75,-3.0,-2.4,433,358
22400870,2,88,2.0,1.3636363636363638,358,270
22400870,2,172,1.0,0.3488372093023256,270,98
22400870,2,56,0.0,0.0,98,42
22400870,2,42,2.0,2.8571428571428568,42,0
22400870,3,169,-1.0,-0.35502958579881655,720,551
22400870,3,102,-2.0,-1.1764705882352942,545,443
22400870,3,6,1.0,10.0,433,427
22400870,3,9,0.0,0.0,427,418
22400870,3,216,2.0,0.5555555555555556,410,194
22400870,3,20,1.0,3.0,194,174
22400870,3,25,0.0,0.0,174,149
22400870,3,149,-8.0,-3.221476510067114,149,0
22400870,4,50,0.0,0.0,720,670
22400870,4,45,-5.0,-6.666666666666666,658,613
22400870,4,72,1.0,0.8333333333333333,591,519
22400870,4,16,-2.0,-7.5,505,489
22400870,4,24,0.0,0.0,474,450
22400870,4,60,0.0,0.0,447,387
22400870,4,62,0.0,0.0,387,325
22400870,4,41,0.0,0.0,325,284
22400870,4,222,10.0,2.7027027027027026,271,49
22400870,4,45,2.0,2.666666666666667,49,4
22400870,4,2,0.0,0.0,2,0
22400871,1,302,-5.0,-0.9933774834437087,720,418
22400871,1,142,2.0,0.8450704225352113,418,276
22400871,1,56,1.0,1.0714285714285714,254,198
22400871,1,40,-2.0,-3.0,186,146
22400871,1,146,4.0,1.643835616438356,146,0
22400871,2,224,5.0,1.3392857142857144,720,496
22400871,2,40,0.0,0.0,489,449
22400871,2,87,1.0,0.6896551724137931,435,348
22400871,2,55,-2.0,-2.1818181818181817,332,277
22400871,2,95,2.0,1.263157894736842,271,176
22400871,2,39,3.0,4.615384615384616,176,137
22400871,2,137,-1.0,-0.437956204379562,137,0
22400871,3,297,-9.0,-1.8181818181818183,720,423
22400871,3,70,5.0,4.285714285714286,409,339
22400871,3,69,-5.0,-4.3478260869565215,328,259
22400871,3,68,0.0,0.0,248,180
22400871,3,153,-4.0,-1.5686274509803921,154,1
22400871,3,1,0.0,0.0,1,0
22400871,4,170,0.0,0.0,720,550
22400871,4,22,-1.0,-2.7272727272727275,534,512
22400871,4,32,0.0,0.0,512,480
22400871,4,60,-3.0,-3.0,423,363
22400871,4,89,-6.0,-4.044943820224719,349,260
22400871,4,39,2.0,3.0769230769230766,260,221
22400871,4,66,-3.0,-2.7272727272727275,206,140
22400871,4,9,-2.0,-13.333333333333332,126,117
22400871,4,105,5.0,2.8571428571428568,105,0
22400872,1,330,-2.0,-0.36363636363636365,720,390
22400872,1,72,-4.0,-3.333333333333333,376,304
22400872,1,100,-1.0,-0.6,291,191
22400872,1,80,0.0,0.0,191,111
22400872,1,99,4.0,2.4242424242424243,99,0
22400872,2,105,0.0,0.0,720,615
22400872,2,154,-4.0,-1.5584415584415585,615,461
22400872,2,69,-3.0,-2.608695652173913,451,382
22400872,2,84,5.0,3.571428571428571,375,291
22400872,2,134,4.0,1.791044776119403,278,144
22400872,2,131,-5.0,-2.290076335877863,131,0
22400872,3,359,1.0,0.1671309192200557,720,361
22400872,3,36,-2.0,-3.333333333333333,361,325
22400872,3,33,-2.0,-3.6363636363636367,307,274
22400872,3,89,3.0,2.0224719101123596,261,172
22400872,3,148,7.0,2.837837837837838,152,4
22400872,4,182,-2.0,-0.6593406593406594,720,538
22400872,4,37,2.0,3.2432432432432434,533,496
22400872,4,104,1.0,0.576923076923077,496,392
22400872,4,95,-9.0,-5.684210526315789,392,297
22400872,4,58,-4.0,-4.137931034482759,288,230
22400872,4,210,6.0,1.7142857142857142,225,15
22400872,4,9,-2.0,-13.333333333333332,9,0
22400873,1,242,8.0,1.9834710743801653,720,478
22400873,1,68,2.0,1.7647058823529411,462,394
22400873,1,126,2.0,0.9523809523809523,394,268
22400873,1,58,-8.0,-8.275862068965518,259,201
22400873,1,74,4.0,3.2432432432432434,176,102
22400873,2,125,2.0,0.96,720,595
22400873,2,56,-1.0,-1.0714285714285714,587,531
22400873,2,119,0.0,0.0,530,411
22400873,2,114,-1.0,-0.5263157894736842,411,297
22400873,2,28,-1.0,-2.142857142857143,289,261
22400873,2,60,0.0,0.0,261,201
22400873,2,66,0.0,0.0,201,135
22400873,2,76,-1.0,-0.7894736842105263,130,54
22400873,2,31,1.0,1.935483870967742,54,23
22400873,2,23,-3.0,-7.826086956521739,23,0
22400873,3,301,-4.0,-0.7973421926910299,720,419
22400873,3,104,-3.0,-1.7307692307692308,408,304
22400873,3,94,-3.0,-1.9148936170212765,260,166
22400873,3,86,2.0,1.3953488372093024,147,61
22400873,3,61,-1.0,-0.9836065573770493,61,0
22400873,4,125,1.0,0.48,720,595
22400873,4,14,-1.0,-4.285714285714286,592,578
22400873,4,77,-7.0,-5.454545454545455,578,501
22400873,4,66,4.0,3.6363636363636367,486,420
22400873,4,136,1.0,0.4411764705882353,408,272
22400873,4,152,-3.0,-1.1842105263157894,272,120
22400873,4,14,0.0,0.0,109,95
22400874,1,329,1.0,0.182370820668693,720,391
22400874,1,11,0.0,0.0,360,349
22400874,1,141,2.0,0.851063829787234,334,193
22400874,1,76,-4.0,-3.1578947368421053,179,103
22400874,1,2,0.0,0.0,103,101
22400874,1,80,2.0,1.5,80,0
22400874,2,186,-5.0,-1.6129032258064517,720,534
22400874,2,150,0.0,0.0,534,384
22400874,2,62,0.0,0.0,372,310
22400874,2,59,3.0,3.050847457627119,295,236
22400874,2,126,4.0,1.9047619047619047,204,78
22400874,2,63,1.0,0.9523809523809523,68,5
22400874,2,5,0.0,0.0,5,0
22400874,3,390,1.0,0.15384615384615385,720,330
22400874,3,11,0.0,0.0,320,309
22400874,3,28,3.0,6.428571428571428,309,281
22400874,3,127,3.0,1.4173228346456692,259,132
22400874,3,24,-2.0,-5.0,121,97
22400874,3,88,-3.0,-2.0454545454545454,88,0
22400874,4,57,-2.0,-2.1052631578947367,720,663
22400874,4,20,0.0,0.0,652,632
22400874,4,56,-1.0,-1.0714285714285714,622,566
22400874,4,94,-5.0,-3.1914893617021276,566,472
22400874,4,76,5.0,3.9473684210526314,453,377
22400874,4,125,-2.0,-0.96,377,252
22400874,4,32,-1.0,-1.875,252,220
22400874,4,202,-4.0,-1.188118811881188,210,8
22400875,1,284,-4.0,-0.8450704225352113,720,436
22400875,1,43,1.0,1.3953488372093024,432,389
22400875,1,88,-2.0,-1.3636363636363638,347,259
22400875,1,51,-2.0,-2.3529411764705883,250,199
22400875,1,68,2.0,1.7647058823529411,189,121
22400875,1,121,4.0,1.9834710743801653,121,0
22400875,2,166,2.0,0.7228915662650602,720,554
22400875,2,28,0.0,0.0,546,518
22400875,2,44,2.0,2.7272727272727275,513,469
22400875,2,40,-3.0,-4.5,410,370
22400875,2,125,-4.0,-1.92,370,245
22400875,2,51,4.0,4.705882352941177,235,184
22400875,2,122,2.0,0.9836065573770493,170,48
22400875,2,17,0.0,0.0,36,19
22400875,2,17,0.0,0.0,19,2
22400875,3,233,-3.0,-0.7725321888412017,720,487
22400875,3,81,4.0,2.962962962962963,480,399
22400875,3,68,0.0,0.0,387,319
22400875,3,74,-1.0,-0.8108108108108109,319,245
22400875,3,95,4.0,2.526315789473684,245,150
22400875,4,192,-6.0,-1.875,720,528
22400875,4,148,-2.0,-0.8108108108108109,516,368
22400875,4,256,-1.0,-0.234375,368,112
22400875,4,107,0.0,0.0,112,5
22400875,4,5,0.0,0.0,5,0
22400876,1,237,3.0,0.7594936708860759,720,483
22400876,1,250,1.0,0.24,483,233
22400876,1,57,0.0,0.0,233,176
22400876,1,173,-4.0,-1.3872832369942196,174,1
22400876,1,1,0.0,0.0,1,0
22400876,2,203,6.0,1.773399014778325,720,517
22400876,2,107,3.0,1.6822429906542056,500,393
22400876,2,31,0.0,0.0,385,354
22400876,2,41,-3.0,-4.390243902439024,348,307
22400876,2,106,-1.0,-0.5660377358490566,307,201
22400876,2,118,0.0,0.0,183,65
22400876,2,65,0.0,0.0,65,0
22400876,3,318,-11.0,-2.0754716981132075,720,402
22400876,3,165,3.0,1.0909090909090908,402,237
22400876,3,71,2.0,1.6901408450704225,237,166
22400876,3,128,-8.0,-3.75,158,30
22400876,3,13,0.0,0.0,30,17
22400876,4,160,-3.0,-1.125,720,560
22400876,4,135,1.0,0.4444444444444445,560,425
22400876,4,130,-6.0,-2.769230769230769,194,64
22400876,4,55,-1.0,-1.0909090909090908,55,0
22400877,1,416,4.0,0.576923076923077,720,304
22400877,1,42,5.0,7.142857142857142,295,253
22400877,1,35,0.0,0.0,253,218
22400877,1,180,4.0,1.3333333333333335,211,31
22400877,1,31,-2.0,-3.870967741935484,31,0
22400877,2,271,3.0,0.6642066420664207,720,449
22400877,2,85,3.0,2.1176470588235294,432,347
22400877,2,68,0.0,0.0,335,267
22400877,2,79,2.0,1.5189873417721518,256,177
22400877,2,63,3.0,2.8571428571428568,164,101
22400877,2,25,-2.0,-4.8,91,66
22400877,2,47,2.0,2.5531914893617023,66,19
22400877,2,19,2.0,6.315789473684211,19,0
22400877,3,321,-5.0,-0.9345794392523364,720,399
22400877,3,139,-1.0,-0.43165467625899284,399,260
22400877,3,139,-2.0,-0.8633093525179857,243,104
22400877,3,93,3.0,1.935483870967742,93,0
22400877,4,76,0.0,0.0,720,644
22400877,4,63,0.0,0.0,644,581
22400877,4,126,8.0,3.8095238095238093,581,455
22400877,4,112,0.0,0.0,455,343
22400877,4,33,1.0,1.8181818181818183,330,297
22400877,4,40,0.0,0.0,297,257
22400877,4,9,0.0,0.0,243,234
22400877,4,83,-3.0,-2.1686746987951806,226,143
22400877,4,143,-4.0,-1.6783216783216783,143,0
22400878,1,99,0.0,0.0,720,621
22400878,1,245,6.0,1.4693877551020407,621,376
22400878,1,19,-2.0,-6.315789473684211,376,357
22400878,1,105,2.0,1.142857142857143,357,252
22400878,1,82,-2.0,-1.4634146341463414,250,168
22400878,1,49,3.0,3.673469387755102,166,117
22400878,1,25,0.0,0.0,117,92
22400878,1,74,3.0,2.4324324324324325,83,9
22400878,1,5,1.0,12.0,9,4
22400878,1,227,1.0,0.2643171806167401,227,0
22400878,2,170,0.0,0.0,720,550
22400878,2,20,0.0,0.0,550,530
22400878,2,67,-1.0,-0.8955223880597015,523,456
22400878,2,1,0.0,0.0,437,436
22400878,2,127,3.0,1.4173228346456692,422,295
22400878,2,65,0.0,0.0,295,230
22400878,2,52,-5.0,-5.769230769230769,230,178
22400878,2,164,-6.0,-2.195121951219512,164,0
22400878,3,309,8.0,1.5533980582524272,720,411
22400878,3,24,0.0,0.0,372,348
22400878,3,25,-2.0,-4.8,334,309
22400878,3,60,1.0,1.0,309,249
22400878,3,13,-2.0,-9.230769230769232,244,231
22400878,3,53,3.0,3.3962264150943398,231,178
22400878,3,57,-1.0,-1.0526315789473684,167,110
22400878,3,76,1.0,0.7894736842105263,110,34
22400878,4,108,3.0,1.6666666666666665,720,612
22400878,4,63,3.0,2.8571428571428568,612,549
22400878,4,101,-2.0,-1.188118811881188,537,436
22400878,4,14,2.0,8.571428571428571,414,400
22400878,4,98,-3.0,-1.836734693877551,384,286
22400878,4,8,-3.0,-22.5,274,266
22400878,4,72,-4.0,-3.333333333333333,245,173
22400878,4,157,-7.0,-2.6751592356687897,157,0
22400879,1,333,2.0,0.36036036036036034,720,387
22400879,1,68,-3.0,-2.647058823529412,374,306
22400879,1,94,0.0,0.0,254,160
22400879,1,46,0.0,0.0,146,100
22400879,1,91,7.0,4.615384615384616,91,0
22400879,2,168,-8.0,-2.8571428571428568,720,552
22400879,2,82,3.0,2.195121951219512,539,457
22400879,2,30,4.0,8.0,451,421
22400879,2,123,0.0,0.0,404,281
22400879,2,271,0.0,0.0,271,0
22400879,3,355,14.0,2.366197183098592,720,365
22400879,3,78,0.0,0.0,358,280
22400879,3,30,-3.0,-6.0,259,229
22400879,3,171,0.0,0.0,219,48
22400879,3,48,3.0,3.75,48,0
22400879,4,86,3.0,2.0930232558139537,720,634
22400879,4,23,0.0,0.0,626,603
22400879,4,49,-5.0,-6.122448979591837,595,546
22400879,4,113,6.0,3.185840707964602,530,417
22400879,4,91,-5.0,-3.2967032967032965,406,315
22400879,4,234,-1.0,-0.25641025641025644,315,81
22400880,1,202,-5.0,-1.4851485148514851,720,518
22400880,1,98,1.0,0.6122448979591836,509,411
22400880,1,62,-2.0,-1.935483870967742,404,342
22400880,1,171,1.0,0.3508771929824561,326,155
22400880,1,133,3.0,1.3533834586466165,139,6
22400880,1,1,0.0,0.0,1,0
22400880,2,107,-7.0,-3.9252336448598126,720,613
22400880,2,142,2.0,0.8450704225352113,605,463
22400880,2,13,1.0,4.615384615384616,446,433
22400880,2,61,0.0,0.0,433,372
22400880,2,105,2.0,1.142857142857143,357,252
22400880,2,54,0.0,0.0,235,181
22400880,2,78,2.0,1.5384615384615383,170,92
22400880,2,11,0.0,0.0,92,81
22400880,2,71,-1.0,-0.8450704225352113,71,0
22400880,3,208,-4.0,-1.153846153846154,720,512
22400880,3,77,-6.0,-4.675324675324675,502,425
22400880,3,41,-2.0,-2.926829268292683,413,372
22400880,3,39,-1.0,-1.5384615384615383,370,331
22400880,3,55,0.0,0.0,307,252
22400880,3,105,1.0,0.5714285714285715,239,134
22400880,3,134,-2.0,-0.8955223880597015,134,0
22400880,4,205,-3.0,-0.8780487804878049,720,515
22400880,4,128,4.0,1.875,515,387
22400880,4,63,-2.0,-1.9047619047619047,377,314
22400880,4,49,1.0,1.2244897959183672,296,247
22400880,4,159,-2.0,-0.7547169811320755,159,0
22400881,1,245,-2.0,-0.489795918367347,720,475
22400881,1,117,0.0,0.0,475,358
22400881,1,72,-7.0,-5.833333333333333,358,286
22400881,1,160,-5.0,-1.875,286,126
22400881,1,23,0.0,0.0,126,103
22400881,1,88,-2.0,-1.3636363636363638,91,3
22400881,1,3,0.0,0.0,3,0
22400881,2,147,-1.0,-0.40816326530612246,720,573
22400881,2,90,3.0,2.0,573,483
22400881,2,100,-4.0,-2.4,467,367
22400881,2,164,3.0,1.097560975609756,362,198
22400881,2,71,-2.0,-1.6901408450704225,179,108
22400881,2,96,0.0,0.0,96,0
22400881,3,233,-7.0,-1.8025751072961373,720,487
22400881,3,98,-1.0,-0.6122448979591836,487,389
22400881,3,19,0.0,0.0,365,346
22400881,3,29,1.0,2.0689655172413794,340,311
22400881,3,13,0.0,0.0,311,298
22400881,3,43,1.0,1.3953488372093024,294,251
22400881,3,167,-1.0,-0.3592814371257485,251,84
22400881,3,84,2.0,1.4285714285714284,84,0
22400881,4,119,2.0,1.0084033613445378,720,601
22400881,4,36,3.0,5.0,601,565
22400881,4,85,-3.0,-2.1176470588235294,548,463
22400881,4,17,-1.0,-3.5294117647058822,463,446
22400881,4,92,-4.0,-2.608695652173913,446,354
22400881,4,47,2.0,2.5531914893617023,354,307
22400881,4,79,-5.0,-3.79746835443038,296,217
22400881,4,203,1.0,0.2955665024630542,203,0
22400882,1,176,1.0,0.34090909090909094,720,544
22400882,1,209,1.0,0.28708133971291866,537,328
22400882,1,127,1.0,0.47244094488188976,327,200
22400882,1,26,0.0,0.0,189,163
22400882,1,15,0.0,0.0,147,132
22400882,1,97,5.0,3.092783505154639,123,26
22400882,1,5,0.0,0.0,5,0
22400882,2,166,-3.0,-1.0843373493975903,720,554
22400882,2,67,0.0,0.0,543,476
22400882,2,59,3.0,3.050847457627119,476,417
22400882,2,22,3.0,8.181818181818182,417,395
22400882,2,51,1.0,1.1764705882352942,379,328
22400882,2,109,-1.0,-0.5504587155963303,304,195
22400882,2,72,-2.0,-1.6666666666666665,195,123
22400882,2,91,5.0,3.2967032967032965,106,15
22400882,2,8,0.0,0.0,15,7
22400882,2,3,0.0,0.0,3,0
22400882,3,417,2.0,0.28776978417266186,720,303
22400882,3,120,4.0,2.0,300,180
22400882,3,46,-2.0,-2.608695652173913,175,129
22400882,3,63,-4.0,-3.8095238095238093,114,51
22400882,3,51,-2.0,-2.3529411764705883,51,0
22400882,4,90,-1.0,-0.6666666666666667,720,630
22400882,4,22,-6.0,-16.363636363636363,630,608
22400882,4,34,0.0,0.0,541,507
22400882,4,122,5.0,2.4590163934426226,507,385
22400882,4,120,5.0,2.5,372,252
22400882,4,153,2.0,0.7843137254901961,243,90
22400882,4,29,-1.0,-2.0689655172413794,83,54
22400882,4,54,2.0,2.2222222222222223,54,0
22400883,1,296,-3.0,-0.6081081081081081,720,424
22400883,1,63,0.0,0.0,424,361
22400883,1,61,2.0,1.9672131147540985,355,294
22400883,1,61,1.0,0.9836065573770493,279,218
22400883,1,120,-2.0,-1.0,159,39
22400883,1,32,-3.0,-5.625,39,7
22400883,1,7,0.0,0.0,7,0
22400883,2,130,0.0,0.0,720,590
22400883,2,29,2.0,4.137931034482759,582,553
22400883,2,5,0.0,0.0,544,539
22400883,2,36,0.0,0.0,526,490
22400883,2,165,3.0,1.0909090909090908,473,308
22400883,2,73,-4.0,-3.287671232876712,308,235
22400883,2,73,0.0,0.0,219,146
22400883,2,86,0.0,0.0,132,46
22400883,2,25,4.0,9.6,25,0
22400883,3,166,-7.0,-2.5301204819277108,720,554
22400883,3,88,1.0,0.6818181818181819,554,466
22400883,3,58,0.0,0.0,452,394
22400883,3,67,-2.0,-1.791044776119403,394,327
22400883,3,35,-3.0,-5.142857142857143,327,292
22400883,3,58,-3.0,-3.103448275862069,223,165
22400883,3,57,3.0,3.1578947368421053,138,81
22400883,3,56,-1.0,-1.0714285714285714,76,20
22400883,3,20,0.0,0.0,20,0
22400883,4,100,3.0,1.7999999999999998,720,620
22400883,4,23,-2.0,-5.217391304347826,606,583
22400883,4,50,-2.0,-2.4,568,518
22400883,4,31,1.0,1.935483870967742,518,487
22400883,4,18,2.0,6.666666666666666,487,469
22400883,4,69,2.0,1.7391304347826086,469,400
22400883,4,171,5.0,1.7543859649122806,382,211
22400883,4,91,1.0,0.6593406593406594,188,97
22400883,4,32,0.0,0.0,76,44
22400883,4,42,2.0,2.8571428571428568,42,0
22400884,1,343,1.0,0.1749271137026239,720,377
22400884,1,13,-2.0,-9.230769230769232,364,351
22400884,1,139,-2.0,-0.8633093525179857,145,6
22400884,2,285,8.0,1.6842105263157896,720,435
22400884,2,26,-2.0,-4.615384615384616,422,396
22400884,2,118,3.0,1.5254237288135595,392,274
22400884,2,115,-4.0,-2.0869565217391304,274,159
22400884,2,109,1.0,0.5504587155963303,159,50
22400884,3,308,-2.0,-0.38961038961038963,720,412
22400884,3,107,1.0,0.5607476635514018,396,289
22400884,3,43,-2.0,-2.7906976744186047,279,236
22400884,3,102,3.0,1.7647058823529411,236,134
22400884,3,127,4.0,1.889763779527559,127,0
22400884,4,178,-1.0,-0.33707865168539325,720,542
22400884,4,14,0.0,0.0,503,489
22400884,4,43,0.0,0.0,489,446
22400884,4,13,0.0,0.0,446,433
22400884,4,85,3.0,2.1176470588235294,416,331
22400884,4,292,-3.0,-0.6164383561643836,318,26
22400884,4,8,-1.0,-7.5,23,15
22400884,4,1,0.0,0.0,15,14
22400885,1,293,0.0,0.0,720,427
22400885,1,38,2.0,3.1578947368421053,427,389
22400885,1,25,0.0,0.0,382,357
22400885,1,62,0.0,0.0,345,283
22400885,1,89,-2.0,-1.348314606741573,260,171
22400885,1,64,-2.0,-1.875,155,91
22400885,2,235,6.0,1.5319148936170213,720,485
22400885,2,47,-3.0,-3.829787234042553,481,434
22400885,2,12,0.0,0.0,416,404
22400885,2,21,0.0,0.0,399,378
22400885,2,9,1.0,6.666666666666666,358,349
22400885,2,69,-2.0,-1.7391304347826086,349,280
22400885,2,113,1.0,0.5309734513274336,280,167
22400885,2,130,4.0,1.8461538461538463,159,29
22400885,2,6,0.0,0.0,6,0
22400885,3,402,-7.0,-1.0447761194029852,720,318
22400885,3,37,-2.0,-3.2432432432432434,306,269
22400885,3,96,1.0,0.625,257,161
22400885,3,61,2.0,1.9672131147540985,146,85
22400885,3,25,-3.0,-7.199999999999999,60,35
22400885,4,327,0.0,0.0,720,393
22400885,4,164,-8.0,-2.926829268292683,393,229
22400885,4,53,-3.0,-3.3962264150943398,212,159
22400885,4,30,1.0,2.0,149,119
22400885,4,119,-4.0,-2.0168067226890756,119,0
22400886,1,304,0.0,0.0,720,416
22400886,1,75,3.0,2.4,399,324
22400886,1,45,2.0,2.666666666666667,324,279
22400886,1,54,4.0,4.444444444444445,272,218
22400886,1,206,-3.0,-0.8737864077669903,206,0
22400886,2,112,8.0,4.285714285714286,720,608
22400886,2,76,0.0,0.0,597,521
22400886,2,125,0.0,0.0,521,396
22400886,2,63,-2.0,-1.9047619047619047,379,316
22400886,2,37,0.0,0.0,300,263
22400886,2,195,-2.0,-0.6153846153846154,263,68
22400886,2,68,-4.0,-3.5294117647058822,68,0
22400886,3,271,-5.0,-1.1070110701107012,720,449
22400886,3,48,0.0,0.0,420,372
22400886,3,32,0.0,0.0,362,330
22400886,3,8,2.0,15.0,324,316
22400886,3,54,-3.0,-3.333333333333333,301,247
22400886,3,39,2.0,3.0769230769230766,247,208
22400886,3,208,-1.0,-0.2884615384615385,208,0
22400886,4,120,-2.0,-1.0,720,600
22400886,4,24,0.0,0.0,589,565
22400886,4,107,0.0,0.0,564,457
22400886,4,25,0.0,0.0,447,422
22400886,4,176,-11.0,-3.75,406,230
22400886,4,80,-6.0,-4.5,223,143
22400886,4,132,0.0,0.0,132,0
22400887,1,340,0.0,0.0,720,380
22400887,1,32,0.0,0.0,380,348
22400887,1,16,0.0,0.0,344,328
22400887,1,59,-2.0,-2.0338983050847457,328,269
22400887,1,29,1.0,2.0689655172413794,269,240
22400887,1,37,-1.0,-1.6216216216216217,240,203
22400887,1,41,2.0,2.926829268292683,203,162
22400887,1,147,3.0,1.2244897959183672,147,0
22400887,2,177,6.0,2.0338983050847457,720,543
22400887,2,10,2.0,12.0,533,523
22400887,2,95,2.0,1.263157894736842,523,428
22400887,2,16,0.0,0.0,418,402
22400887,2,43,-5.0,-6.976744186046512,393,350
22400887,2,153,-5.0,-1.9607843137254903,335,182
22400887,2,127,0.0,0.0,172,45
22400887,2,45,2.0,2.666666666666667,45,0
22400887,3,447,-2.0,-0.2684563758389262,720,273
22400887,3,92,0.0,0.0,273,181
22400887,3,79,1.0,0.7594936708860759,167,88
22400887,3,46,-1.0,-1.3043478260869565,72,26
22400887,3,26,1.0,2.307692307692308,26,0
22400887,4,175,8.0,2.742857142857143,720,545
22400887,4,117,3.0,1.5384615384615383,533,416
22400887,4,16,-2.0,-7.5,402,386
22400887,4,129,5.0,2.3255813953488373,386,257
22400887,4,10,-2.0,-12.0,257,247
22400887,4,45,3.0,4.0,239,194
22400887,4,185,-7.0,-2.27027027027027,185,0
22400888,1,233,5.0,1.2875536480686696,720,487
22400888,1,73,-2.0,-1.643835616438356,487,414
22400888,1,127,-1.0,-0.47244094488188976,396,269
22400888,1,34,3.0,5.294117647058824,269,235
22400888,1,70,-3.0,-2.5714285714285716,235,165
22400888,1,17,0.0,0.0,157,140
22400888,2,137,-10.0,-4.37956204379562,720,583
22400888,2,19,0.0,0.0,561,542
22400888,2,83,-6.0,-4.337349397590361,530,447
22400888,2,53,5.0,5.660377358490567,401,348
22400888,2,86,2.0,1.3953488372093024,337,251
22400888,2,63,0.0,0.0,251,188
22400888,2,182,2.0,0.6593406593406594,188,6
22400888,3,263,7.0,1.5969581749049429,720,457
22400888,3,84,1.0,0.7142857142857142,444,360
22400888,3,41,3.0,4.390243902439024,360,319
22400888,3,26,2.0,4.615384615384616,311,285
22400888,3,100,2.0,1.2,285,185
22400888,3,61,2.0,1.9672131147540985,170,109
22400888,3,106,-6.0,-3.3962264150943398,106,0
22400888,4,121,1.0,0.49586776859504134,720,599
22400888,4,94,-3.0,-1.9148936170212765,579,485
22400888,4,119,-1.0,-0.5042016806722689,470,351
22400888,4,1,0.0,0.0,351,350
22400888,4,92,2.0,1.3043478260869565,336,244
22400888,4,12,0.0,0.0,106,94
22400889,1,279,-6.0,-1.2903225806451615,720,441
22400889,1,95,-2.0,-1.263157894736842,417,322
22400889,1,54,-1.0,-1.1111111111111112,302,248
22400889,1,44,0.0,0.0,234,190
22400889,1,172,10.0,3.488372093023256,172,0
22400889,2,131,-5.0,-2.290076335877863,720,589
22400889,2,24,-2.0,-5.0,547,523
22400889,2,201,-6.0,-1.791044776119403,509,308
22400889,2,7,0.0,0.0,308,301
22400889,2,36,-2.0,-3.333333333333333,293,257
22400889,2,66,0.0,0.0,247,181
22400889,2,51,-4.0,-4.705882352941177,181,130
22400889,2,110,-4.0,-2.1818181818181817,110,0
22400889,3,395,-3.0,-0.45569620253164556,720,325
22400889,3,94,-2.0,-1.2765957446808511,325,231
22400889,3,62,2.0,1.935483870967742,221,159
22400889,3,159,0.0,0.0,159,0
22400889,4,86,7.0,4.883720930232559,720,634
22400889,4,37,3.0,4.864864864864865,634,597
22400889,4,89,1.0,0.6741573033707865,597,508
22400889,4,203,5.0,1.477832512315271,498,295
22400889,4,142,4.0,1.6901408450704225,295,153
22400889,4,101,1.0,0.594059405940594,137,36
22400889,4,25,-2.0,-4.8,34,9
22400889,4,2,-1.0,-30.0,5,3
22400889,4,3,0.0,0.0,3,0
22400890,1,359,5.0,0.8356545961002785,720,361
22400890,1,28,0.0,0.0,346,318
22400890,1,105,9.0,5.142857142857143,314,209
22400890,1,168,3.0,1.0714285714285714,189,21
22400890,1,21,-2.0,-5.7142857142857135,21,0
22400890,2,126,-7.0,-3.333333333333333,720,594
22400890,2,115,-3.0,-1.5652173913043477,585,470
22400890,2,36,-3.0,-5.0,460,424
22400890,2,84,5.0,3.571428571428571,411,327
22400890,2,21,2.0,5.7142857142857135,316,295
22400890,2,108,-3.0,-1.6666666666666665,295,187
22400890,2,42,1.0,1.4285714285714284,175,133
22400890,2,118,-3.0,-1.5254237288135595,133,15
22400890,2,15,3.0,12.0,15,0
22400890,3,221,-2.0,-0.5429864253393666,720,499
22400890,3,72,3.0,2.5,494,422
22400890,3,5,0.0,0.0,409,404
22400890,3,24,1.0,2.5,404,380
22400890,3,46,2.0,2.608695652173913,380,334
22400890,3,111,5.0,2.7027027027027026,328,217
22400890,3,18,0.0,0.0,203,185
22400890,3,48,-2.0,-2.5,149,101
22400890,3,101,-2.0,-1.188118811881188,101,0
22400890,4,198,2.0,0.6060606060606061,720,522
22400890,4,79,0.0,0.0,503,424
22400890,4,10,1.0,6.0,410,400
22400890,4,71,1.0,0.8450704225352113,400,329
22400890,4,77,3.0,2.3376623376623376,318,241
22400890,4,235,-2.0,-0.5106382978723404,235,0
22400891,1,249,0.0,0.0,720,471
22400891,1,60,-3.0,-3.0,471,411
22400891,1,112,4.0,2.142857142857143,391,279
22400891,1,46,-2.0,-2.608695652173913,225,179
22400891,1,60,1.0,1.0,179,119
22400891,1,119,6.0,3.0252100840336134,119,0
22400891,2,93,-4.0,-2.580645161290323,720,627
22400891,2,145,1.0,0.41379310344827586,612,467
22400891,2,40,-3.0,-4.5,465,425
22400891,2,47,0.0,0.0,418,371
22400891,2,38,-2.0,-3.1578947368421053,371,333
22400891,2,93,2.0,1.2903225806451615,333,240
22400891,2,131,9.0,4.122137404580153,232,101
22400891,3,197,5.0,1.5228426395939085,720,523
22400891,3,211,0.0,0.0,511,300
22400891,3,122,5.0,2.4590163934426226,261,139
22400891,3,120,1.0,0.5,124,4
22400891,3,1,0.0,0.0,1,0
22400891,4,93,3.0,1.935483870967742,720,627
22400891,4,79,-6.0,-4.556962025316456,624,545
22400891,4,81,-1.0,-0.7407407407407407,528,447
22400891,4,126,-5.0,-2.380952380952381,447,321
22400891,4,258,-5.0,-1.1627906976744187,321,63
22400891,4,40,0.0,0.0,52,12
22400891,4,6,1.0,10.0,6,0
22400892,1,310,-1.0,-0.1935483870967742,720,410
22400892,1,207,-10.0,-2.898550724637681,398,191
22400892,1,130,-2.0,-0.9230769230769231,184,54
22400892,1,51,1.0,1.1764705882352942,51,0
22400892,2,176,6.0,2.0454545454545454,720,544
22400892,2,65,-1.0,-0.9230769230769231,532,467
22400892,2,45,0.0,0.0,467,422
22400892,2,53,-3.0,-3.3962264150943398,409,356
22400892,2,108,-1.0,-0.5555555555555556,332,224
22400892,2,37,-1.0,-1.6216216216216217,221,184
22400892,2,84,2.0,1.4285714285714284,184,100
22400892,2,42,0.0,0.0,42,0
22400892,3,334,-2.0,-0.3592814371257485,720,386
22400892,3,45,-3.0,-4.0,372,327
22400892,3,55,-2.0,-2.1818181818181817,306,251
22400892,3,98,-1.0,-0.6122448979591836,231,133
22400892,3,123,4.0,1.9512195121951221,123,0
22400892,4,48,1.0,1.25,720,672
22400892,4,104,-10.0,-5.769230769230769,672,568
22400892,4,107,-2.0,-1.1214953271028036,556,449
22400892,4,18,2.0,6.666666666666666,449,431
22400892,4,65,4.0,3.6923076923076925,431,366
22400892,4,212,5.0,1.4150943396226416,346,134
22400892,4,69,-3.0,-2.608695652173913,112,43
22400892,4,43,-1.0,-1.3953488372093024,43,0
22400893,1,367,3.0,0.49046321525885556,720,353
22400893,1,26,0.0,0.0,334,308
22400893,1,57,1.0,1.0526315789473684,308,251
22400893,1,66,-2.0,-1.8181818181818183,251,185
22400893,1,14,0.0,0.0,175,161
22400893,1,156,3.0,1.153846153846154,156,0
22400893,2,164,4.0,1.4634146341463414,720,556
22400893,2,141,0.0,0.0,545,404
22400893,2,47,-2.0,-2.5531914893617023,404,357
22400893,2,23,0.0,0.0,345,322
22400893,2,105,2.0,1.142857142857143,320,215
22400893,2,41,2.0,2.926829268292683,215,174
22400893,2,300,-13.0,-2.6,300,0
22400893,3,276,-1.0,-0.21739130434782608,720,444
22400893,3,35,-4.0,-6.857142857142857,427,392
22400893,3,81,5.0,3.7037037037037033,381,300
22400893,3,92,0.0,0.0,291,199
22400893,3,13,1.0,4.615384615384616,190,177
22400893,3,165,1.0,0.36363636363636365,165,0
22400893,4,51,-2.0,-2.3529411764705883,720,669
22400893,4,114,0.0,0.0,651,537
22400893,4,37,-1.0,-1.6216216216216217,537,500
22400893,4,79,0.0,0.0,500,421
22400893,4,37,2.0,3.2432432432432434,408,371
22400893,4,94,4.0,2.5531914893617023,371,277
22400893,4,134,6.0,2.6865671641791042,253,119
22400893,4,66,2.0,1.8181818181818183,105,39
22400893,4,1,0.0,0.0,18,17
22400893,4,12,0.0,0.0,12,0
22400894,1,165,-3.0,-1.0909090909090908,720,555
22400894,1,117,6.0,3.0769230769230766,555,438
22400894,1,125,3.0,1.44,438,313
22400894,1,9,0.0,0.0,313,304
22400894,1,91,2.0,1.3186813186813189,294,203
22400894,1,198,-4.0,-1.2121212121212122,200,2
22400894,2,171,1.0,0.3508771929824561,720,549
22400894,2,61,-1.0,-0.9836065573770493,526,465
22400894,2,61,-2.0,-1.9672131147540985,457,396
22400894,2,28,1.0,2.142857142857143,396,368
22400894,2,87,-1.0,-0.6896551724137931,358,271
22400894,2,220,6.0,1.6363636363636362,271,51
22400894,2,33,3.0,5.454545454545455,44,11
22400894,3,304,4.0,0.7894736842105263,720,416
22400894,3,48,-5.0,-6.25,397,349
22400894,3,53,0.0,0.0,349,296
22400894,3,19,1.0,3.1578947368421053,280,261
22400894,3,79,-2.0,-1.5189873417721518,261,182
22400894,3,182,-1.0,-0.3296703296703297,182,0
22400894,4,149,-2.0,-0.8053691275167785,720,571
22400894,4,34,1.0,1.7647058823529411,553,519
22400894,4,52,0.0,0.0,519,467
22400894,4,47,3.0,3.829787234042553,467,420
22400894,4,28,-1.0,-2.142857142857143,420,392
22400894,4,128,-2.0,-0.9375,372,244
22400894,4,224,2.0,0.5357142857142857,231,7
22400894,4,1,0.0,0.0,5,4
22400894,4,1,0.0,0.0,1,0
22400895,1,247,5.0,1.214574898785425,720,473
22400895,1,47,-5.0,-6.382978723404255,473,426
22400895,1,135,-1.0,-0.4444444444444445,417,282
22400895,1,140,-5.0,-2.142857142857143,272,132
22400895,1,108,6.0,3.333333333333333,120,12
22400895,2,316,1.0,0.18987341772151897,720,404
22400895,2,28,-1.0,-2.142857142857143,404,376
22400895,2,86,-2.0,-1.3953488372093024,363,277
22400895,2,69,0.0,0.0,263,194
22400895,2,12,-1.0,-5.0,172,160
22400895,2,26,2.0,4.615384615384616,160,134
22400895,2,87,-3.0,-2.0689655172413794,123,36
22400895,2,12,1.0,5.0,36,24
22400895,2,24,0.0,0.0,24,0
22400895,3,274,0.0,0.0,720,446
22400895,3,33,-2.0,-3.6363636363636367,433,400
22400895,3,101,-4.0,-2.376237623762376,393,292
22400895,3,44,2.0,2.7272727272727275,292,248
22400895,3,10,2.0,12.0,194,184
22400895,3,26,-2.0,-4.615384615384616,184,158
22400895,3,158,2.0,0.7594936708860759,158,0
22400895,4,162,7.0,2.5925925925925926,720,558
22400895,4,52,-2.0,-2.307692307692308,537,485
22400895,4,1,0.0,0.0,469,468
22400895,4,89,-7.0,-4.719101123595506,450,361
22400895,4,193,5.0,1.5544041450777202,354,161
22400895,4,62,-6.0,-5.806451612903226,152,90
22400895,4,75,2.0,1.6,75,0
22400896,1,339,-2.0,-0.35398230088495575,720,381
22400896,1,120,-2.0,-1.0,381,261
22400896,1,67,0.0,0.0,254,187
22400896,1,102,-4.0,-2.3529411764705883,187,85
22400896,1,67,-5.0,-4.477611940298507,67,0
22400896,2,77,4.0,3.116883116883117,720,643
22400896,2,218,0.0,0.0,638,420
22400896,2,76,-5.0,-3.9473684210526314,406,330
22400896,2,184,1.0,0.32608695652173914,313,129
22400896,2,129,0.0,0.0,129,0
22400896,3,444,1.0,0.13513513513513514,720,276
22400896,3,3,0.0,0.0,263,260
22400896,3,14,0.0,0.0,251,237
22400896,3,118,0.0,0.0,229,111
22400896,3,93,-5.0,-3.2258064516129035,107,14
22400896,4,143,5.0,2.097902097902098,720,577
22400896,4,30,2.0,4.0,565,535
22400896,4,55,0.0,0.0,497,442
22400896,4,36,-3.0,-5.0,442,406
22400896,4,114,-1.0,-0.5263157894736842,406,292
22400896,4,72,5.0,4.166666666666667,292,220
22400896,4,184,0.0,0.0,220,36
22400896,4,36,2.0,3.333333333333333,36,0
22400897,1,310,0.0,0.0,720,410
22400897,1,124,-3.0,-1.4516129032258065,404,280
22400897,1,26,2.0,4.615384615384616,280,254
22400897,1,81,0.0,0.0,148,67
22400897,2,173,-7.0,-2.4277456647398843,720,547
22400897,2,97,2.0,1.2371134020618557,533,436
22400897,2,24,3.0,7.5,421,397
22400897,2,25,1.0,2.4,397,372
22400897,2,41,2.0,2.926829268292683,372,331
22400897,2,51,0.0,0.0,331,280
22400897,2,212,4.0,1.1320754716981132,275,63
22400897,2,63,0.0,0.0,63,0
22400897,3,260,3.0,0.6923076923076923,720,460
22400897,3,57,2.0,2.1052631578947367,445,388
22400897,3,60,5.0,5.0,373,313
22400897,3,52,1.0,1.153846153846154,295,243
22400897,3,77,-3.0,-2.3376623376623376,243,166
22400897,3,153,-3.0,-1.1764705882352942,153,0
22400897,4,177,6.0,2.0338983050847457,720,543
22400897,4,252,-2.0,-0.47619047619047616,526,274
22400897,4,83,2.0,1.4457831325301205,272,189
22400897,4,158,-4.0,-1.5189873417721518,158,0
22400898,1,382,10.0,1.5706806282722514,720,338
22400898,1,11,2.0,10.90909090909091,335,324
22400898,1,57,1.0,1.0526315789473684,324,267
22400898,1,145,-5.0,-2.0689655172413794,267,122
22400898,1,115,-2.0,-1.0434782608695652,115,0
22400898,2,141,-2.0,-0.851063829787234,720,579
22400898,2,72,4.0,3.333333333333333,579,507
22400898,2,92,-2.0,-1.3043478260869565,495,403
22400898,2,131,-4.0,-1.83206106870229,383,252
22400898,2,198,0.0,0.0,247,49
22400898,2,33,-4.0,-7.272727272727273,34,1
22400898,2,1,0.0,0.0,1,0
22400898,3,457,6.0,0.787746170678337,720,263
22400898,3,25,0.0,0.0,243,218
22400898,3,44,-4.0,-5.454545454545455,207,163
22400898,3,53,-2.0,-2.2641509433962264,163,110
22400898,3,95,3.0,1.8947368421052633,95,0
22400898,4,81,0.0,0.0,720,639
22400898,4,70,1.0,0.8571428571428571,626,556
22400898,4,84,-5.0,-3.571428571428571,548,464
22400898,4,74,6.0,4.864864864864865,448,374
22400898,4,36,2.0,3.333333333333333,341,305
22400898,4,92,-1.0,-0.6521739130434783,297,205
22400898,4,75,1.0,0.8,193,118
22400898,4,72,-1.0,-0.8333333333333333,118,46
22400898,4,2,0.0,0.0,46,44
22400898,4,44,0.0,0.0,44,0
22400899,1,316,-4.0,-0.7594936708860759,720,404
22400899,1,16,-1.0,-3.75,404,388
22400899,1,39,0.0,0.0,384,345
22400899,1,89,-5.0,-3.3707865168539324,345,256
22400899,1,88,0.0,0.0,228,140
22400899,1,130,-3.0,-1.3846153846153846,130,0
22400899,2,148,6.0,2.4324324324324325,720,572
22400899,2,59,6.0,6.101694915254238,551,492
22400899,2,48,0.0,0.0,479,431
22400899,2,40,0.0,0.0,418,378
22400899,2,71,-5.0,-4.225352112676057,371,300
22400899,2,24,2.0,5.0,289,265
22400899,2,9,1.0,6.666666666666666,255,246
22400899,2,58,0.0,0.0,246,188
22400899,2,184,-9.0,-2.9347826086956523,184,0
22400899,3,94,-1.0,-0.6382978723404256,720,626
22400899,3,37,3.0,4.864864864864865,619,582
22400899,3,171,-4.0,-1.4035087719298245,563,392
22400899,3,78,4.0,3.0769230769230766,392,314
22400899,3,9,2.0,13.333333333333332,308,299
22400899,3,51,-2.0,-2.3529411764705883,299,248
22400899,3,39,2.0,3.0769230769230766,233,194
22400899,3,33,-6.0,-10.90909090909091,181,148
22400899,3,39,-4.0,-6.153846153846153,129,90
22400899,3,88,3.0,2.0454545454545454,90,2
22400899,3,2,0.0,0.0,2,0
22400899,4,134,1.0,0.44776119402985076,720,586
22400899,4,24,1.0,2.5,572,548
22400899,4,48,2.0,2.5,548,500
22400899,4,94,0.0,0.0,477,383
22400899,4,66,4.0,3.6363636363636367,369,303
22400899,4,229,2.0,0.5240174672489083,284,55
22400899,4,17,-1.0,-3.5294117647058822,54,37
22400899,4,37,-1.0,-1.6216216216216217,37,0
22400900,1,291,-1.0,-0.20618556701030927,720,429
22400900,1,6,0.0,0.0,417,411
22400900,1,81,1.0,0.7407407407407407,396,315
22400900,1,24,2.0,5.0,312,288
22400900,1,114,-1.0,-0.5263157894736842,277,163
22400900,1,80,8.0,6.0,155,75
22400900,1,59,-3.0,-3.050847457627119,59,0
22400900,2,119,0.0,0.0,720,601
22400900,2,138,-1.0,-0.43478260869565216,587,449
22400900,2,8,-2.0,-15.0,441,433
22400900,2,210,10.0,2.8571428571428568,413,203
22400900,2,190,1.0,0.3157894736842105,191,1
22400900,2,1,0.0,0.0,1,0
22400900,3,345,1.0,0.17391304347826086,720,375
22400900,3,68,-1.0,-0.8823529411764706,357,289
22400900,3,62,-5.0,-4.838709677419355,289,227
22400900,3,93,-6.0,-3.870967741935484,214,121
22400900,3,22,8.0,21.81818181818182,121,99
22400900,4,41,2.0,2.926829268292683,720,679
22400900,4,82,6.0,4.390243902439024,666,584
22400900,4,99,2.0,1.2121212121212122,570,471
22400900,4,79,-3.0,-2.278481012658228,471,392
22400900,4,135,-4.0,-1.777777777777778,376,241
22400900,4,38,-2.0,-3.1578947368421053,229,191
22400900,4,178,-2.0,-0.6741573033707865,178,0
22400901,1,44,0.0,0.0,720,676
22400901,1,235,7.0,1.7872340425531916,676,441
22400901,1,67,5.0,4.477611940298507,427,360
22400901,1,11,1.0,5.454545454545455,344,333
22400901,1,46,2.0,2.608695652173913,302,256
22400901,1,251,-2.0,-0.47808764940239046,254,3
22400901,2,281,-10.0,-2.135231316725979,720,439
22400901,2,51,-2.0,-2.3529411764705883,419,368
22400901,2,74,4.0,3.2432432432432434,352,278
22400901,2,35,0.0,0.0,271,236
22400901,2,90,-3.0,-2.0,236,146
22400901,2,39,-5.0,-7.692307692307692,134,95
22400901,2,78,-1.0,-0.7692307692307692,78,0
22400901,3,276,-4.0,-0.8695652173913043,720,444
22400901,3,19,0.0,0.0,444,425
22400901,3,22,-1.0,-2.7272727272727275,419,397
22400901,3,33,1.0,1.8181818181818183,397,364
22400901,3,66,2.0,1.8181818181818183,352,286
22400901,3,48,-1.0,-1.25,286,238
22400901,3,73,0.0,0.0,238,165
22400901,3,57,-2.0,-2.1052631578947367,165,108
22400901,3,96,0.0,0.0,96,0
22400901,4,100,0.0,0.0,720,620
22400901,4,76,-2.0,-1.5789473684210527,614,538
22400901,4,45,-2.0,-2.666666666666667,538,493
22400901,4,129,-2.0,-0.9302325581395349,469,340
22400901,4,38,-2.0,-3.1578947368421053,340,302
22400901,4,35,-3.0,-5.142857142857143,302,267
22400901,4,44,2.0,2.7272727272727275,267,223
22400901,4,85,2.0,1.4117647058823528,211,126
22400901,4,84,2.0,1.4285714285714284,126,42
22400901,4,11,0.0,0.0,26,15
22400901,4,10,0.0,0.0,10,0
22400902,1,240,0.0,0.0,720,480
22400902,1,69,5.0,4.3478260869565215,480,411
22400902,1,91,5.0,3.2967032967032965,391,300
22400902,1,81,1.0,0.7407407407407407,286,205
22400902,1,82,-1.0,-0.7317073170731707,205,123
22400902,1,118,-3.0,-1.5254237288135595,119,1
22400902,1,1,0.0,0.0,1,0
22400902,2,179,2.0,0.670391061452514,720,541
22400902,2,80,0.0,0.0,535,455
22400902,2,33,0.0,0.0,445,412
22400902,2,185,3.0,0.972972972972973,397,212
22400902,2,114,-4.0,-2.1052631578947367,212,98
22400902,2,82,-2.0,-1.4634146341463414,82,0
22400902,3,51,-2.0,-2.3529411764705883,720,669
22400902,3,245,-6.0,-1.4693877551020407,663,418
22400902,3,58,1.0,1.0344827586206897,399,341
22400902,3,96,0.0,0.0,323,227
22400902,3,28,0.0,0.0,227,199
22400902,3,46,-3.0,-3.9130434782608696,188,142
22400902,3,120,-5.0,-2.5,142,22
22400902,3,17,1.0,3.5294117647058822,22,5
22400902,3,5,0.0,0.0,5,0
22400902,4,161,0.0,0.0,720,559
22400902,4,27,0.0,0.0,548,521
22400902,4,125,4.0,1.92,521,396
22400902,4,99,3.0,1.8181818181818183,384,285
22400902,4,8,2.0,15.0,269,261
22400902,4,73,0.0,0.0,257,184
22400902,4,61,-1.0,-0.9836065573770493,169,108
22400902,4,44,-2.0,-2.7272727272727275,108,64
22400903,1,218,0.0,0.0,720,502
22400903,1,85,2.0,1.4117647058823528,502,417
22400903,1,58,-2.0,-2.0689655172413794,408,350
22400903,1,51,4.0,4.705882352941177,350,299
22400903,1,118,-1.0,-0.5084745762711864,282,164
22400903,1,8,0.0,0.0,104,96
22400903,1,92,0.0,0.0,96,4
22400903,2,55,0.0,0.0,720,665
22400903,2,55,0.0,0.0,663,608
22400903,2,63,-5.0,-4.761904761904762,608,545
22400903,2,56,-2.0,-2.142857142857143,531,475
22400903,2,89,2.0,1.348314606741573,475,386
22400903,2,71,-3.0,-2.535211267605634,373,302
22400903,2,66,-5.0,-4.545454545454546,294,228
22400903,2,40,0.0,0.0,207,167
22400903,2,147,1.0,0.40816326530612246,147,0
22400903,3,203,-1.0,-0.2955665024630542,720,517
22400903,3,216,-2.0,-0.5555555555555556,517,301
22400903,3,61,-3.0,-2.9508196721311473,226,165
22400903,3,81,3.0,2.2222222222222223,165,84
22400903,3,69,-1.0,-0.8695652173913043,69,0
22400903,4,162,-2.0,-0.7407407407407407,720,558
22400903,4,57,2.0,2.1052631578947367,543,486
22400903,4,35,0.0,0.0,473,438
22400903,4,37,2.0,3.2432432432432434,417,380
22400903,4,62,3.0,2.903225806451613,375,313
22400903,4,291,7.0,1.443298969072165,313,22
22400903,4,2,0.0,0.0,11,9
22400903,5,216,0.0,0.0,300,84
22400903,5,4,0.0,0.0,84,80
22400903,5,29,0.0,0.0,39,10
22400903,5,10,2.0,12.0,10,0
22400904,1,318,-1.0,-0.18867924528301888,720,402
22400904,1,36,2.0,3.333333333333333,402,366
22400904,1,23,3.0,7.826086956521739,346,323
22400904,1,21,0.0,0.0,323,302
22400904,1,30,-1.0,-2.0,302,272
22400904,1,57,0.0,0.0,272,215
22400904,1,28,3.0,6.428571428571428,215,187
22400904,1,170,-4.0,-1.4117647058823528,170,0
22400904,2,51,0.0,0.0,720,669
22400904,2,78,-4.0,-3.0769230769230766,663,585
22400904,2,71,5.0,4.225352112676057,569,498
22400904,2,25,-2.0,-4.8,498,473
22400904,2,11,2.0,10.90909090909091,473,462
22400904,2,144,-1.0,-0.41666666666666663,462,318
22400904,2,81,-1.0,-0.7407407407407407,318,237
22400904,2,96,-2.0,-1.25,237,141
22400904,2,118,2.0,1.0169491525423728,121,3
22400904,2,1,-2.0,-120.0,1,0
22400904,3,168,1.0,0.3571428571428571,720,552
22400904,3,139,6.0,2.589928057553957,552,413
22400904,3,4,0.0,0.0,413,409
22400904,3,73,-1.0,-0.821917808219178,397,324
22400904,3,25,0.0,0.0,324,299
22400904,3,11,-1.0,-5.454545454545455,283,272
22400904,3,184,0.0,0.0,409,225
22400904,3,189,2.0,0.6349206349206349,220,31
22400904,3,21,0.0,0.0,21,0
22400904,4,71,0.0,0.0,720,649
22400904,4,155,5.0,1.935483870967742,644,489
22400904,4,23,0.0,0.0,489,466
22400904,4,61,2.0,1.9672131147540985,466,405
22400904,4,9,0.0,0.0,392,383
22400904,4,52,1.0,1.153846153846154,370,318
22400904,4,67,-2.0,-1.791044776119403,318,251
22400904,4,38,-1.0,-1.5789473684210527,241,203
22400904,4,50,0.0,0.0,203,153
22400904,4,23,0.0,0.0,141,118
22400904,4,37,-4.0,-6.486486486486487,112,75
22400904,4,54,-1.0,-1.1111111111111112,75,21
22400904,4,1,-1.0,-60.0,16,15
22400904,4,7,2.0,17.142857142857142,12,5
22400904,4,1,0.0,0.0,5,4
22400904,4,4,0.0,0.0,4,0
22400905,1,258,5.0,1.1627906976744187,720,462
22400905,1,28,0.0,0.0,462,434
22400905,1,45,2.0,2.666666666666667,419,374
22400905,1,115,0.0,0.0,374,259
22400905,1,170,-2.0,-0.7058823529411764,259,89
22400905,2,207,3.0,0.8695652173913043,720,513
22400905,2,12,1.0,5.0,513,501
22400905,2,31,-3.0,-5.806451612903226,501,470
22400905,2,49,3.0,3.673469387755102,470,421
22400905,2,71,0.0,0.0,418,347
22400905,2,25,0.0,0.0,347,322
22400905,2,161,1.0,0.37267080745341613,322,161
22400905,2,75,3.0,2.4,161,86
22400905,2,77,3.0,2.3376623376623376,86,9
22400905,3,123,-2.0,-0.9756097560975611,720,597
22400905,3,191,2.0,0.6282722513089005,591,400
22400905,3,31,-2.0,-3.870967741935484,400,369
22400905,3,54,1.0,1.1111111111111112,362,308
22400905,3,79,-2.0,-1.5189873417721518,300,221
22400905,3,64,2.0,1.875,208,144
22400905,3,144,2.0,0.8333333333333333,144,0
22400905,4,134,-1.0,-0.44776119402985076,720,586
22400905,4,62,-2.0,-1.935483870967742,577,515
22400905,4,26,0.0,0.0,502,476
22400905,4,59,-4.0,-4.067796610169491,476,417
22400905,4,55,-1.0,-1.0909090909090908,402,347
22400905,4,120,5.0,2.5,324,204
22400905,4,101,0.0,0.0,195,94
22400905,4,10,0.0,0.0,72,62
22400905,4,62,-3.0,-2.903225806451613,62,0
22400906,1,251,-1.0,-0.23904382470119523,720,469
22400906,1,31,0.0,0.0,450,419
22400906,1,112,4.0,2.142857142857143,412,300
22400906,1,38,0.0,0.0,280,242
22400906,1,83,-3.0,-2.1686746987951806,237,154
22400906,1,114,5.0,2.631578947368421,148,34
22400906,1,34,0.0,0.0,34,0
22400906,2,209,-1.0,-0.28708133971291866,720,511
22400906,2,10,-2.0,-12.0,510,500
22400906,2,61,1.0,0.9836065573770493,481,420
22400906,2,82,7.0,5.121951219512195,409,327
22400906,2,59,0.0,0.0,317,258
22400906,2,121,-4.0,-1.9834710743801653,255,134
22400906,2,102,-3.0,-1.7647058823529411,134,32
22400906,2,32,0.0,0.0,32,0
22400906,3,214,-5.0,-1.4018691588785046,720,506
22400906,3,49,-1.0,-1.2244897959183672,506,457
22400906,3,40,-2.0,-3.0,457,417
22400906,3,66,4.0,3.6363636363636367,405,339
22400906,3,12,-1.0,-5.0,324,312
22400906,3,155,1.0,0.3870967741935484,312,157
22400906,3,153,0.0,0.0,157,4
22400906,4,169,-8.0,-2.8402366863905324,720,551
22400906,4,60,6.0,6.0,532,472
22400906,4,163,-2.0,-0.7361963190184049,461,298
22400906,4,40,0.0,0.0,288,248
22400906,4,122,-4.0,-1.9672131147540985,248,126
22400906,4,126,-7.0,-3.333333333333333,126,0
22400907,1,359,-7.0,-1.16991643454039,720,361
22400907,1,36,0.0,0.0,346,310
22400907,1,33,0.0,0.0,298,265
22400907,1,48,0.0,0.0,256,208
22400907,1,35,0.0,0.0,192,157
22400907,1,135,-2.0,-0.888888888888889,135,0
22400907,2,147,-1.0,-0.40816326530612246,720,573
22400907,2,39,2.0,3.0769230769230766,573,534
22400907,2,33,-4.0,-7.272727272727273,521,488
22400907,2,140,6.0,2.5714285714285716,464,324
22400907,2,149,1.0,0.40268456375838924,312,163
22400907,2,39,0.0,0.0,144,105
22400907,2,97,3.0,1.8556701030927836,105,8
22400907,3,211,-6.0,-1.7061611374407581,720,509
22400907,3,77,-2.0,-1.5584415584415585,498,421
22400907,3,92,-5.0,-3.260869565217391,421,329
22400907,3,62,2.0,1.935483870967742,302,240
22400907,3,116,10.0,5.172413793103448,240,124
22400907,3,56,0.0,0.0,100,44
22400907,4,86,0.0,0.0,720,634
22400907,4,90,-2.0,-1.3333333333333335,634,544
22400907,4,70,2.0,1.7142857142857142,526,456
22400907,4,27,2.0,4.444444444444445,432,405
22400907,4,164,-8.0,-2.926829268292683,399,235
22400907,4,39,-1.0,-1.5384615384615383,213,174
22400907,4,112,0.0,0.0,174,62
22400907,4,18,0.0,0.0,57,39
22400907,4,4,0.0,0.0,38,34
22400907,4,3,0.0,0.0,26,23
22400907,4,2,0.0,0.0,19,17
22400907,4,6,2.0,20.0,17,11
22400907,4,1,0.0,0.0,8,7
22400907,4,2,0.0,0.0,3,1
22400907,4,1,0.0,0.0,1,0
22400908,1,254,-4.0,-0.9448818897637795,720,466
22400908,1,94,6.0,3.829787234042553,459,365
22400908,1,94,3.0,1.9148936170212765,365,271
22400908,1,68,-3.0,-2.647058823529412,256,188
22400908,1,21,0.0,0.0,172,151
22400908,1,57,-2.0,-2.1052631578947367,151,94
22400908,1,85,0.0,0.0,85,0
22400908,2,212,-10.0,-2.8301886792452833,720,508
22400908,2,40,5.0,7.5,508,468
22400908,2,113,6.0,3.185840707964602,457,344
22400908,2,6,-1.0,-10.0,329,323
22400908,2,5,0.0,0.0,323,318
22400908,2,102,5.0,2.941176470588235,312,210
22400908,2,65,4.0,3.6923076923076925,210,145
22400908,2,145,6.0,2.4827586206896552,145,0
22400908,3,191,1.0,0.31413612565445026,720,529
22400908,3,128,-1.0,-0.46875,520,392
22400908,3,82,-4.0,-2.926829268292683,387,305
22400908,3,66,0.0,0.0,305,239
22400908,3,64,1.0,0.9375,232,168
22400908,3,133,-4.0,-1.8045112781954886,165,32
22400908,3,22,0.0,0.0,22,0
22400908,4,79,0.0,0.0,720,641
22400908,4,84,0.0,0.0,621,537
22400908,4,4,0.0,0.0,530,526
22400908,4,93,-2.0,-1.2903225806451615,520,427
22400908,4,83,3.0,2.1686746987951806,427,344
22400908,4,31,3.0,5.806451612903226,328,297
22400908,4,37,2.0,3.2432432432432434,286,249
22400908,4,57,-1.0,-1.0526315789473684,242,185
22400908,4,100,8.0,4.8,185,85
22400908,4,6,0.0,0.0,75,69
22400908,4,67,2.0,1.791044776119403,67,0
22400909,1,422,4.0,0.5687203791469195,720,298
22400909,1,81,5.0,3.7037037037037033,289,208
22400909,1,32,-1.0,-1.875,200,168
22400909,1,163,-1.0,-0.36809815950920244,163,0
22400909,2,113,0.0,0.0,720,607
22400909,2,40,-1.0,-1.5,594,554
22400909,2,134,7.0,3.134328358208955,554,420
22400909,2,136,4.0,1.7647058823529411,408,272
22400909,2,12,1.0,5.0,272,260
22400909,2,183,0.0,0.0,260,77
22400909,2,63,-2.0,-1.9047619047619047,63,0
22400909,3,338,5.0,0.8875739644970414,720,382
22400909,3,58,-3.0,-3.103448275862069,382,324
22400909,3,151,-1.0,-0.3973509933774834,309,158
22400909,3,144,-5.0,-2.0833333333333335,150,6
22400909,4,163,-2.0,-0.7361963190184049,720,557
22400909,4,12,0.0,0.0,557,545
22400909,4,58,-1.0,-1.0344827586206897,541,483
22400909,4,39,2.0,3.0769230769230766,466,427
22400909,4,99,0.0,0.0,412,313
22400909,4,29,-1.0,-2.0689655172413794,313,284
22400909,4,90,1.0,0.6666666666666667,284,194
22400909,4,182,-1.0,-0.3296703296703297,183,1
22400909,5,264,7.0,1.590909090909091,300,36
22400909,5,36,0.0,0.0,36,0
22400910,1,388,0.0,0.0,720,332
22400910,1,48,-2.0,-2.5,300,252
22400910,1,112,-4.0,-2.142857142857143,245,133
22400910,1,9,0.0,0.0,120,111
22400910,1,85,2.0,1.4117647058823528,106,21
22400910,2,119,2.0,1.0084033613445378,720,601
22400910,2,118,3.0,1.5254237288135595,591,473
22400910,2,50,1.0,1.2,463,413
22400910,2,54,5.0,5.555555555555555,413,359
22400910,2,106,4.0,2.2641509433962264,334,228
22400910,2,209,6.0,1.722488038277512,209,0
22400910,3,210,7.0,2.0,720,510
22400910,3,109,2.0,1.1009174311926606,510,401
22400910,3,192,0.0,0.0,385,193
22400910,3,188,-1.0,-0.3191489361702128,188,0
22400910,4,116,-7.0,-3.620689655172414,720,604
22400910,4,28,3.0,6.428571428571428,595,567
22400910,4,57,-3.0,-3.1578947368421053,567,510
22400910,4,79,1.0,0.7594936708860759,510,431
22400910,4,61,2.0,1.9672131147540985,419,358
22400910,4,96,-2.0,-1.25,357,261
22400910,4,100,2.0,1.2,253,153
22400910,4,20,0.0,0.0,153,133
22400910,4,2,-2.0,-60.0,119,117
22400910,4,101,-2.0,-1.188118811881188,101,0
22400911,1,474,-1.0,-0.12658227848101264,720,246
22400911,1,133,0.0,0.0,246,113
22400911,1,100,7.0,4.2,100,0
22400911,2,130,-8.0,-3.6923076923076925,720,590
22400911,2,44,-2.0,-2.7272727272727275,590,546
22400911,2,127,-2.0,-0.9448818897637795,528,401
22400911,2,159,5.0,1.8867924528301887,379,220
22400911,2,58,5.0,5.172413793103448,220,162
22400911,2,155,3.0,1.1612903225806452,155,0
22400911,3,503,0.0,0.0,720,217
22400911,3,113,-3.0,-1.592920353982301,173,60
22400911,3,35,1.0,1.7142857142857142,56,21
22400911,3,16,-2.0,-7.5,21,5
22400911,3,5,0.0,0.0,5,0
22400911,4,326,7.0,1.2883435582822087,720,394
22400911,4,13,1.0,4.615384615384616,371,358
22400911,4,29,0.0,0.0,358,329
22400911,4,219,2.0,0.547945205479452,316,97
22400911,4,6,-2.0,-20.0,97,91
22400911,4,46,-1.0,-1.3043478260869565,71,25
22400911,4,14,0.0,0.0,25,11
22400911,4,8,1.0,7.5,8,0
22400912,1,277,-1.0,-0.21660649819494585,720,443
22400912,1,83,-1.0,-0.7228915662650602,424,341
22400912,1,5,0.0,0.0,303,298
22400912,1,11,0.0,0.0,279,268
22400912,1,46,-2.0,-2.608695652173913,261,215
22400912,1,12,-1.0,-5.0,215,203
22400912,1,37,0.0,0.0,194,157
22400912,1,138,0.0,0.0,150,12
22400912,2,184,-3.0,-0.9782608695652174,720,536
22400912,2,50,-2.0,-2.4,536,486
22400912,2,7,0.0,0.0,468,461
22400912,2,42,-3.0,-4.285714285714286,455,413
22400912,2,49,2.0,2.4489795918367343,402,353
22400912,2,10,0.0,0.0,336,326
22400912,2,35,2.0,3.4285714285714284,313,278
22400912,2,9,2.0,13.333333333333332,271,262
22400912,2,82,-1.0,-0.7317073170731707,262,180
22400912,2,34,-2.0,-3.5294117647058822,170,136
22400912,2,39,-2.0,-3.0769230769230766,130,91
22400912,2,91,-1.0,-0.6593406593406594,91,0
22400912,3,304,3.0,0.5921052631578947,720,416
22400912,3,52,-2.0,-2.307692307692308,395,343
22400912,3,3,0.0,0.0,343,340
22400912,3,57,-1.0,-1.0526315789473684,320,263
22400912,3,164,4.0,1.4634146341463414,254,90
22400912,3,73,0.0,0.0,78,5
22400912,4,117,-1.0,-0.5128205128205129,720,603
22400912,4,82,-2.0,-1.4634146341463414,603,521
22400912,4,7,0.0,0.0,499,492
22400912,4,99,0.0,0.0,478,379
22400912,4,206,4.0,1.1650485436893203,371,165
22400912,4,158,4.0,1.5189873417721518,165,7
22400912,4,4,2.0,30.0,4,0
22400913,1,316,6.0,1.139240506329114,720,404
22400913,1,52,-1.0,-1.153846153846154,396,344
22400913,1,158,3.0,1.139240506329114,344,186
22400913,1,72,-1.0,-0.8333333333333333,179,107
22400913,1,95,-1.0,-0.631578947368421,95,0
22400913,2,220,5.0,1.3636363636363638,720,500
22400913,2,123,3.0,1.4634146341463414,500,377
22400913,2,46,-1.0,-1.3043478260869565,366,320
22400913,2,136,-9.0,-3.9705882352941178,320,184
22400913,2,90,2.0,1.3333333333333335,238,148
22400913,2,135,4.0,1.777777777777778,136,1
22400913,3,381,5.0,0.7874015748031495,720,339
22400913,3,61,-7.0,-6.885245901639345,339,278
22400913,3,29,0.0,0.0,260,231
22400913,3,110,4.0,2.1818181818181817,218,108
22400913,3,94,5.0,3.1914893617021276,94,0
22400913,4,111,5.0,2.7027027027027026,720,609
22400913,4,47,-1.0,-1.2765957446808511,609,562
22400913,4,98,1.0,0.6122448979591836,562,464
22400913,4,94,2.0,1.2765957446808511,454,360
22400913,4,29,-2.0,-4.137931034482759,360,331
22400913,4,278,-4.0,-0.8633093525179857,278,0
22400914,1,240,11.0,2.75,720,480
22400914,1,56,-3.0,-3.214285714285714,480,424
22400914,1,47,-2.0,-2.5531914893617023,424,377
22400914,1,7,0.0,0.0,365,358
22400914,1,35,1.0,1.7142857142857142,337,302
22400914,1,118,10.0,5.084745762711864,302,184
22400914,1,62,2.0,1.935483870967742,173,111
22400914,1,100,2.0,1.2,100,0
22400914,2,144,-6.0,-2.5,720,576
22400914,2,93,-5.0,-3.2258064516129035,576,483
22400914,2,70,-1.0,-0.8571428571428571,474,404
22400914,2,59,0.0,0.0,394,335
22400914,2,19,-2.0,-6.315789473684211,326,307
22400914,2,79,2.0,1.5189873417721518,271,192
22400914,2,47,4.0,5.1063829787234045,179,132
22400914,2,6,-1.0,-10.0,123,117
22400914,3,235,-6.0,-1.5319148936170213,720,485
22400914,3,47,2.0,2.5531914893617023,485,438
22400914,3,72,-2.0,-1.6666666666666665,432,360
22400914,3,67,-1.0,-0.8955223880597015,338,271
22400914,3,68,-1.0,-0.8823529411764706,271,203
22400914,3,25,0.0,0.0,203,178
22400914,3,72,3.0,2.5,178,106
22400914,3,46,-1.0,-1.3043478260869565,106,60
22400914,3,60,-2.0,-2.0,60,0
22400914,4,40,0.0,0.0,720,680
22400914,4,68,-5.0,-4.411764705882353,680,612
22400914,4,85,5.0,3.5294117647058822,602,517
22400914,4,42,-3.0,-4.285714285714286,516,474
22400914,4,39,0.0,0.0,474,435
22400914,4,61,3.0,2.9508196721311473,426,365
22400914,4,149,2.0,0.8053691275167785,365,216
22400914,4,181,-3.0,-0.9944751381215469,200,19
22400914,4,2,0.0,0.0,19,17
22400914,4,2,0.0,0.0,13,11
22400914,4,7,-1.0,-8.571428571428571,7,0
22400915,1,306,4.0,0.7843137254901961,720,414
22400915,1,52,-4.0,-4.615384615384616,395,343
22400915,1,61,7.0,6.885245901639345,335,274
22400915,1,27,3.0,6.666666666666666,268,241
22400915,1,59,-1.0,-1.0169491525423728,219,160
22400915,1,9,0.0,0.0,160,151
22400915,1,106,-2.0,-1.1320754716981132,138,32
22400915,1,28,2.0,4.285714285714286,32,4
22400915,1,4,2.0,30.0,4,0
22400915,2,152,1.0,0.39473684210526316,720,568
22400915,2,48,4.0,5.0,568,520
22400915,2,33,2.0,3.6363636363636367,509,476
22400915,2,76,-5.0,-3.9473684210526314,476,400
22400915,2,17,0.0,0.0,400,383
22400915,2,19,0.0,0.0,378,359
22400915,2,129,0.0,0.0,348,219
22400915,2,163,1.0,0.36809815950920244,219,56
22400915,3,224,-8.0,-2.142857142857143,720,496
22400915,3,89,5.0,3.3707865168539324,496,407
22400915,3,53,0.0,0.0,394,341
22400915,3,1,-1.0,-60.0,327,326
22400915,3,27,-1.0,-2.2222222222222223,323,296
22400915,3,89,-1.0,-0.6741573033707865,296,207
22400915,3,105,0.0,0.0,199,94
22400915,3,85,4.0,2.8235294117647056,85,0
22400915,4,84,3.0,2.142857142857143,720,636
22400915,4,138,-3.0,-1.3043478260869565,633,495
22400915,4,10,0.0,0.0,480,470
22400915,4,19,2.0,6.315789473684211,457,438
22400915,4,95,-1.0,-0.631578947368421,424,329
22400915,4,74,-1.0,-0.8108108108108109,329,255
22400915,4,253,5.0,1.1857707509881423,255,2
22400915,4,2,0.0,0.0,2,0
22400916,1,293,2.0,0.40955631399317405,720,427
22400916,1,150,2.0,0.8,427,277
22400916,1,46,-5.0,-6.521739130434782,277,231
22400916,1,25,1.0,2.4,214,189
22400916,1,32,1.0,1.875,189,157
22400916,1,100,5.0,3.0,157,57
22400916,2,46,3.0,3.9130434782608696,720,674
22400916,2,14,0.0,0.0,663,649
22400916,2,66,-5.0,-4.545454545454546,640,574
22400916,2,19,-1.0,-3.1578947368421053,507,488
22400916,2,55,3.0,3.2727272727272725,488,433
22400916,2,100,-2.0,-1.2,424,324
22400916,2,68,0.0,0.0,309,241
22400916,2,67,-4.0,-3.582089552238806,241,174
22400916,2,163,-1.0,-0.36809815950920244,163,0
22400916,3,307,3.0,0.5863192182410423,720,413
22400916,3,66,2.0,1.8181818181818183,409,343
22400916,3,81,-4.0,-2.962962962962963,330,249
22400916,3,170,1.0,0.3529411764705882,216,46
22400916,3,37,3.0,4.864864864864865,37,0
22400916,4,129,-4.0,-1.8604651162790697,720,591
22400916,4,11,-2.0,-10.90909090909091,584,573
22400916,4,85,-4.0,-2.8235294117647056,561,476
22400916,4,122,-6.0,-2.9508196721311473,474,352
22400916,4,19,0.0,0.0,336,317
22400916,4,30,5.0,10.0,297,267
22400916,4,65,0.0,0.0,256,191
22400916,4,191,-6.0,-1.8848167539267016,191,0
22400917,1,329,-7.0,-1.2765957446808511,720,391
22400917,1,157,-3.0,-1.1464968152866242,382,225
22400917,1,57,4.0,4.2105263157894735,209,152
22400917,1,19,0.0,0.0,141,122
22400917,1,113,-3.0,-1.592920353982301,113,0
22400917,2,120,2.0,1.0,720,600
22400917,2,151,0.0,0.0,600,449
22400917,2,50,2.0,2.4,449,399
22400917,2,53,2.0,2.2641509433962264,391,338
22400917,2,94,-5.0,-3.1914893617021276,327,233
22400917,2,52,-2.0,-2.307692307692308,233,181
22400917,2,148,-1.0,-0.40540540540540543,177,29
22400917,3,342,3.0,0.5263157894736842,720,378
22400917,3,103,-1.0,-0.5825242718446602,363,260
22400917,3,9,0.0,0.0,260,251
22400917,3,105,-2.0,-1.142857142857143,244,139
22400917,4,149,-1.0,-0.40268456375838924,720,571
22400917,4,4,0.0,0.0,556,552
22400917,4,48,1.0,1.25,532,484
22400917,4,48,5.0,6.25,484,436
22400917,4,55,6.0,6.545454545454545,417,362
22400917,4,337,-2.0,-0.3560830860534125,362,25
22400917,4,2,2.0,60.0,17,15
22400917,4,9,0.0,0.0,15,6
22400918,1,287,-5.0,-1.0452961672473866,720,433
22400918,1,170,5.0,1.7647058823529411,419,249
22400918,1,145,3.0,1.2413793103448276,249,104
22400918,1,6,-2.0,-20.0,104,98
22400918,1,73,-2.0,-1.643835616438356,73,0
22400918,2,209,0.0,0.0,720,511
22400918,2,87,3.0,2.0689655172413794,511,424
22400918,2,50,-3.0,-3.5999999999999996,424,374
22400918,2,13,0.0,0.0,374,361
22400918,2,126,-2.0,-0.9523809523809523,346,220
22400918,2,125,2.0,0.96,214,89
22400918,2,84,5.0,3.571428571428571,84,0
22400918,3,204,8.0,2.3529411764705883,720,516
22400918,3,187,10.0,3.2085561497326203,496,309
22400918,3,43,0.0,0.0,294,251
22400918,3,46,-1.0,-1.3043478260869565,235,189
22400918,3,15,0.0,0.0,189,174
22400918,3,48,0.0,0.0,173,125
22400918,3,111,1.0,0.5405405405405406,111,0
22400918,4,209,-5.0,-1.4354066985645932,720,511
22400918,4,97,-6.0,-3.711340206185567,501,404
22400918,4,359,2.0,0.3342618384401114,396,37
22400918,4,37,-2.0,-3.2432432432432434,37,0
22400919,1,375,-1.0,-0.16,720,345
22400919,1,69,2.0,1.7391304347826086,336,267
22400919,1,41,-1.0,-1.4634146341463414,260,219
22400919,1,32,2.0,3.75,219,187
22400919,1,58,0.0,0.0,187,129
22400919,1,96,1.0,0.625,114,18
22400919,1,15,-1.0,-4.0,18,3
22400919,1,3,0.0,0.0,3,0
22400919,2,140,-7.0,-3.0,720,580
22400919,2,6,2.0,20.0,563,557
22400919,2,78,4.0,3.0769230769230766,557,479
22400919,2,56,-4.0,-4.285714285714286,474,418
22400919,2,36,0.0,0.0,418,382
22400919,2,70,1.0,0.8571428571428571,359,289
22400919,2,106,-1.0,-0.5660377358490566,289,183
22400919,2,12,-1.0,-5.0,183,171
22400919,2,79,3.0,2.278481012658228,171,92
22400919,2,84,-3.0,-2.142857142857143,92,8
22400919,2,7,-2.0,-17.142857142857142,8,1
22400919,3,93,2.0,1.2903225806451615,720,627
22400919,3,37,1.0,1.6216216216216217,627,590
22400919,3,170,3.0,1.0588235294117647,590,420
22400919,3,69,-3.0,-2.608695652173913,420,351
22400919,3,9,-2.0,-13.333333333333332,351,342
22400919,3,107,-4.0,-2.2429906542056073,342,235
22400919,3,32,2.0,3.75,235,203
22400919,3,158,0.0,0.0,187,29
22400919,3,29,-1.0,-2.0689655172413794,29,0
22400919,4,200,-1.0,-0.3,720,520
22400919,4,47,3.0,3.829787234042553,520,473
22400919,4,33,3.0,5.454545454545455,458,425
22400919,4,15,2.0,8.0,425,410
22400919,4,67,2.0,1.791044776119403,410,343
22400919,4,34,-1.0,-1.7647058823529411,343,309
22400919,4,82,1.0,0.7317073170731707,309,227
22400919,4,31,-3.0,-5.806451612903226,208,177
22400919,4,12,1.0,5.0,177,165
22400919,4,93,3.0,1.935483870967742,165,72
22400919,4,23,-2.0,-5.217391304347826,72,49
22400919,4,11,0.0,0.0,35,24
22400919,4,14,4.0,17.142857142857142,17,3
22400920,1,404,-1.0,-0.1485148514851485,720,316
22400920,1,175,-2.0,-0.6857142857142857,303,128
22400920,1,105,3.0,1.7142857142857142,128,23
22400920,1,17,3.0,10.588235294117649,17,0
22400920,2,87,2.0,1.3793103448275863,720,633
22400920,2,137,1.0,0.437956204379562,633,496
22400920,2,33,0.0,0.0,496,463
22400920,2,13,0.0,0.0,456,443
22400920,2,87,2.0,1.3793103448275863,437,350
22400920,2,84,2.0,1.4285714285714284,341,257
22400920,2,27,-1.0,-2.2222222222222223,243,216
22400920,2,46,-4.0,-5.217391304347826,204,158
22400920,2,158,-4.0,-1.5189873417721518,158,0
22400920,3,346,7.0,1.2138728323699421,720,374
22400920,3,90,2.0,1.3333333333333335,374,284
22400920,3,77,-3.0,-2.3376623376623376,273,196
22400920,3,118,-1.0,-0.5084745762711864,174,56
22400920,3,52,-3.0,-3.4615384615384617,56,4
22400920,4,88,1.0,0.6818181818181819,720,632
22400920,4,86,0.0,0.0,632,546
22400920,4,76,5.0,3.9473684210526314,546,470
22400920,4,49,-3.0,-3.673469387755102,457,408
22400920,4,93,-1.0,-0.6451612903225807,388,295
22400920,4,43,5.0,6.976744186046512,295,252
22400920,4,169,9.0,3.195266272189349,242,73
22400920,4,58,2.0,2.0689655172413794,58,0
22400921,1,323,-1.0,-0.18575851393188855,720,397
22400921,1,245,-4.0,-0.979591836734694,397,152
22400921,2,71,-4.0,-3.380281690140845,720,649
22400921,2,21,1.0,2.8571428571428568,649,628
22400921,2,91,0.0,0.0,628,537
22400921,2,115,1.0,0.5217391304347826,528,413
22400921,2,62,4.0,3.870967741935484,413,351
22400921,2,108,-1.0,-0.5555555555555556,351,243
22400921,2,24,0.0,0.0,243,219
22400921,2,39,2.0,3.0769230769230766,195,156
22400921,2,101,4.0,2.376237623762376,133,32
22400921,2,27,0.0,0.0,27,0
22400921,3,194,-4.0,-1.2371134020618557,720,526
22400921,3,91,-1.0,-0.6593406593406594,518,427
22400921,3,20,0.0,0.0,420,400
22400921,3,61,0.0,0.0,400,339
22400921,3,136,0.0,0.0,339,203
22400921,3,10,-1.0,-6.0,195,185
22400921,3,127,4.0,1.889763779527559,185,58
22400921,3,57,0.0,0.0,57,0
22400921,4,136,-3.0,-1.323529411764706,720,584
22400921,4,44,6.0,8.181818181818182,584,540
22400921,4,166,1.0,0.3614457831325301,531,365
22400921,4,197,-3.0,-0.9137055837563453,365,168
22400921,4,78,1.0,0.7692307692307692,168,90
22400921,4,82,0.0,0.0,82,0
22400922,1,277,1.0,0.21660649819494585,720,443
22400922,1,120,0.0,0.0,424,304
22400922,1,50,-1.0,-1.2,296,246
22400922,1,43,2.0,2.7906976744186047,43,0
22400922,2,100,-2.0,-1.2,720,620
22400922,2,13,-3.0,-13.846153846153847,602,589
22400922,2,45,-1.0,-1.3333333333333335,569,524
22400922,2,67,-5.0,-4.477611940298507,524,457
22400922,2,102,0.0,0.0,442,340
22400922,2,308,3.0,0.5844155844155844,330,22
22400922,3,446,2.0,0.26905829596412556,720,274
22400922,3,15,0.0,0.0,254,239
22400922,3,127,-1.0,-0.47244094488188976,232,105
22400922,4,156,-1.0,-0.3846153846153846,720,564
22400922,4,75,0.0,0.0,562,487
22400922,4,19,-3.0,-9.473684210526315,476,457
22400922,4,51,0.0,0.0,448,397
22400922,4,57,-3.0,-3.1578947368421053,396,339
22400922,4,146,4.0,1.643835616438356,329,183
22400923,1,315,4.0,0.7619047619047619,720,405
22400923,1,104,-2.0,-1.153846153846154,405,301
22400923,1,14,0.0,0.0,287,273
22400923,1,20,0.0,0.0,273,253
22400923,1,56,0.0,0.0,241,185
22400923,1,56,2.0,2.142857142857143,185,129
22400923,1,129,-3.0,-1.3953488372093024,129,0
22400923,2,298,11.0,2.214765100671141,720,422
22400923,2,41,-1.0,-1.4634146341463414,406,365
22400923,2,101,0.0,0.0,343,242
22400923,2,75,-4.0,-3.2,235,160
22400923,2,20,0.0,0.0,33,13
22400923,3,328,-8.0,-1.4634146341463414,720,392
22400923,3,39,-2.0,-3.0769230769230766,379,340
22400923,3,61,-3.0,-2.9508196721311473,327,266
22400923,3,17,0.0,0.0,260,243
22400923,3,22,0.0,0.0,231,209
22400923,3,91,-2.0,-1.3186813186813189,193,102
22400923,3,71,-6.0,-5.070422535211268,87,16
22400923,3,16,0.0,0.0,16,0
22400923,4,110,7.0,3.818181818181818,720,610
22400923,4,10,0.0,0.0,563,553
22400923,4,129,8.0,3.7209302325581395,551,422
22400923,4,34,-1.0,-1.7647058823529411,369,335
22400923,4,61,0.0,0.0,335,274
22400923,4,19,0.0,0.0,256,237
22400923,4,29,-2.0,-4.137931034482759,237,208
22400923,4,42,-2.0,-2.8571428571428568,195,153
22400923,4,143,2.0,0.8391608391608392,153,10
22400923,4,1,0.0,0.0,10,9
22400923,4,6,0.0,0.0,6,0
22400924,1,319,-8.0,-1.5047021943573666,720,401
22400924,1,104,-4.0,-2.307692307692308,393,289
22400924,1,43,0.0,0.0,289,246
22400924,1,22,0.0,0.0,230,208
22400924,1,15,0.0,0.0,199,184
22400924,1,70,0.0,0.0,184,114
22400924,2,103,4.0,2.3300970873786406,720,617
22400924,2,66,2.0,1.8181818181818183,616,550
22400924,2,160,8.0,3.0,537,377
22400924,2,96,1.0,0.625,377,281
22400924,2,19,-2.0,-6.315789473684211,276,257
22400924,2,101,-1.0,-0.594059405940594,250,149
22400924,2,18,2.0,6.666666666666666,136,118
22400924,2,81,4.0,2.962962962962963,118,37
22400924,2,37,-2.0,-3.2432432432432434,37,0
22400924,3,183,-1.0,-0.32786885245901637,720,537
22400924,3,85,-3.0,-2.1176470588235294,537,452
22400924,3,52,3.0,3.4615384615384617,446,394
22400924,3,56,0.0,0.0,394,338
22400924,3,87,1.0,0.6896551724137931,338,251
22400924,3,89,6.0,4.044943820224719,251,162
22400924,3,87,0.0,0.0,155,68
22400924,3,60,4.0,4.0,60,0
22400924,4,191,4.0,1.256544502617801,720,529
22400924,4,114,-4.0,-2.1052631578947367,526,412
22400924,4,54,-3.0,-3.333333333333333,402,348
22400924,4,331,-4.0,-0.7250755287009063,342,11
22400924,4,1,1.0,60.0,9,8
22400924,4,8,-1.0,-7.5,8,0
22400925,1,330,6.0,1.0909090909090908,720,390
22400925,1,67,1.0,0.8955223880597015,374,307
22400925,1,77,-2.0,-1.5584415584415585,295,218
22400925,1,99,-1.0,-0.6060606060606061,211,112
22400925,1,62,1.0,0.967741935483871,112,50
22400925,1,50,1.0,1.2,50,0
22400925,2,97,1.0,0.6185567010309279,720,623
22400925,2,52,2.0,2.307692307692308,601,549
22400925,2,51,0.0,0.0,535,484
22400925,2,29,2.0,4.137931034482759,484,455
22400925,2,34,0.0,0.0,455,421
22400925,2,17,0.0,0.0,421,404
22400925,2,92,-2.0,-1.3043478260869565,396,304
22400925,2,112,-1.0,-0.5357142857142857,300,188
22400925,2,28,1.0,2.142857142857143,172,144
22400925,2,84,0.0,0.0,132,48
22400925,2,32,3.0,5.625,32,0
22400925,3,395,1.0,0.1518987341772152,720,325
22400925,3,78,-1.0,-0.7692307692307692,325,247
22400925,3,88,1.0,0.6818181818181819,247,159
22400925,3,60,2.0,2.0,60,0
22400925,4,259,4.0,0.9266409266409267,720,461
22400925,4,124,5.0,2.4193548387096775,461,337
22400925,4,16,0.0,0.0,335,319
22400925,4,145,-4.0,-1.6551724137931034,299,154
22400925,4,138,-1.0,-0.43478260869565216,138,0
22400926,1,215,-4.0,-1.1162790697674418,720,505
22400926,1,185,2.0,0.6486486486486487,505,320
22400926,1,11,1.0,5.454545454545455,320,309
22400926,1,85,0.0,0.0,309,224
22400926,1,85,-1.0,-0.7058823529411764,224,139
22400926,1,139,1.0,0.43165467625899284,139,0
22400926,2,149,1.0,0.40268456375838924,720,571
22400926,2,37,-5.0,-8.108108108108109,571,534
22400926,2,40,2.0,3.0,534,494
22400926,2,112,3.0,1.607142857142857,494,382
22400926,2,35,1.0,1.7142857142857142,360,325
22400926,2,76,-4.0,-3.1578947368421053,325,249
22400926,2,44,-4.0,-5.454545454545455,242,198
22400926,2,198,6.0,1.8181818181818183,198,0
22400926,3,215,-8.0,-2.2325581395348837,720,505
22400926,3,55,-4.0,-4.363636363636363,498,443
22400926,3,135,2.0,0.888888888888889,427,292
22400926,3,28,-2.0,-4.285714285714286,292,264
22400926,3,62,0.0,0.0,264,202
22400926,3,60,-1.0,-1.0,193,133
22400926,3,112,5.0,2.678571428571429,133,21
22400926,3,2,0.0,0.0,2,0
22400926,4,210,3.0,0.8571428571428571,720,510
22400926,4,88,0.0,0.0,497,409
22400926,4,11,1.0,5.454545454545455,353,342
22400926,4,50,2.0,2.4,342,292
22400926,4,25,-1.0,-2.4,292,267
22400926,4,234,2.0,0.5128205128205129,259,25
22400926,4,20,-4.0,-12.0,20,0
22400927,1,445,2.0,0.26966292134831465,720,275
22400927,1,67,0.0,0.0,260,193
22400927,1,55,0.0,0.0,193,138
22400927,1,138,-2.0,-0.8695652173913043,138,0
22400927,2,169,1.0,0.35502958579881655,720,551
22400927,2,98,1.0,0.6122448979591836,551,453
22400927,2,24,0.0,0.0,439,415
22400927,2,147,2.0,0.8163265306122449,415,268
22400927,2,27,-3.0,-6.666666666666666,268,241
22400927,2,101,5.0,2.9702970297029703,231,130
22400927,2,124,0.0,0.0,124,0
22400927,3,379,0.0,0.0,720,341
22400927,3,123,-2.0,-0.9756097560975611,341,218
22400927,3,5,0.0,0.0,204,199
22400927,3,123,-2.0,-0.9756097560975611,199,76
22400927,3,76,0.0,0.0,76,0
22400927,4,53,2.0,2.2641509433962264,720,667
22400927,4,21,0.0,0.0,654,633
22400927,4,98,-4.0,-2.4489795918367343,619,521
22400927,4,78,4.0,3.0769230769230766,500,422
22400927,4,101,-4.0,-2.376237623762376,414,313
22400927,4,60,-4.0,-4.0,313,253
22400927,4,18,1.0,3.333333333333333,230,212
22400927,4,74,-3.0,-2.4324324324324325,212,138
22400927,4,98,3.0,1.836734693877551,120,22
22400927,4,1,0.0,0.0,1,0
22400927,5,64,-2.0,-1.875,300,236
22400927,5,2,0.0,0.0,236,234
22400927,5,10,0.0,0.0,223,213
22400927,5,80,-1.0,-0.75,199,119
22400927,5,24,0.0,0.0,108,84
22400927,5,24,0.0,0.0,84,60
22400927,5,39,-2.0,-3.0769230769230766,60,21
22400927,5,21,2.0,5.7142857142857135,21,0
22400928,1,303,-3.0,-0.594059405940594,720,417
22400928,1,80,3.0,2.25,405,325
22400928,1,99,-3.0,-1.8181818181818183,318,219
22400928,1,100,2.0,1.2,219,119
22400928,1,105,1.0,0.5714285714285715,105,0
22400928,2,197,5.0,1.5228426395939085,720,523
22400928,2,32,-2.0,-3.75,509,477
22400928,2,152,6.0,2.3684210526315788,469,317
22400928,2,52,0.0,0.0,317,265
22400928,2,78,3.0,2.307692307692308,265,187
22400928,2,109,-3.0,-1.651376146788991,182,73
22400928,2,41,1.0,1.4634146341463414,55,14
22400928,3,294,8.0,1.6326530612244898,720,426
22400928,3,37,0.0,0.0,404,367
22400928,3,70,2.0,1.7142857142857142,362,292
22400928,3,43,-2.0,-2.7906976744186047,292,249
22400928,3,22,0.0,0.0,237,215
22400928,3,94,5.0,3.1914893617021276,207,113
22400928,3,108,-2.0,-1.1111111111111112,108,0
22400928,4,63,2.0,1.9047619047619047,720,657
22400928,4,161,1.0,0.37267080745341613,652,491
22400928,4,53,0.0,0.0,491,438
22400928,4,17,0.0,0.0,426,409
22400928,4,362,-5.0,-0.8287292817679558,397,35
22400928,4,6,-2.0,-20.0,35,29
22400929,1,335,0.0,0.0,720,385
22400929,1,208,-1.0,-0.2884615384615385,373,165
22400929,1,148,2.0,0.8108108108108109,159,11
22400929,2,157,1.0,0.3821656050955414,720,563
22400929,2,112,0.0,0.0,553,441
22400929,2,106,3.0,1.6981132075471699,423,317
22400929,2,102,1.0,0.5882352941176471,298,196
22400929,2,196,1.0,0.3061224489795918,196,0
22400929,3,294,4.0,0.8163265306122449,720,426
22400929,3,41,0.0,0.0,417,376
22400929,3,57,3.0,3.1578947368421053,376,319
22400929,3,308,6.0,1.1688311688311688,308,0
22400929,4,222,-7.0,-1.8918918918918917,720,498
22400929,4,2,-2.0,-60.0,489,487
22400929,4,48,-3.0,-3.75,471,423
22400929,4,115,-3.0,-1.5652173913043477,423,308
22400929,4,41,-4.0,-5.853658536585366,308,267
22400929,4,231,1.0,0.2597402597402597,267,36
22400929,4,6,1.0,10.0,21,15
22400929,4,13,0.0,0.0,13,0
22400930,1,397,-3.0,-0.4534005037783375,720,323
22400930,1,9,0.0,0.0,267,258
22400930,1,83,-3.0,-2.1686746987951806,239,156
22400930,1,32,-2.0,-3.75,137,105
22400930,1,71,3.0,2.535211267605634,105,34
22400930,1,28,-2.0,-4.285714285714286,28,0
22400930,2,70,-3.0,-2.5714285714285716,720,650
22400930,2,84,3.0,2.142857142857143,650,566
22400930,2,31,1.0,1.935483870967742,566,535
22400930,2,120,3.0,1.5,535,415
22400930,2,61,0.0,0.0,409,348
22400930,2,125,1.0,0.48,340,215
22400930,2,38,3.0,4.7368421052631575,204,166
22400930,3,217,7.0,1.935483870967742,720,503
22400930,3,223,-6.0,-1.6143497757847534,626,403
22400930,3,50,3.0,3.5999999999999996,403,353
22400930,3,31,-2.0,-3.870967741935484,353,322
22400930,3,44,0.0,0.0,310,266
22400930,3,28,0.0,0.0,259,231
22400930,3,194,0.0,0.0,231,37
22400930,3,37,3.0,4.864864864864865,37,0
22400930,4,188,0.0,0.0,720,532
22400930,4,102,5.0,2.941176470588235,522,420
22400930,4,3,0.0,0.0,407,404
22400930,4,72,1.0,0.8333333333333333,386,314
22400930,4,119,-2.0,-1.0084033613445378,310,191
22400930,4,89,1.0,0.6741573033707865,171,82
22400930,4,69,1.0,0.8695652173913043,82,13
22400930,4,3,-3.0,-60.0,13,10
22400930,4,6,-2.0,-20.0,9,3
22400930,4,2,0.0,0.0,2,0
22400931,1,350,2.0,0.34285714285714286,720,370
22400931,1,42,2.0,2.8571428571428568,370,328
22400931,1,26,-2.0,-4.615384615384616,312,286
22400931,1,51,4.0,4.705882352941177,284,233
22400931,1,99,3.0,1.8181818181818183,213,114
22400931,1,69,2.0,1.7391304347826086,114,45
22400931,1,45,2.0,2.666666666666667,45,0
22400931,2,113,4.0,2.1238938053097343,720,607
22400931,2,105,-1.0,-0.5714285714285715,603,498
22400931,2,93,2.0,1.2903225806451615,490,397
22400931,2,16,-1.0,-3.75,389,373
22400931,2,12,0.0,0.0,373,361
22400931,2,83,-5.0,-3.6144578313253013,359,276
22400931,2,20,-1.0,-3.0,260,240
22400931,2,109,3.0,1.651376146788991,240,131
22400931,2,124,-5.0,-2.4193548387096775,124,0
22400931,3,388,-4.0,-0.6185567010309279,720,332
22400931,3,31,-2.0,-3.870967741935484,332,301
22400931,3,127,6.0,2.8346456692913384,301,174
22400931,3,40,0.0,0.0,174,134
22400931,3,31,-2.0,-3.870967741935484,134,103
22400931,3,102,2.0,1.1764705882352942,103,1
22400931,4,126,1.0,0.47619047619047616,720,594
22400931,4,111,2.0,1.0810810810810811,579,468
22400931,4,24,0.0,0.0,468,444
22400931,4,31,1.0,1.935483870967742,438,407
22400931,4,76,-8.0,-6.315789473684211,407,331
22400931,4,26,-1.0,-2.307692307692308,320,294
22400931,4,26,3.0,6.923076923076923,294,268
22400931,4,258,-4.0,-0.9302325581395349,268,10
22400931,4,1,0.0,0.0,6,5
22400931,4,1,0.0,0.0,1,0
22400932,1,219,-3.0,-0.821917808219178,720,501
22400932,1,76,-2.0,-1.5789473684210527,493,417
22400932,1,105,7.0,4.0,417,312
22400932,1,73,0.0,0.0,312,239
22400932,1,8,0.0,0.0,239,231
22400932,1,3,0.0,0.0,216,213
22400932,1,104,0.0,0.0,195,91
22400932,1,31,0.0,0.0,91,60
22400932,2,214,5.0,1.4018691588785046,720,506
22400932,2,96,-3.0,-1.875,506,410
22400932,2,75,0.0,0.0,410,335
22400932,2,43,3.0,4.186046511627907,321,278
22400932,2,77,-2.0,-1.5584415584415585,278,201
22400932,2,76,0.0,0.0,201,125
22400932,2,120,-5.0,-2.5,120,0
22400932,3,127,5.0,2.3622047244094486,720,593
22400932,3,72,3.0,2.5,593,521
22400932,3,75,-5.0,-4.0,506,431
22400932,3,94,4.0,2.5531914893617023,413,319
22400932,3,82,6.0,4.390243902439024,312,230
22400932,3,109,2.0,1.1009174311926606,212,103
22400932,3,59,2.0,2.0338983050847457,92,33
22400932,3,33,0.0,0.0,33,0
22400932,4,84,2.0,1.4285714285714284,720,636
22400932,4,122,-4.0,-1.9672131147540985,636,514
22400932,4,31,-3.0,-5.806451612903226,514,483
22400932,4,105,2.0,1.142857142857143,483,378
22400932,4,44,-5.0,-6.818181818181818,370,326
22400932,4,39,6.0,9.230769230769232,326,287
22400932,4,271,1.0,0.22140221402214022,271,0
22400933,1,245,-4.0,-0.979591836734694,720,475
22400933,1,13,-2.0,-9.230769230769232,475,462
22400933,1,105,4.0,2.285714285714286,462,357
22400933,1,89,1.0,0.6741573033707865,357,268
22400933,1,20,0.0,0.0,264,244
22400933,1,7,0.0,0.0,235,228
22400933,1,175,-3.0,-1.0285714285714287,214,39
22400933,1,39,0.0,0.0,39,0
22400933,2,82,2.0,1.4634146341463414,720,638
22400933,2,58,-4.0,-4.137931034482759,638,580
22400933,2,16,0.0,0.0,565,549
22400933,2,94,4.0,2.5531914893617023,549,455
22400933,2,8,0.0,0.0,444,436
22400933,2,39,2.0,3.0769230769230766,429,390
22400933,2,70,3.0,2.5714285714285716,390,320
22400933,2,99,2.0,1.2121212121212122,206,107
22400933,3,185,-5.0,-1.6216216216216217,720,535
22400933,3,98,1.0,0.6122448979591836,526,428
22400933,3,65,7.0,6.461538461538462,419,354
22400933,3,82,3.0,2.195121951219512,343,261
22400933,3,100,-1.0,-0.6,261,161
22400933,3,37,2.0,3.2432432432432434,161,124
22400933,3,113,0.0,0.0,113,0
22400933,4,65,-4.0,-3.6923076923076925,720,655
22400933,4,114,0.0,0.0,638,524
22400933,4,61,2.0,1.9672131147540985,513,452
22400933,4,110,-1.0,-0.5454545454545454,440,330
22400933,4,107,5.0,2.803738317757009,317,210
22400933,4,36,2.0,3.333333333333333,210,174
22400933,4,60,1.0,1.0,170,110
22400933,4,94,-5.0,-3.1914893617021276,94,0
22400934,1,320,-7.0,-1.3125,720,400
22400934,1,207,1.0,0.2898550724637681,388,181
22400934,1,53,2.0,2.2641509433962264,167,114
22400934,1,107,6.0,3.364485981308411,107,0
22400934,2,87,0.0,0.0,720,633
22400934,2,60,-8.0,-8.0,633,573
22400934,2,28,0.0,0.0,554,526
22400934,2,31,0.0,0.0,495,464
22400934,2,106,1.0,0.5660377358490566,464,358
22400934,2,43,1.0,1.3953488372093024,358,315
22400934,2,78,4.0,3.0769230769230766,315,237
22400934,2,98,4.0,2.4489795918367343,232,134
22400934,2,121,0.0,0.0,121,0
22400934,3,312,5.0,0.9615384615384615,720,408
22400934,3,56,-1.0,-1.0714285714285714,398,342
22400934,3,25,0.0,0.0,331,306
22400934,3,47,3.0,3.829787234042553,304,257
22400934,3,26,2.0,4.615384615384616,183,157
22400934,3,16,1.0,3.75,157,141
22400934,3,137,2.0,0.875912408759124,141,4
22400934,4,202,5.0,1.4851485148514851,720,518
22400934,4,102,-3.0,-1.7647058823529411,509,407
22400934,4,37,-1.0,-1.6216216216216217,407,370
22400934,4,42,-1.0,-1.4285714285714284,370,328
22400934,4,134,6.0,2.6865671641791042,315,181
22400934,4,24,0.0,0.0,171,147
22400934,4,1,0.0,0.0,134,133
22400934,4,130,-5.0,-2.307692307692308,130,0
22400935,1,187,-2.0,-0.6417112299465241,720,533
22400935,1,158,-3.0,-1.139240506329114,522,364
22400935,1,25,-1.0,-2.4,359,334
22400935,1,68,-9.0,-7.9411764705882355,334,266
22400935,1,51,3.0,3.5294117647058822,256,205
22400935,1,48,1.0,1.25,198,150
22400935,1,118,0.0,0.0,150,32
22400935,1,32,0.0,0.0,32,0
22400935,2,164,3.0,1.097560975609756,720,556
22400935,2,65,-2.0,-1.8461538461538463,542,477
22400935,2,84,2.0,1.4285714285714284,474,390
22400935,2,15,2.0,8.0,374,359
22400935,2,79,2.0,1.5189873417721518,350,271
22400935,2,47,3.0,3.829787234042553,271,224
22400935,2,17,0.0,0.0,207,190
22400935,2,78,-1.0,-0.7692307692307692,182,104
22400935,2,36,2.0,3.333333333333333,104,68
22400935,2,41,2.0,2.926829268292683,68,27
22400935,2,24,0.0,0.0,27,3
22400935,3,181,1.0,0.3314917127071823,720,539
22400935,3,139,7.0,3.0215827338129495,528,389
22400935,3,68,-6.0,-5.294117647058824,377,309
22400935,3,10,0.0,0.0,309,299
22400935,3,105,3.0,1.7142857142857142,290,185
22400935,3,10,0.0,0.0,175,165
22400935,3,158,-4.0,-1.5189873417721518,158,0
22400935,4,78,-6.0,-4.615384615384616,720,642
22400935,4,117,4.0,2.0512820512820515,642,525
22400935,4,42,3.0,4.285714285714286,525,483
22400935,4,160,-2.0,-0.75,483,323
22400935,4,23,0.0,0.0,323,300
22400935,4,270,-1.0,-0.22222222222222224,287,17
22400935,4,1,0.0,0.0,9,8
22400935,4,1,0.0,0.0,1,0
22400936,1,383,-3.0,-0.46997389033942555,720,337
22400936,1,20,2.0,6.0,337,317
22400936,1,61,1.0,0.9836065573770493,317,256
22400936,1,84,3.0,2.142857142857143,256,172
22400936,1,88,3.0,2.0454545454545454,167,79
22400936,1,60,-7.0,-7.0,60,0
22400936,2,267,0.0,0.0,720,453
22400936,2,31,0.0,0.0,398,367
22400936,2,57,5.0,5.263157894736842,367,310
22400936,2,86,0.0,0.0,310,224
22400936,2,120,5.0,2.5,214,94
22400936,2,84,-2.0,-1.4285714285714284,94,10
22400936,3,343,0.0,0.0,720,377
22400936,3,181,0.0,0.0,377,196
22400936,3,101,-1.0,-0.594059405940594,196,95
22400936,3,85,-5.0,-3.5294117647058822,85,0
22400936,4,191,-8.0,-2.513089005235602,720,529
22400936,4,129,-5.0,-2.3255813953488373,529,400
22400936,4,69,1.0,0.8695652173913043,394,325
22400936,4,43,0.0,0.0,312,269
22400936,4,67,-1.0,-0.8955223880597015,254,187
22400936,4,65,-2.0,-1.8461538461538463,171,106
22400936,4,97,3.0,1.8556701030927836,97,0
22400937,1,229,-1.0,-0.26200873362445415,720,491
22400937,1,145,4.0,1.6551724137931034,473,328
22400937,1,133,2.0,0.9022556390977443,328,195
22400937,1,21,-3.0,-8.571428571428571,176,155
22400937,1,138,1.0,0.43478260869565216,138,0
22400937,2,74,-3.0,-2.4324324324324325,720,646
22400937,2,139,0.0,0.0,646,507
22400937,2,56,4.0,4.285714285714286,494,438
22400937,2,23,3.0,7.826086956521739,424,401
22400937,2,64,0.0,0.0,401,337
22400937,2,79,0.0,0.0,324,245
22400937,2,47,-2.0,-2.5531914893617023,230,183
22400937,2,61,0.0,0.0,183,122
22400937,2,77,4.0,3.116883116883117,122,45
22400937,3,179,-6.0,-2.011173184357542,720,541
22400937,3,57,2.0,2.1052631578947367,534,477
22400937,3,98,6.0,3.673469387755102,477,379
22400937,3,35,0.0,0.0,365,330
22400937,3,68,1.0,0.8823529411764706,330,262
22400937,3,19,-1.0,-3.1578947368421053,255,236
22400937,3,72,1.0,0.8333333333333333,236,164
22400937,3,163,-5.0,-1.8404907975460123,163,0
22400937,4,171,-5.0,-1.7543859649122806,720,549
22400937,4,100,-2.0,-1.2,549,449
22400937,4,73,2.0,1.643835616438356,433,360
22400937,4,49,2.0,2.4489795918367343,345,296
22400937,4,26,-2.0,-4.615384615384616,278,252
22400937,4,94,-1.0,-0.6382978723404256,233,139
22400937,4,133,2.0,0.9022556390977443,139,6
22400937,4,6,0.0,0.0,6,0
22400938,1,267,7.0,1.5730337078651686,720,453
22400938,1,48,-5.0,-6.25,453,405
22400938,1,110,6.0,3.2727272727272725,405,295
22400938,1,29,2.0,4.137931034482759,279,250
22400938,1,84,1.0,0.7142857142857142,250,166
22400938,1,81,3.0,2.2222222222222223,158,77
22400938,1,62,2.0,1.935483870967742,62,0
22400938,2,191,0.0,0.0,720,529
22400938,2,97,2.0,1.2371134020618557,529,432
22400938,2,149,2.0,0.8053691275167785,416,267
22400938,2,93,-1.0,-0.6451612903225807,267,174
22400938,2,129,2.0,0.9302325581395349,174,45
22400938,2,29,2.0,4.137931034482759,29,0
22400938,3,312,-13.0,-2.5,720,408
22400938,3,70,0.0,0.0,402,332
22400938,3,114,1.0,0.5263157894736842,311,197
22400938,3,50,1.0,1.2,197,147
22400938,3,137,0.0,0.0,137,0
22400938,4,185,5.0,1.6216216216216217,720,535
22400938,4,46,-3.0,-3.9130434782608696,528,482
22400938,4,173,0.0,0.0,473,300
22400938,4,58,0.0,0.0,280,222
22400938,4,40,-1.0,-1.5,214,174
22400938,4,125,-4.0,-1.92,174,49
22400938,4,49,1.0,1.2244897959183672,49,0
22400939,1,263,-3.0,-0.6844106463878328,720,457
22400939,1,113,-1.0,-0.5309734513274336,453,340
22400939,1,73,-1.0,-0.821917808219178,332,259
22400939,1,24,-2.0,-5.0,247,223
22400939,1,38,-1.0,-1.5789473684210527,213,175
22400939,1,175,-7.0,-2.4,175,0
22400939,2,36,-3.0,-5.0,720,684
22400939,2,183,2.0,0.6557377049180327,684,501
22400939,2,9,0.0,0.0,488,479
22400939,2,51,2.0,2.3529411764705883,471,420
22400939,2,11,2.0,10.90909090909091,420,409
22400939,2,161,-5.0,-1.8633540372670807,409,248
22400939,2,35,0.0,0.0,248,213
22400939,2,74,0.0,0.0,196,122
22400939,2,117,1.0,0.5128205128205129,122,5
22400939,2,5,0.0,0.0,5,0
22400939,3,189,-4.0,-1.2698412698412698,720,531
22400939,3,235,-2.0,-0.5106382978723404,506,271
22400939,3,7,-1.0,-8.571428571428571,225,218
22400939,3,26,-1.0,-2.307692307692308,218,192
22400939,3,126,0.0,0.0,192,66
22400939,3,1,0.0,0.0,207,206
22400939,4,123,2.0,0.9756097560975611,720,597
22400939,4,115,-1.0,-0.5217391304347826,581,466
22400939,4,113,-5.0,-2.6548672566371683,466,353
22400939,4,56,-6.0,-6.428571428571428,340,284
22400939,4,19,0.0,0.0,284,265
22400940,1,343,-6.0,-1.0495626822157436,720,377
22400940,1,67,2.0,1.791044776119403,360,293
22400940,1,69,4.0,3.4782608695652173,293,224
22400940,1,26,0.0,0.0,224,198
22400940,1,178,-2.0,-0.6741573033707865,178,0
22400940,2,152,-3.0,-1.1842105263157894,720,568
22400940,2,111,1.0,0.5405405405405406,556,445
22400940,2,94,-6.0,-3.829787234042553,429,335
22400940,2,142,-3.0,-1.267605633802817,322,180
22400940,2,86,-3.0,-2.0930232558139537,170,84
22400940,3,341,2.0,0.3519061583577713,720,379
22400940,3,32,2.0,3.75,365,333
22400940,3,33,2.0,3.6363636363636367,323,290
22400940,3,79,-2.0,-1.5189873417721518,274,195
22400940,3,59,2.0,2.0338983050847457,195,136
22400940,3,110,0.0,0.0,110,0
22400940,4,201,4.0,1.1940298507462686,720,519
22400940,4,45,2.0,2.666666666666667,519,474
22400940,4,115,4.0,2.0869565217391304,474,359
22400940,4,55,-1.0,-1.0909090909090908,335,280
22400940,4,247,2.0,0.4858299595141701,280,33
22400941,1,349,2.0,0.3438395415472779,720,371
22400941,1,90,1.0,0.6666666666666667,371,281
22400941,1,23,2.0,5.217391304347826,281,258
22400941,1,101,-1.0,-0.594059405940594,248,147
22400941,1,141,5.0,2.127659574468085,141,0
22400941,2,232,-1.0,-0.25862068965517243,720,488
22400941,2,181,-6.0,-1.9889502762430937,478,297
22400941,2,178,1.0,0.33707865168539325,291,113
22400941,2,100,6.0,3.5999999999999996,108,8
22400941,3,407,3.0,0.44226044226044225,720,313
22400941,3,40,3.0,4.5,306,266
22400941,3,46,-5.0,-6.521739130434782,251,205
22400941,3,117,-1.0,-0.5128205128205129,205,88
22400941,4,70,1.0,0.8571428571428571,720,650
22400941,4,186,-8.0,-2.580645161290323,643,457
22400941,4,136,-2.0,-0.8823529411764706,438,302
22400941,4,48,4.0,5.0,302,254
22400941,4,42,0.0,0.0,235,193
22400941,4,46,3.0,3.9130434782608696,193,147
22400941,4,136,0.0,0.0,136,0
22400942,1,340,1.0,0.1764705882352941,720,380
22400942,1,61,-1.0,-0.9836065573770493,367,306
22400942,1,12,0.0,0.0,306,294
22400942,1,102,3.0,1.7647058823529411,269,167
22400942,1,19,0.0,0.0,167,148
22400942,1,96,-3.0,-1.875,135,39
22400942,1,39,5.0,7.692307692307692,39,0
22400942,2,178,1.0,0.33707865168539325,720,542
22400942,2,12,0.0,0.0,536,524
22400942,2,47,5.0,6.382978723404255,517,470
22400942,2,22,3.0,8.181818181818182,469,447
22400942,2,37,-4.0,-6.486486486486487,434,397
22400942,2,62,-3.0,-2.903225806451613,397,335
22400942,2,57,-4.0,-4.2105263157894735,323,266
22400942,2,255,3.0,0.7058823529411764,259,4
22400942,3,258,1.0,0.23255813953488372,720,462
22400942,3,30,-5.0,-10.0,447,417
22400942,3,72,4.0,3.333333333333333,402,330
22400942,3,68,-2.0,-1.7647058823529411,330,262
22400942,3,84,-4.0,-2.8571428571428568,186,102
22400942,3,102,0.0,0.0,102,0
22400942,4,175,3.0,1.0285714285714287,720,545
22400942,4,31,2.0,3.870967741935484,528,497
22400942,4,48,-3.0,-3.75,492,444
22400942,4,25,0.0,0.0,421,396
22400942,4,117,-3.0,-1.5384615384615383,385,268
22400942,4,70,1.0,0.8571428571428571,257,187
22400942,4,118,-5.0,-2.542372881355932,124,6
22400942,4,3,0.0,0.0,3,0
22400943,1,312,4.0,0.7692307692307692,720,408
22400943,1,164,-2.0,-0.7317073170731707,404,240
22400943,1,45,0.0,0.0,224,179
22400943,1,47,1.0,1.2765957446808511,162,115
22400943,1,115,-2.0,-1.0434782608695652,115,0
22400943,2,153,11.0,4.313725490196078,720,567
22400943,2,40,0.0,0.0,548,508
22400943,2,107,-7.0,-3.9252336448598126,495,388
22400943,2,226,-1.0,-0.2654867256637168,372,146
22400943,2,71,-1.0,-0.8450704225352113,137,66
22400943,2,58,-4.0,-4.137931034482759,66,8
22400943,3,348,-5.0,-0.8620689655172413,720,372
22400943,3,39,-3.0,-4.615384615384616,372,333
22400943,3,73,0.0,0.0,321,248
22400943,3,126,-1.0,-0.47619047619047616,230,104
22400943,4,104,7.0,4.038461538461538,720,616
22400943,4,158,-3.0,-1.139240506329114,603,445
22400943,4,105,-3.0,-1.7142857142857142,432,327
22400943,4,29,-2.0,-4.137931034482759,312,283
22400943,4,44,3.0,4.090909090909091,265,221
22400943,4,179,0.0,0.0,203,24
22400943,4,5,-2.0,-24.0,21,16
22400943,4,2,1.0,30.0,16,14
22400943,4,14,0.0,0.0,14,0
22400944,1,238,3.0,0.7563025210084033,720,482
22400944,1,71,-3.0,-2.535211267605634,476,405
22400944,1,155,2.0,0.7741935483870968,405,250
22400944,1,41,0.0,0.0,239,198
22400944,1,194,1.0,0.30927835051546393,194,0
22400944,2,125,1.0,0.48,720,595
22400944,2,51,-3.0,-3.5294117647058822,578,527
22400944,2,31,-2.0,-3.870967741935484,527,496
22400944,2,154,-2.0,-0.7792207792207793,479,325
22400944,2,65,-1.0,-0.9230769230769231,325,260
22400944,2,89,-2.0,-1.348314606741573,260,171
22400944,2,15,-1.0,-4.0,171,156
22400944,2,51,2.0,2.3529411764705883,156,105
22400944,2,60,-1.0,-1.0,105,45
22400944,2,43,0.0,0.0,43,0
22400944,3,90,8.0,5.333333333333334,720,630
22400944,3,51,0.0,0.0,608,557
22400944,3,116,6.0,3.103448275862069,557,441
22400944,3,64,0.0,0.0,431,367
22400944,3,9,0.0,0.0,358,349
22400944,3,42,-2.0,-2.8571428571428568,349,307
22400944,3,58,-2.0,-2.0689655172413794,307,249
22400944,3,9,-2.0,-13.333333333333332,239,230
22400944,3,16,-1.0,-3.75,215,199
22400944,3,110,-1.0,-0.5454545454545454,199,89
22400944,3,68,3.0,2.647058823529412,68,0
22400944,4,131,3.0,1.3740458015267176,720,589
22400944,4,73,-5.0,-4.10958904109589,584,511
22400944,4,113,-2.0,-1.0619469026548671,491,378
22400944,4,34,1.0,1.7647058823529411,378,344
22400944,4,241,-6.0,-1.4937759336099583,344,103
22400944,4,45,-1.0,-1.3333333333333335,103,58
22400945,1,341,-4.0,-0.7038123167155426,720,379
22400945,1,43,-2.0,-2.7906976744186047,377,334
22400945,1,13,1.0,4.615384615384616,322,309
22400945,1,90,-1.0,-0.6666666666666667,304,214
22400945,1,30,0.0,0.0,210,180
22400945,1,167,3.0,1.0778443113772456,167,0
22400945,2,139,5.0,2.158273381294964,720,581
22400945,2,41,-3.0,-4.390243902439024,575,534
22400945,2,54,3.0,3.333333333333333,534,480
22400945,2,69,-2.0,-1.7391304347826086,464,395
22400945,2,135,2.0,0.888888888888889,385,250
22400945,2,15,-2.0,-8.0,232,217
22400945,2,63,-3.0,-2.8571428571428568,201,138
22400945,2,118,-1.0,-0.5084745762711864,118,0
22400945,3,84,3.0,2.142857142857143,720,636
22400945,3,133,2.0,0.9022556390977443,635,502
22400945,3,74,1.0,0.8108108108108109,502,428
22400945,3,26,0.0,0.0,428,402
22400945,3,46,3.0,3.9130434782608696,383,337
22400945,3,122,-1.0,-0.49180327868852464,314,192
22400945,3,82,0.0,0.0,192,110
22400945,3,48,-4.0,-5.0,110,62
22400945,4,57,-4.0,-4.2105263157894735,720,663
22400945,4,116,2.0,1.0344827586206897,650,534
22400945,4,26,-1.0,-2.307692307692308,499,473
22400945,4,14,1.0,4.285714285714286,469,455
22400945,4,46,-2.0,-2.608695652173913,455,409
22400945,4,60,0.0,0.0,409,349
22400945,4,8,0.0,0.0,349,341
22400945,4,161,3.0,1.1180124223602486,329,168
22400945,4,108,2.0,1.1111111111111112,168,60
22400945,4,60,-1.0,-1.0,60,0
22400946,1,347,0.0,0.0,720,373
22400946,1,80,2.0,1.5,369,289
22400946,1,58,-2.0,-2.0689655172413794,289,231
22400946,1,214,0.0,0.0,216,2
22400946,2,136,1.0,0.4411764705882353,720,584
22400946,2,140,-4.0,-1.7142857142857142,573,433
22400946,2,80,2.0,1.5,425,345
22400946,2,12,3.0,15.0,334,322
22400946,2,68,2.0,1.7647058823529411,309,241
22400946,2,60,3.0,3.0,229,169
22400946,2,70,2.0,1.7142857142857142,123,53
22400946,2,53,-2.0,-2.2641509433962264,53,0
22400946,3,394,-4.0,-0.6091370558375634,720,326
22400946,3,62,0.0,0.0,312,250
22400946,3,39,2.0,3.0769230769230766,234,195
22400946,3,171,6.0,2.1052631578947367,187,16
22400946,3,13,0.0,0.0,16,3
22400946,3,1,0.0,0.0,1,0
22400946,4,71,0.0,0.0,720,649
22400946,4,40,-2.0,-3.0,642,602
22400946,4,23,0.0,0.0,602,579
22400946,4,32,0.0,0.0,562,530
22400946,4,102,-1.0,-0.5882352941176471,510,408
22400946,4,48,-1.0,-1.25,408,360
22400946,4,106,0.0,0.0,360,254
22400946,4,36,2.0,3.333333333333333,252,216
22400946,4,170,-3.0,-1.0588235294117647,216,46
22400946,4,24,0.0,0.0,46,22
22400946,4,8,1.0,7.5,22,14
22400946,4,14,1.0,4.285714285714286,14,0
22400947,1,316,-1.0,-0.18987341772151897,720,404
22400947,1,7,0.0,0.0,391,384
22400947,1,97,3.0,1.8556701030927836,372,275
22400947,1,70,2.0,1.7142857142857142,275,205
22400947,1,82,-2.0,-1.4634146341463414,203,121
22400947,1,25,0.0,0.0,121,96
22400947,1,83,1.0,0.7228915662650602,83,0
22400947,2,84,-4.0,-2.8571428571428568,720,636
22400947,2,95,2.0,1.263157894736842,628,533
22400947,2,65,4.0,3.6923076923076925,526,461
22400947,2,11,-1.0,-5.454545454545455,461,450
22400947,2,162,12.0,4.444444444444445,450,288
22400947,2,128,-4.0,-1.875,265,137
22400947,2,135,-5.0,-2.2222222222222223,135,0
22400947,3,311,3.0,0.5787781350482315,720,409
22400947,3,30,-4.0,-8.0,395,365
22400947,3,82,1.0,0.7317073170731707,358,276
22400947,3,7,-1.0,-8.571428571428571,271,264
22400947,3,214,-9.0,-2.5233644859813085,264,50
22400947,3,4,0.0,0.0,4,0
22400947,4,120,5.0,2.5,720,600
22400947,4,35,2.0,3.4285714285714284,590,555
22400947,4,189,0.0,0.0,533,344
22400947,4,76,0.0,0.0,344,268
22400947,4,35,2.0,3.4285714285714284,255,220
22400947,4,32,3.0,5.625,212,180
22400947,4,29,0.0,0.0,177,148
22400947,4,127,1.0,0.47244094488188976,127,0
22400948,1,339,-9.0,-1.592920353982301,720,381
22400948,1,87,0.0,0.0,381,294
22400948,1,46,-2.0,-2.608695652173913,294,248
22400948,1,21,-2.0,-5.7142857142857135,241,220
22400948,1,62,1.0,0.967741935483871,199,137
22400948,1,103,3.0,1.7475728155339807,137,34
22400948,1,20,-2.0,-6.0,20,0
22400948,2,162,3.0,1.1111111111111112,720,558
22400948,2,95,2.0,1.263157894736842,558,463
22400948,2,89,-4.0,-2.696629213483146,446,357
22400948,2,218,2.0,0.5504587155963303,337,119
22400948,2,119,0.0,0.0,119,0
22400948,3,234,-4.0,-1.0256410256410258,720,486
22400948,3,55,4.0,4.363636363636363,479,424
22400948,3,157,-1.0,-0.3821656050955414,424,267
22400948,3,98,1.0,0.6122448979591836,256,158
22400948,3,36,2.0,3.333333333333333,158,122
22400948,3,122,-3.0,-1.4754098360655736,122,0
22400948,4,99,-2.0,-1.2121212121212122,720,621
22400948,4,131,-3.0,-1.3740458015267176,621,490
22400948,4,66,0.0,0.0,474,408
22400948,4,95,2.0,1.263157894736842,396,301
22400948,4,289,0.0,0.0,289,0
22400949,1,306,0.0,0.0,720,414
22400949,1,48,2.0,2.5,403,355
22400949,1,21,2.0,5.7142857142857135,344,323
22400949,1,32,-2.0,-3.75,311,279
22400949,1,35,-1.0,-1.7142857142857142,269,234
22400949,1,93,-5.0,-3.2258064516129035,234,141
22400949,1,141,9.0,3.829787234042553,141,0
22400949,2,129,0.0,0.0,720,591
22400949,2,88,-2.0,-1.3636363636363638,582,494
22400949,2,37,0.0,0.0,482,445
22400949,2,62,5.0,4.838709677419355,445,383
22400949,2,95,-4.0,-2.526315789473684,383,288
22400949,2,80,4.0,3.0,272,192
22400949,2,83,2.0,1.4457831325301205,180,97
22400949,2,55,2.0,2.1818181818181817,77,22
22400949,2,5,0.0,0.0,5,0
22400949,3,273,1.0,0.21978021978021978,720,447
22400949,3,45,3.0,4.0,428,383
22400949,3,59,1.0,1.0169491525423728,372,313
22400949,3,97,-1.0,-0.6185567010309279,313,216
22400949,3,109,3.0,1.651376146788991,216,107
22400949,3,17,0.0,0.0,107,90
22400949,4,66,0.0,0.0,720,654
22400949,4,30,0.0,0.0,648,618
22400949,4,159,5.0,1.8867924528301887,618,459
22400949,4,85,0.0,0.0,429,344
22400949,4,131,0.0,0.0,344,213
22400949,4,73,0.0,0.0,213,140
22400949,4,8,1.0,7.5,119,111
22400949,4,20,-1.0,-3.0,111,91
22400949,4,91,-6.0,-3.956043956043956,91,0
22400950,1,228,-2.0,-0.5263157894736842,720,492
22400950,1,93,-1.0,-0.6451612903225807,487,394
22400950,1,1,0.0,0.0,389,388
22400950,1,62,2.0,1.935483870967742,371,309
22400950,1,69,3.0,2.608695652173913,309,240
22400950,1,34,-1.0,-1.7647058823529411,234,200
22400950,1,150,1.0,0.4,200,50
22400950,2,134,7.0,3.134328358208955,720,586
22400950,2,64,1.0,0.9375,586,522
22400950,2,118,0.0,0.0,522,404
22400950,2,78,2.0,1.5384615384615383,389,311
22400950,2,131,-5.0,-2.290076335877863,311,180
22400950,2,48,0.0,0.0,161,113
22400950,2,84,4.0,2.8571428571428568,97,13
22400950,2,13,0.0,0.0,13,0
22400950,3,265,-3.0,-0.6792452830188679,720,455
22400950,3,60,-3.0,-3.0,444,384
22400950,3,33,1.0,1.8181818181818183,376,343
22400950,3,33,1.0,1.8181818181818183,343,310
22400950,3,16,0.0,0.0,310,294
22400950,3,82,-2.0,-1.4634146341463414,291,209
22400950,3,19,0.0,0.0,209,190
22400950,3,126,-5.0,-2.380952380952381,190,64
22400950,3,24,0.0,0.0,53,29
22400950,3,23,1.0,2.608695652173913,29,6
22400950,3,6,0.0,0.0,6,0
22400950,4,103,3.0,1.7475728155339807,720,617
22400950,4,150,-2.0,-0.8,607,457
22400950,4,131,-2.0,-0.916030534351145,457,326
22400950,4,114,-1.0,-0.5263157894736842,312,198
22400950,4,173,4.0,1.3872832369942196,184,11
22400951,1,307,8.0,1.5635179153094463,720,413
22400951,1,42,1.0,1.4285714285714284,399,357
22400951,1,21,-1.0,-2.8571428571428568,340,319
22400951,1,25,0.0,0.0,319,294
22400951,1,106,-2.0,-1.1320754716981132,289,183
22400951,1,50,-2.0,-2.4,183,133
22400951,1,106,-5.0,-2.8301886792452833,106,0
22400951,2,223,1.0,0.26905829596412556,720,497
22400951,2,1,0.0,0.0,475,474
22400951,2,41,-2.0,-2.926829268292683,465,424
22400951,2,65,1.0,0.9230769230769231,424,359
22400951,2,22,0.0,0.0,353,331
22400951,2,44,2.0,2.7272727272727275,331,287
22400951,2,30,1.0,2.0,276,246
22400951,2,186,4.0,1.2903225806451615,246,60
22400951,2,34,2.0,3.5294117647058822,59,25
22400951,2,25,0.0,0.0,25,0
22400951,3,204,5.0,1.4705882352941175,720,516
22400951,3,146,3.0,1.2328767123287672,516,370
22400951,3,24,-2.0,-5.0,346,322
22400951,3,136,3.0,1.323529411764706,312,176
22400951,3,58,0.0,0.0,135,77
22400951,3,77,2.0,1.5584415584415585,77,0
22400951,4,117,3.0,1.5384615384615383,720,603
22400951,4,139,0.0,0.0,603,464
22400951,4,22,-2.0,-5.454545454545455,441,419
22400951,4,79,2.0,1.5189873417721518,419,340
22400951,4,30,0.0,0.0,330,300
22400951,4,121,0.0,0.0,300,179
22400951,4,106,-3.0,-1.6981132075471699,106,0
22400952,1,349,-3.0,-0.5157593123209169,720,371
22400952,1,3,0.0,0.0,359,356
22400952,1,83,-6.0,-4.337349397590361,356,273
22400952,1,87,-1.0,-0.6896551724137931,257,170
22400952,1,26,4.0,9.230769230769232,153,127
22400952,1,111,-2.0,-1.0810810810810811,111,0
22400952,2,79,-3.0,-2.278481012658228,720,641
22400952,2,56,-3.0,-3.214285714285714,628,572
22400952,2,12,1.0,5.0,558,546
22400952,2,98,1.0,0.6122448979591836,539,441
22400952,2,18,0.0,0.0,426,408
22400952,2,37,2.0,3.2432432432432434,408,371
22400952,2,124,-5.0,-2.4193548387096775,351,227
22400952,2,52,-2.0,-2.307692307692308,217,165
22400952,2,165,3.0,1.0909090909090908,165,0
22400952,3,259,-1.0,-0.23166023166023167,720,461
22400952,3,49,-1.0,-1.2244897959183672,456,407
22400952,3,134,-1.0,-0.44776119402985076,399,265
22400952,3,11,1.0,5.454545454545455,257,246
22400952,3,90,-2.0,-1.3333333333333335,246,156
22400952,3,131,-2.0,-0.916030534351145,156,25
22400952,3,25,0.0,0.0,25,0
22400952,4,87,-4.0,-2.7586206896551726,720,633
22400952,4,76,-1.0,-0.7894736842105263,613,537
22400952,4,29,-3.0,-6.206896551724138,537,508
22400952,4,189,-6.0,-1.9047619047619047,494,305
22400952,4,18,2.0,6.666666666666666,305,287
22400952,4,83,6.0,4.337349397590361,270,187
22400952,4,187,-3.0,-0.9625668449197862,187,0
22400953,1,254,4.0,0.9448818897637795,720,466
22400953,1,80,-4.0,-3.0,459,379
22400953,1,225,-4.0,-1.0666666666666667,379,154
22400953,1,66,1.0,0.9090909090909092,154,88
22400953,1,82,-3.0,-2.195121951219512,82,0
22400953,2,226,4.0,1.0619469026548671,720,494
22400953,2,31,-2.0,-3.870967741935484,490,459
22400953,2,37,0.0,0.0,451,414
22400953,2,72,1.0,0.8333333333333333,414,342
22400953,2,141,0.0,0.0,331,190
22400953,2,98,-1.0,-0.6122448979591836,173,75
22400953,3,289,-6.0,-1.245674740484429,720,431
22400953,3,1,0.0,0.0,418,417
22400953,3,71,1.0,0.8450704225352113,410,339
22400953,3,34,3.0,5.294117647058824,339,305
22400953,3,83,4.0,2.891566265060241,288,205
22400953,3,149,1.0,0.40268456375838924,192,43
22400953,3,14,0.0,0.0,43,29
22400953,3,29,0.0,0.0,29,0
22400953,4,162,4.0,1.4814814814814814,720,558
22400953,4,108,3.0,1.6666666666666665,558,450
22400953,4,52,-3.0,-3.4615384615384617,442,390
22400953,4,78,4.0,3.0769230769230766,372,294
22400953,4,137,-5.0,-2.18978102189781,213,76
22400953,4,14,3.0,12.857142857142856,72,58
22400953,4,40,3.0,4.5,47,7
22400953,4,3,0.0,0.0,3,0
22400953,5,75,0.0,0.0,300,225
22400953,5,192,0.0,0.0,207,15
22400953,5,5,0.0,0.0,12,7
22400953,5,1,2.0,120.0,4,3
22400954,1,378,0.0,0.0,720,342
22400954,1,15,-2.0,-8.0,342,327
22400954,1,65,-4.0,-3.6923076923076925,327,262
22400954,1,61,5.0,4.918032786885245,252,191
22400954,2,160,-7.0,-2.625,720,560
22400954,2,35,0.0,0.0,546,511
22400954,2,83,0.0,0.0,509,426
22400954,2,3,2.0,40.0,406,403
22400954,2,31,3.0,5.806451612903226,403,372
22400954,2,48,1.0,1.25,355,307
22400954,2,135,-7.0,-3.111111111111111,307,172
22400954,2,6,1.0,10.0,172,166
22400954,2,27,0.0,0.0,166,139
22400954,2,98,-3.0,-1.836734693877551,105,7
22400954,2,7,0.0,0.0,7,0
22400954,3,324,1.0,0.18518518518518517,720,396
22400954,3,62,-2.0,-1.935483870967742,388,326
22400954,3,54,-1.0,-1.1111111111111112,314,260
22400954,3,96,2.0,1.25,245,149
22400954,3,167,10.0,3.592814371257485,167,0
22400954,4,110,0.0,0.0,720,610
22400954,4,188,-2.0,-0.6382978723404256,610,422
22400954,4,54,-3.0,-3.333333333333333,404,350
22400954,4,10,1.0,6.0,334,324
22400954,4,46,0.0,0.0,272,226
22400954,4,90,-2.0,-1.3333333333333335,184,94
22400954,4,82,-3.0,-2.195121951219512,94,12
22400954,4,8,-1.0,-7.5,8,0
22400955,1,381,6.0,0.9448818897637795,720,339
22400955,1,13,-1.0,-4.615384615384616,339,326
22400955,1,28,0.0,0.0,309,281
22400955,1,81,-2.0,-1.4814814814814814,281,200
22400955,1,2,0.0,0.0,200,198
22400955,1,78,1.0,0.7692307692307692,182,104
22400955,1,86,0.0,0.0,86,0
22400955,2,147,7.0,2.8571428571428568,720,573
22400955,2,36,0.0,0.0,561,525
22400955,2,115,-2.0,-1.0434782608695652,510,395
22400955,2,58,-3.0,-3.103448275862069,384,326
22400955,2,73,1.0,0.821917808219178,168,95
22400955,2,84,-1.0,-0.7142857142857142,84,0
22400955,3,212,5.0,1.4150943396226416,720,508
22400955,3,19,1.0,3.1578947368421053,493,474
22400955,3,17,-2.0,-7.0588235294117645,460,443
22400955,3,86,5.0,3.488372093023256,437,351
22400955,3,70,0.0,0.0,351,281
22400955,3,60,4.0,4.0,279,219
22400955,3,50,-1.0,-1.2,205,155
22400955,3,135,-1.0,-0.4444444444444445,142,7
22400955,3,1,0.0,0.0,1,0
22400955,4,158,-4.0,-1.5189873417721518,720,562
22400955,4,48,-3.0,-3.75,554,506
22400955,4,17,1.0,3.5294117647058822,494,477
22400955,4,201,1.0,0.29850746268656714,462,261
22400955,4,15,2.0,8.0,261,246
22400955,4,58,4.0,4.137931034482759,229,171
22400955,4,17,0.0,0.0,163,146
22400955,4,117,-1.0,-0.5128205128205129,117,0
22400956,1,316,-3.0,-0.569620253164557,720,404
22400956,1,21,0.0,0.0,404,383
22400956,1,16,1.0,3.75,379,363
22400956,1,113,2.0,1.0619469026548671,363,250
22400956,1,232,3.0,0.7758620689655172,232,0
22400956,2,175,1.0,0.34285714285714286,720,545
22400956,2,52,-3.0,-3.4615384615384617,533,481
22400956,2,26,-2.0,-4.615384615384616,481,455
22400956,2,79,0.0,0.0,455,376
22400956,2,18,-1.0,-3.333333333333333,370,352
22400956,2,109,-2.0,-1.1009174311926606,352,243
22400956,2,3,-1.0,-20.0,237,234
22400956,2,221,2.0,0.5429864253393666,234,13
22400956,2,1,0.0,0.0,1,0
22400956,3,268,-5.0,-1.1194029850746268,720,452
22400956,3,118,1.0,0.5084745762711864,443,325
22400956,3,59,-2.0,-2.0338983050847457,325,266
22400956,3,55,3.0,3.2727272727272725,266,211
22400956,3,207,-5.0,-1.4492753623188406,207,0
22400956,4,134,7.0,3.134328358208955,720,586
22400956,4,15,0.0,0.0,576,561
22400956,4,63,-1.0,-0.9523809523809523,553,490
22400956,4,64,2.0,1.875,487,423
22400956,4,151,1.0,0.3973509933774834,412,261
22400956,4,51,3.0,3.5294117647058822,261,210
22400956,4,136,5.0,2.2058823529411766,201,65
22400956,4,65,-2.0,-1.8461538461538463,65,0
22400957,1,277,5.0,1.0830324909747293,720,443
22400957,1,113,3.0,1.592920353982301,431,318
22400957,1,73,1.0,0.821917808219178,307,234
22400957,1,74,0.0,0.0,234,160
22400957,1,125,2.0,0.96,140,15
22400957,1,6,0.0,0.0,6,0
22400957,2,200,3.0,0.8999999999999999,720,520
22400957,2,43,0.0,0.0,520,477
22400957,2,62,4.0,3.870967741935484,465,403
22400957,2,70,4.0,3.4285714285714284,403,333
22400957,2,76,-3.0,-2.3684210526315788,311,235
22400957,2,89,-4.0,-2.696629213483146,218,129
22400957,2,129,-5.0,-2.3255813953488373,129,0
22400957,3,206,-4.0,-1.1650485436893203,720,514
22400957,3,64,-1.0,-0.9375,499,435
22400957,3,31,0.0,0.0,435,404
22400957,3,29,-1.0,-2.0689655172413794,404,375
22400957,3,41,3.0,4.390243902439024,375,334
22400957,3,121,5.0,2.479338842975207,317,196
22400957,3,65,-4.0,-3.6923076923076925,196,131
22400957,3,111,2.0,1.0810810810810811,111,0
22400957,4,53,0.0,0.0,720,667
22400957,4,52,-4.0,-4.615384615384616,653,601
22400957,4,144,5.0,2.0833333333333335,601,457
22400957,4,105,0.0,0.0,436,331
22400957,4,126,3.0,1.4285714285714284,328,202
22400957,4,202,6.0,1.782178217821782,202,0
22400958,1,368,-13.0,-2.119565217391304,720,352
22400958,1,53,2.0,2.2641509433962264,352,299
22400958,1,19,0.0,0.0,299,280
22400958,1,66,-4.0,-3.6363636363636367,280,214
22400958,1,119,3.0,1.5126050420168067,214,95
22400958,1,80,0.0,0.0,80,0
22400958,2,240,0.0,0.0,720,480
22400958,2,23,0.0,0.0,480,457
22400958,2,69,2.0,1.7391304347826086,457,388
22400958,2,111,-1.0,-0.5405405405405406,370,259
22400958,2,83,5.0,3.6144578313253013,245,162
22400958,2,93,-3.0,-1.935483870967742,162,69
22400958,2,33,3.0,5.454545454545455,46,13
22400958,2,13,0.0,0.0,13,0
22400958,3,391,7.0,1.0741687979539642,720,329
22400958,3,28,-2.0,-4.285714285714286,316,288
22400958,3,26,0.0,0.0,273,247
22400958,3,104,-4.0,-2.307692307692308,234,130
22400958,3,70,2.0,1.7142857142857142,120,50
22400958,3,33,-2.0,-3.6363636363636367,33,0
22400958,4,120,-3.0,-1.5,720,600
22400958,4,73,-2.0,-1.643835616438356,587,514
22400958,4,15,0.0,0.0,489,474
22400958,4,72,0.0,0.0,457,385
22400958,4,143,0.0,0.0,376,233
22400958,4,77,-3.0,-2.3376623376623376,217,140
22400958,4,140,-1.0,-0.42857142857142855,140,0
22400959,1,370,2.0,0.32432432432432434,720,350
22400959,1,20,1.0,3.0,338,318
22400959,1,95,3.0,1.8947368421052633,318,223
22400959,1,52,3.0,3.4615384615384617,210,158
22400959,1,50,-2.0,-2.4,158,108
22400959,1,108,-1.0,-0.5555555555555556,108,0
22400959,2,153,-5.0,-1.9607843137254903,720,567
22400959,2,30,1.0,2.0,567,537
22400959,2,78,0.0,0.0,537,459
22400959,2,197,3.0,0.9137055837563453,447,250
22400959,2,161,-3.0,-1.1180124223602486,250,89
22400959,2,16,1.0,3.75,78,62
22400959,2,62,-5.0,-4.838709677419355,62,0
22400959,3,233,-9.0,-2.3175965665236054,720,487
22400959,3,143,-7.0,-2.937062937062937,476,333
22400959,3,47,2.0,2.5531914893617023,320,273
22400959,3,69,3.0,2.608695652173913,256,187
22400959,3,56,1.0,1.0714285714285714,176,120
22400959,3,24,5.0,12.5,120,96
22400959,3,2,1.0,30.0,77,75
22400959,3,75,-2.0,-1.6,75,0
22400959,4,145,-10.0,-4.137931034482759,720,575
22400959,4,12,1.0,5.0,559,547
22400959,4,59,2.0,2.0338983050847457,547,488
22400959,4,13,0.0,0.0,488,475
22400959,4,68,-2.0,-1.7647058823529411,465,397
22400959,4,55,0.0,0.0,385,330
22400959,4,26,2.0,4.615384615384616,330,304
22400959,4,94,-3.0,-1.9148936170212765,304,210
22400959,4,111,0.0,0.0,202,91
22400959,4,86,-2.0,-1.3953488372093024,86,0
22400960,1,352,7.0,1.1931818181818181,720,368
22400960,1,62,-3.0,-2.903225806451613,353,291
22400960,1,26,-1.0,-2.307692307692308,287,261
22400960,1,83,5.0,3.6144578313253013,261,178
22400960,2,108,4.0,2.2222222222222223,720,612
22400960,2,100,0.0,0.0,606,506
22400960,2,54,2.0,2.2222222222222223,487,433
22400960,2,5,0.0,0.0,415,410
22400960,2,264,5.0,1.1363636363636365,394,130
22400960,2,43,-1.0,-1.3953488372093024,130,87
22400960,2,29,3.0,6.206896551724138,87,58
22400960,2,271,0.0,0.0,271,0
22400960,3,203,-6.0,-1.773399014778325,720,517
22400960,3,128,0.0,0.0,494,366
22400960,3,93,1.0,0.6451612903225807,366,273
22400960,3,142,-11.0,-4.647887323943662,267,125
22400960,3,85,-2.0,-1.4117647058823528,85,0
22400960,4,129,2.0,0.9302325581395349,720,591
22400960,4,121,-1.0,-0.49586776859504134,591,470
22400960,4,27,2.0,4.444444444444445,462,435
22400960,4,63,-2.0,-1.9047619047619047,416,353
22400960,4,89,2.0,1.348314606741573,353,264
22400960,4,125,-2.0,-0.96,255,130
22400960,4,19,2.0,6.315789473684211,130,111
22400961,1,212,0.0,0.0,720,508
22400961,1,92,7.0,4.565217391304348,508,416
22400961,1,106,-2.0,-1.1320754716981132,400,294
22400961,1,30,0.0,0.0,282,252
22400961,1,48,2.0,2.5,236,188
22400961,1,12,0.0,0.0,177,165
22400961,1,18,2.0,6.666666666666666,165,147
22400961,1,58,-2.0,-2.0689655172413794,147,89
22400961,1,67,1.0,0.8955223880597015,67,0
22400961,2,126,3.0,1.4285714285714284,720,594
22400961,2,35,0.0,0.0,594,559
22400961,2,112,3.0,1.607142857142857,559,447
22400961,2,22,0.0,0.0,429,407
22400961,2,102,3.0,1.7647058823529411,388,286
22400961,2,94,2.0,1.2765957446808511,274,180
22400961,2,35,3.0,5.142857142857143,164,129
22400961,2,115,-3.0,-1.5652173913043477,115,0
22400961,3,230,3.0,0.7826086956521738,720,490
22400961,3,87,7.0,4.827586206896552,490,403
22400961,3,180,2.0,0.6666666666666667,388,208
22400961,3,21,0.0,0.0,208,187
22400961,3,5,0.0,0.0,177,172
22400961,3,124,5.0,2.4193548387096775,151,27
22400961,4,83,5.0,3.6144578313253013,720,637
22400961,4,225,1.0,0.26666666666666666,637,412
22400961,4,157,1.0,0.3821656050955414,393,236
22400961,4,55,4.0,4.363636363636363,236,181
22400961,4,172,-1.0,-0.3488372093023256,172,0
22400962,1,302,1.0,0.1986754966887417,720,418
22400962,1,39,-1.0,-1.5384615384615383,418,379
22400962,1,148,1.0,0.40540540540540543,365,217
22400962,1,58,0.0,0.0,206,148
22400962,1,137,-5.0,-2.18978102189781,137,0
22400962,2,209,-8.0,-2.2966507177033493,720,511
22400962,2,33,-1.0,-1.8181818181818183,490,457
22400962,2,8,0.0,0.0,445,437
22400962,2,58,1.0,1.0344827586206897,437,379
22400962,2,77,-1.0,-0.7792207792207793,368,291
22400962,2,90,0.0,0.0,291,201
22400962,2,9,0.0,0.0,186,177
22400962,2,50,-4.0,-4.8,177,127
22400962,2,103,1.0,0.5825242718446602,114,11
22400962,2,1,0.0,0.0,1,0
22400962,3,98,-5.0,-3.0612244897959187,720,622
22400962,3,96,-4.0,-2.5,607,511
22400962,3,82,5.0,3.6585365853658534,502,420
22400962,3,50,-2.0,-2.4,404,354
22400962,3,142,-1.0,-0.4225352112676056,354,212
22400962,3,50,1.0,1.2,212,162
22400962,3,162,3.0,1.1111111111111112,162,0
22400962,4,188,4.0,1.2765957446808511,720,532
22400962,4,27,2.0,4.444444444444445,532,505
22400962,4,221,-6.0,-1.6289592760180995,622,401
22400962,4,149,-3.0,-1.2080536912751678,388,239
22400962,4,229,8.0,2.096069868995633,229,0
22400963,1,111,2.0,1.0810810810810811,720,609
22400963,1,193,-3.0,-0.9326424870466321,609,416
22400963,1,69,1.0,0.8695652173913043,407,338
22400963,1,24,-1.0,-2.5,338,314
22400963,1,57,0.0,0.0,314,257
22400963,1,72,3.0,2.5,257,185
22400963,1,64,0.0,0.0,160,96
22400963,1,92,1.0,0.6521739130434783,92,0
22400963,2,137,0.0,0.0,720,583
22400963,2,67,1.0,0.8955223880597015,573,506
22400963,2,69,1.0,0.8695652173913043,506,437
22400963,2,42,1.0,1.4285714285714284,419,377
22400963,2,99,-3.0,-1.8181818181818183,377,278
22400963,2,57,0.0,0.0,278,221
22400963,2,1,0.0,0.0,204,203
22400963,2,15,0.0,0.0,191,176
22400963,2,122,5.0,2.4590163934426226,161,39
22400963,2,28,-3.0,-6.428571428571428,28,0
22400963,3,199,-6.0,-1.809045226130653,720,521
22400963,3,114,0.0,0.0,504,390
22400963,3,31,2.0,3.870967741935484,374,343
22400963,3,14,2.0,8.571428571428571,325,311
22400963,3,172,-8.0,-2.7906976744186047,297,125
22400963,3,41,-3.0,-4.390243902439024,118,77
22400963,3,23,-2.0,-5.217391304347826,77,54
22400963,3,33,0.0,0.0,33,0
22400963,4,125,5.0,2.4,720,595
22400963,4,47,3.0,3.829787234042553,577,530
22400963,4,24,2.0,5.0,516,492
22400963,4,26,2.0,4.615384615384616,480,454
22400963,4,122,-2.0,-0.9836065573770493,441,319
22400963,4,38,0.0,0.0,309,271
22400963,4,122,3.0,1.4754098360655736,255,133
22400963,4,50,-1.0,-1.2,114,64
22400963,4,6,1.0,10.0,56,50
22400963,4,20,-1.0,-3.0,50,30
22400963,4,25,0.0,0.0,25,0
22400964,1,399,-11.0,-1.6541353383458646,720,321
22400964,1,35,0.0,0.0,279,244
22400964,1,97,2.0,1.2371134020618557,234,137
22400964,1,48,-2.0,-2.5,134,86
22400964,1,81,-3.0,-2.2222222222222223,81,0
22400964,2,80,-3.0,-2.25,720,640
22400964,2,71,-4.0,-3.380281690140845,640,569
22400964,2,158,-2.0,-0.7594936708860759,557,399
22400964,2,55,-3.0,-3.2727272727272725,399,344
22400964,2,63,0.0,0.0,339,276
22400964,2,39,-3.0,-4.615384615384616,265,226
22400964,2,50,3.0,3.5999999999999996,204,154
22400964,2,59,-1.0,-1.0169491525423728,145,86
22400964,2,4,2.0,30.0,86,82
22400964,2,82,-3.0,-2.195121951219512,82,0
22400964,3,244,0.0,0.0,720,476
22400964,3,144,-3.0,-1.25,476,332
22400964,3,144,3.0,1.25,332,188
22400964,3,72,2.0,1.6666666666666665,188,116
22400964,3,100,-1.0,-0.6,100,0
22400964,4,190,4.0,1.263157894736842,720,530
22400964,4,29,-2.0,-4.137931034482759,530,501
22400964,4,97,-4.0,-2.4742268041237114,501,404
22400964,4,58,3.0,3.103448275862069,388,330
22400964,4,46,3.0,3.9130434782608696,327,281
22400964,4,193,9.0,2.7979274611398965,193,0
22400965,1,276,-4.0,-0.8695652173913043,720,444
22400965,1,87,-3.0,-2.0689655172413794,436,349
22400965,1,80,3.0,2.25,349,269
22400965,1,17,0.0,0.0,253,236
22400965,1,70,-4.0,-3.4285714285714284,230,160
22400965,1,20,-1.0,-3.0,149,129
22400965,1,102,-1.0,-0.5882352941176471,129,27
22400965,1,27,0.0,0.0,27,0
22400965,2,58,1.0,1.0344827586206897,720,662
22400965,2,106,3.0,1.6981132075471699,662,556
22400965,2,84,0.0,0.0,556,472
22400965,2,25,1.0,2.4,457,432
22400965,2,116,5.0,2.586206896551724,432,316
22400965,2,46,-1.0,-1.3043478260869565,316,270
22400965,2,58,1.0,1.0344827586206897,270,212
22400965,2,183,-1.0,-0.32786885245901637,212,29
22400965,2,4,0.0,0.0,10,6
22400965,3,255,9.0,2.1176470588235294,720,465
22400965,3,121,-2.0,-0.9917355371900827,439,318
22400965,3,50,1.0,1.2,318,268
22400965,3,73,1.0,0.821917808219178,260,187
22400965,3,70,-2.0,-1.7142857142857142,182,112
22400965,3,106,-2.0,-1.1320754716981132,106,0
22400965,4,275,-4.0,-0.8727272727272727,720,445
22400965,4,55,-2.0,-2.1818181818181817,445,390
22400965,4,221,8.0,2.1719457013574663,372,151
22400965,4,135,-2.0,-0.888888888888889,140,5
22400965,4,4,2.0,30.0,4,0
22400966,1,277,1.0,0.21660649819494585,720,443
22400966,1,2,0.0,0.0,426,424
22400966,1,21,0.0,0.0,423,402
22400966,1,68,0.0,0.0,389,321
22400966,1,145,0.0,0.0,321,176
22400966,1,165,-5.0,-1.8181818181818183,165,0
22400966,2,100,-2.0,-1.2,720,620
22400966,2,47,0.0,0.0,620,573
22400966,2,62,2.0,1.935483870967742,560,498
22400966,2,32,-2.0,-3.75,498,466
22400966,2,39,2.0,3.0769230769230766,455,416
22400966,2,93,1.0,0.6451612903225807,410,317
22400966,2,60,1.0,1.0,305,245
22400966,2,245,6.0,1.4693877551020407,245,0
22400966,3,246,-3.0,-0.7317073170731707,720,474
22400966,3,111,-6.0,-3.2432432432432434,474,363
22400966,3,43,2.0,2.7906976744186047,345,302
22400966,3,69,1.0,0.8695652173913043,296,227
22400966,3,60,4.0,4.0,226,166
22400966,3,13,0.0,0.0,166,153
22400966,3,153,-6.0,-2.3529411764705883,153,0
22400966,4,129,-8.0,-3.7209302325581395,720,591
22400966,4,66,-2.0,-1.8181818181818183,580,514
22400966,4,38,1.0,1.5789473684210527,507,469
22400966,4,129,5.0,2.3255813953488373,469,340
22400966,4,56,0.0,0.0,340,284
22400966,4,195,-5.0,-1.5384615384615383,281,86
22400966,4,78,4.0,3.0769230769230766,78,0
22400967,1,266,1.0,0.22556390977443608,720,454
22400967,1,75,0.0,0.0,445,370
22400967,1,55,3.0,3.2727272727272725,359,304
22400967,1,109,3.0,1.651376146788991,304,195
22400967,1,176,7.0,2.3863636363636362,187,11
22400967,1,10,-1.0,-6.0,11,1
22400967,1,1,0.0,0.0,1,0
22400967,2,115,0.0,0.0,720,605
22400967,2,143,-2.0,-0.8391608391608392,596,453
22400967,2,37,0.0,0.0,453,416
22400967,2,209,-6.0,-1.722488038277512,416,207
22400967,2,34,-4.0,-7.0588235294117645,184,150
22400967,2,85,3.0,2.1176470588235294,150,65
22400967,3,278,5.0,1.079136690647482,720,442
22400967,3,83,-3.0,-2.1686746987951806,430,347
22400967,3,26,1.0,2.307692307692308,338,312
22400967,3,144,1.0,0.41666666666666663,312,168
22400967,3,34,3.0,5.294117647058824,153,119
22400967,3,22,4.0,10.90909090909091,107,85
22400967,3,48,-2.0,-2.5,85,37
22400967,3,8,-1.0,-7.5,37,29
22400967,3,22,1.0,2.7272727272727275,29,7
22400967,4,84,5.0,3.571428571428571,720,636
22400967,4,53,2.0,2.2641509433962264,616,563
22400967,4,28,-2.0,-4.285714285714286,553,525
22400967,4,106,1.0,0.5660377358490566,516,410
22400967,4,248,-4.0,-0.967741935483871,399,151
22400967,4,71,5.0,4.225352112676057,151,80
22400967,4,28,-2.0,-4.285714285714286,71,43
22400967,4,37,0.0,0.0,37,0
22400968,1,343,-5.0,-0.8746355685131195,720,377
22400968,1,54,-2.0,-2.2222222222222223,377,323
22400968,1,50,0.0,0.0,323,273
22400968,1,180,6.0,2.0,273,93
22400968,1,66,-2.0,-1.8181818181818183,71,5
22400968,1,1,0.0,0.0,1,0
22400968,2,146,-2.0,-0.821917808219178,720,574
22400968,2,41,-2.0,-2.926829268292683,568,527
22400968,2,17,-1.0,-3.5294117647058822,516,499
22400968,2,112,-7.0,-3.75,499,387
22400968,2,67,-3.0,-2.6865671641791042,355,288
22400968,2,131,3.0,1.3740458015267176,288,157
22400968,2,126,5.0,2.380952380952381,134,8
22400968,2,8,-2.0,-15.0,8,0
22400968,3,348,4.0,0.6896551724137931,720,372
22400968,3,63,0.0,0.0,349,286
22400968,3,99,-7.0,-4.242424242424242,276,177
22400968,3,32,0.0,0.0,164,132
22400968,3,37,2.0,3.2432432432432434,109,72
22400968,3,44,5.0,6.818181818181818,72,28
22400968,4,214,1.0,0.2803738317757009,720,506
22400968,4,47,1.0,1.2765957446808511,506,459
22400968,4,83,-2.0,-1.4457831325301205,459,376
22400968,4,19,0.0,0.0,359,340
22400968,4,160,-1.0,-0.375,331,171
22400968,4,164,9.0,3.292682926829268,164,0
22400969,1,319,-6.0,-1.1285266457680252,720,401
22400969,1,52,2.0,2.307692307692308,401,349
22400969,1,68,-2.0,-1.7647058823529411,349,281
22400969,1,104,0.0,0.0,261,157
22400969,1,52,3.0,3.4615384615384617,144,92
22400969,1,92,5.0,3.260869565217391,92,0
22400969,2,105,6.0,3.4285714285714284,720,615
22400969,2,110,0.0,0.0,615,505
22400969,2,26,0.0,0.0,497,471
22400969,2,35,0.0,0.0,459,424
22400969,2,117,5.0,2.5641025641025643,424,307
22400969,2,67,-3.0,-2.6865671641791042,298,231
22400969,2,206,-6.0,-1.7475728155339807,231,25
22400969,3,293,-8.0,-1.6382252559726962,720,427
22400969,3,50,0.0,0.0,427,377
22400969,3,244,0.0,0.0,536,292
22400969,3,91,0.0,0.0,286,195
22400969,3,3,0.0,0.0,188,185
22400969,3,71,-4.0,-3.380281690140845,172,101
22400969,3,37,-1.0,-1.6216216216216217,84,47
22400969,3,47,0.0,0.0,47,0
22400969,4,116,0.0,0.0,720,604
22400969,4,77,6.0,4.675324675324675,593,516
22400969,4,76,0.0,0.0,510,434
22400969,4,80,4.0,3.0,413,333
22400969,4,138,4.0,1.7391304347826086,333,195
22400969,4,102,-5.0,-2.941176470588235,195,93
22400969,4,58,0.0,0.0,82,24
22400969,4,10,1.0,6.0,23,13
22400970,1,257,0.0,0.0,720,463
22400970,1,30,0.0,0.0,454,424
22400970,1,92,4.0,2.608695652173913,417,325
22400970,1,39,-3.0,-4.615384615384616,294,255
22400970,1,108,-2.0,-1.1111111111111112,251,143
22400970,1,41,0.0,0.0,141,100
22400970,1,59,0.0,0.0,89,30
22400970,1,27,-3.0,-6.666666666666666,27,0
22400970,2,173,2.0,0.6936416184971098,720,547
22400970,2,21,0.0,0.0,547,526
22400970,2,96,-4.0,-2.5,508,412
22400970,2,19,0.0,0.0,412,393
22400970,2,15,0.0,0.0,384,369
22400970,2,79,4.0,3.0379746835443036,358,279
22400970,2,4,0.0,0.0,259,255
22400970,2,80,-4.0,-3.0,248,168
22400970,2,71,-2.0,-1.6901408450704225,163,92
22400970,2,64,0.0,0.0,92,28
22400970,2,28,3.0,6.428571428571428,28,0
22400970,3,153,6.0,2.3529411764705883,720,567
22400970,3,133,-2.0,-0.9022556390977443,547,414
22400970,3,32,0.0,0.0,397,365
22400970,3,17,1.0,3.5294117647058822,354,337
22400970,3,76,-2.0,-1.5789473684210527,315,239
22400970,3,5,0.0,0.0,228,223
22400970,3,111,-3.0,-1.6216216216216217,223,112
22400970,3,24,0.0,0.0,100,76
22400970,3,76,4.0,3.1578947368421053,76,0
22400970,4,78,-1.0,-0.7692307692307692,720,642
22400970,4,41,3.0,4.390243902439024,628,587
22400970,4,104,3.0,1.7307692307692308,571,467
22400970,4,89,-3.0,-2.0224719101123596,456,367
22400970,4,75,5.0,4.0,367,292
22400970,4,71,0.0,0.0,283,212
22400970,4,23,0.0,0.0,212,189
22400970,4,157,-2.0,-0.7643312101910829,171,14
22400970,4,13,-1.0,-4.615384615384616,13,0
22400971,1,283,1.0,0.21201413427561838,720,437
22400971,1,26,2.0,4.615384615384616,422,396
22400971,1,170,3.0,1.0588235294117647,396,226
22400971,1,46,3.0,3.9130434782608696,226,180
22400971,1,160,-2.0,-0.75,163,3
22400971,2,196,-8.0,-2.4489795918367343,720,524
22400971,2,121,3.0,1.487603305785124,508,387
22400971,2,28,3.0,6.428571428571428,387,359
22400971,2,17,1.0,3.5294117647058822,342,325
22400971,2,98,-3.0,-1.836734693877551,325,227
22400971,2,37,2.0,3.2432432432432434,212,175
22400971,2,29,1.0,2.0689655172413794,151,122
22400971,2,97,5.0,3.092783505154639,122,25
22400971,3,344,-3.0,-0.5232558139534884,720,376
22400971,3,66,2.0,1.8181818181818183,365,299
22400971,3,110,4.0,2.1818181818181817,279,169
22400971,3,25,2.0,4.8,153,128
22400971,3,19,-1.0,-3.1578947368421053,113,94
22400971,3,94,7.0,4.468085106382978,94,0
22400971,4,255,-2.0,-0.47058823529411764,720,465
22400971,4,169,-2.0,-0.7100591715976331,442,273
22400971,4,35,2.0,3.4285714285714284,273,238
22400971,4,74,-2.0,-1.6216216216216217,232,158
22400971,4,158,8.0,3.0379746835443036,158,0
22400972,1,415,-2.0,-0.28915662650602414,720,305
22400972,1,141,6.0,2.5531914893617023,305,164
22400972,1,152,0.0,0.0,161,9
22400972,1,9,0.0,0.0,9,0
22400972,2,64,6.0,5.625,720,656
22400972,2,85,5.0,3.5294117647058822,636,551
22400972,2,66,-4.0,-3.6363636363636367,537,471
22400972,2,253,-4.0,-0.9486166007905138,471,218
22400972,2,32,2.0,3.75,207,175
22400972,2,160,-3.0,-1.125,160,0
22400972,3,256,0.0,0.0,720,464
22400972,3,162,-1.0,-0.37037037037037035,446,284
22400972,3,52,4.0,4.615384615384616,284,232
22400972,3,85,6.0,4.235294117647059,219,134
22400972,3,22,0.0,0.0,111,89
22400972,4,61,3.0,2.9508196721311473,720,659
22400972,4,55,-5.0,-5.454545454545455,644,589
22400972,4,97,2.0,1.2371134020618557,589,492
22400972,4,131,3.0,1.3740458015267176,477,346
22400972,4,132,-4.0,-1.8181818181818183,325,193
22400972,4,21,0.0,0.0,187,166
22400972,4,149,-4.0,-1.610738255033557,159,10
22400972,4,10,2.0,12.0,10,0
22400973,1,285,-2.0,-0.4210526315789474,720,435
22400973,1,55,-2.0,-2.1818181818181817,416,361
22400973,1,39,2.0,3.0769230769230766,350,311
22400973,1,9,0.0,0.0,302,293
22400973,1,103,3.0,1.7475728155339807,279,176
22400973,1,92,-2.0,-1.3043478260869565,152,60
22400973,2,200,8.0,2.4,720,520
22400973,2,94,-2.0,-1.2765957446808511,514,420
22400973,2,24,0.0,0.0,407,383
22400973,2,69,1.0,0.8695652173913043,367,298
22400973,2,16,2.0,7.5,290,274
22400973,2,22,-8.0,-21.81818181818182,263,241
22400973,3,311,-6.0,-1.157556270096463,720,409
22400973,3,38,0.0,0.0,403,365
22400973,3,26,3.0,6.923076923076923,357,331
22400973,3,116,15.0,7.758620689655173,324,208
22400973,3,51,-4.0,-4.705882352941177,79,28
22400973,3,28,3.0,6.428571428571428,28,0
22400973,4,159,-2.0,-0.7547169811320755,720,561
22400973,4,35,1.0,1.7142857142857142,561,526
22400973,4,22,3.0,8.181818181818182,512,490
22400973,4,38,-5.0,-7.894736842105263,490,452
22400973,4,77,4.0,3.116883116883117,431,354
22400973,4,148,-4.0,-1.6216216216216217,334,186
22400973,4,28,-1.0,-2.142857142857143,170,142
22400973,4,126,1.0,0.47619047619047616,142,16
22400973,4,4,-1.0,-15.0,10,6
22400973,4,2,0.0,0.0,6,4
22400974,1,278,3.0,0.6474820143884893,720,442
22400974,1,18,2.0,6.666666666666666,431,413
22400974,1,26,0.0,0.0,413,387
22400974,1,31,-2.0,-3.870967741935484,387,356
22400974,1,81,-6.0,-4.444444444444445,356,275
22400974,1,116,6.0,3.103448275862069,263,147
22400974,1,118,-2.0,-1.0169491525423728,137,19
22400974,1,19,2.0,6.315789473684211,19,0
22400974,2,232,5.0,1.293103448275862,720,488
22400974,2,13,0.0,0.0,485,472
22400974,2,13,-1.0,-4.615384615384616,469,456
22400974,2,107,-1.0,-0.5607476635514018,456,349
22400974,2,85,2.0,1.4117647058823528,331,246
22400974,2,40,0.0,0.0,239,199
22400974,2,24,-3.0,-7.5,177,153
22400974,2,45,3.0,4.0,143,98
22400974,2,98,0.0,0.0,98,0
22400974,3,312,4.0,0.7692307692307692,720,408
22400974,3,88,1.0,0.6818181818181819,396,308
22400974,3,16,-1.0,-3.75,304,288
22400974,3,11,0.0,0.0,288,277
22400974,3,119,1.0,0.5042016806722689,277,158
22400974,3,156,-3.0,-1.153846153846154,156,0
22400974,4,49,2.0,2.4489795918367343,720,671
22400974,4,165,7.0,2.5454545454545454,658,493
22400974,4,92,-3.0,-1.9565217391304348,483,391
22400974,4,149,-3.0,-1.2080536912751678,391,242
22400974,4,211,4.0,1.137440758293839,228,17
22400974,4,8,-2.0,-15.0,14,6
22400974,4,6,-2.0,-20.0,6,0
22400975,1,467,8.0,1.0278372591006424,720,253
22400975,1,127,9.0,4.251968503937007,239,112
22400975,1,486,15.0,1.8518518518518516,492,6
22400975,2,141,-2.0,-0.851063829787234,720,579
22400975,2,65,-5.0,-4.615384615384616,579,514
22400975,2,59,-1.0,-1.0169491525423728,500,441
22400975,2,38,-1.0,-1.5789473684210527,328,290
22400975,2,38,2.0,3.1578947368421053,273,235
22400975,2,30,0.0,0.0,225,195
22400975,2,190,2.0,0.631578947368421,190,0
22400975,3,220,-5.0,-1.3636363636363638,720,500
22400975,3,143,1.0,0.4195804195804196,487,344
22400975,3,43,1.0,1.3953488372093024,344,301
22400975,3,9,-1.0,-6.666666666666666,301,292
22400975,3,80,3.0,2.25,292,212
22400975,3,101,-2.0,-1.188118811881188,208,107
22400975,3,104,-5.0,-2.8846153846153846,107,3
22400975,4,238,4.0,1.0084033613445378,720,482
22400975,4,124,7.0,3.3870967741935485,474,350
22400975,4,176,-2.0,-0.6818181818181819,287,111
22400975,4,106,-1.0,-0.5660377358490566,111,5
22400975,4,2,0.0,0.0,2,0
22400976,1,315,0.0,0.0,720,405
22400976,1,55,0.0,0.0,384,329
22400976,1,106,-3.0,-1.6981132075471699,329,223
22400976,1,67,-1.0,-0.8955223880597015,223,156
22400976,1,154,0.0,0.0,154,0
22400976,2,61,3.0,2.9508196721311473,720,659
22400976,2,145,8.0,3.310344827586207,649,504
22400976,2,17,0.0,0.0,504,487
22400976,2,57,0.0,0.0,480,423
22400976,2,112,0.0,0.0,413,301
22400976,2,22,2.0,5.454545454545455,301,279
22400976,2,25,1.0,2.4,279,254
22400976,2,122,-1.0,-0.49180327868852464,254,132
22400976,2,118,-4.0,-2.0338983050847457,118,0
22400976,3,236,-2.0,-0.5084745762711864,720,484
22400976,3,64,-3.0,-2.8125,484,420
22400976,3,63,-1.0,-0.9523809523809523,420,357
22400976,3,41,-3.0,-4.390243902439024,357,316
22400976,3,25,-2.0,-4.8,307,282
22400976,3,47,-2.0,-2.5531914893617023,282,235
22400976,3,97,-1.0,-0.6185567010309279,235,138
22400976,3,39,-3.0,-4.615384615384616,138,99
22400976,3,9,0.0,0.0,99,90
22400976,3,90,-2.0,-1.3333333333333335,90,0
22400976,4,191,5.0,1.5706806282722514,720,529
22400976,4,34,-3.0,-5.294117647058824,529,495
22400976,4,57,-4.0,-4.2105263157894735,485,428
22400976,4,34,3.0,5.294117647058824,414,380
22400976,4,61,-2.0,-1.9672131147540985,363,302
22400976,4,168,4.0,1.4285714285714284,302,134
22400976,4,122,7.0,3.4426229508196724,134,12
22400976,4,10,-2.0,-12.0,10,0
22400977,1,311,2.0,0.3858520900321543,720,409
22400977,1,26,2.0,4.615384615384616,409,383
22400977,1,28,1.0,2.142857142857143,383,355
22400977,1,49,3.0,3.673469387755102,355,306
22400977,1,69,-1.0,-0.8695652173913043,299,230
22400977,1,159,9.0,3.3962264150943398,230,71
22400977,1,60,-2.0,-2.0,60,0
22400977,2,154,-6.0,-2.3376623376623376,720,566
22400977,2,125,0.0,0.0,556,431
22400977,2,52,-2.0,-2.307692307692308,409,357
22400977,2,96,3.0,1.875,347,251
22400977,2,29,0.0,0.0,251,222
22400977,2,37,0.0,0.0,211,174
22400977,2,164,1.0,0.36585365853658536,164,0
22400977,3,237,-6.0,-1.5189873417721518,720,483
22400977,3,155,0.0,0.0,468,313
22400977,3,67,2.0,1.791044776119403,313,246
22400977,3,5,0.0,0.0,236,231
22400977,3,105,-3.0,-1.7142857142857142,231,126
22400977,3,47,-3.0,-3.829787234042553,122,75
22400977,3,26,1.0,2.307692307692308,66,40
22400977,3,40,2.0,3.0,40,0
22400977,4,69,2.0,1.7391304347826086,720,651
22400977,4,108,-2.0,-1.1111111111111112,645,537
22400977,4,27,-3.0,-6.666666666666666,537,510
22400977,4,45,0.0,0.0,507,462
22400977,4,54,0.0,0.0,462,408
22400977,4,41,-2.0,-2.926829268292683,389,348
22400977,4,101,3.0,1.782178217821782,348,247
22400977,4,59,-1.0,-1.0169491525423728,242,183
22400977,4,71,-1.0,-0.8450704225352113,166,95
22400977,4,95,2.0,1.263157894736842,95,0
22400978,1,288,-1.0,-0.20833333333333331,720,432
22400978,1,45,-3.0,-4.0,420,375
22400978,1,88,2.0,1.3636363636363638,366,278
22400978,1,41,0.0,0.0,259,218
22400978,1,3,0.0,0.0,198,195
22400978,1,63,-1.0,-0.9523809523809523,179,116
22400978,1,99,2.0,1.2121212121212122,99,0
22400978,2,139,2.0,0.8633093525179857,720,581
22400978,2,18,2.0,6.666666666666666,564,546
22400978,2,24,-3.0,-7.5,534,510
22400978,2,26,0.0,0.0,510,484
22400978,2,81,1.0,0.7407407407407407,481,400
22400978,2,82,-2.0,-1.4634146341463414,400,318
22400978,2,42,-2.0,-2.8571428571428568,318,276
22400978,2,2,0.0,0.0,262,260
22400978,2,22,-2.0,-5.454545454545455,240,218
22400978,2,218,-12.0,-3.302752293577982,218,0
22400978,3,335,-1.0,-0.1791044776119403,720,385
22400978,3,98,0.0,0.0,382,284
22400978,3,23,1.0,2.608695652173913,284,261
22400978,3,172,7.0,2.4418604651162794,172,0
22400978,4,49,2.0,2.4489795918367343,720,671
22400978,4,154,3.0,1.1688311688311688,659,505
22400978,4,49,3.0,3.673469387755102,490,441
22400978,4,34,1.0,1.7647058823529411,441,407
22400978,4,74,0.0,0.0,407,333
22400978,4,32,-3.0,-5.625,339,307
22400978,4,19,0.0,0.0,288,269
22400978,4,85,-1.0,-0.7058823529411764,256,171
22400978,4,158,3.0,1.139240506329114,171,13
22400979,1,287,3.0,0.6271777003484321,720,433
22400979,1,48,-2.0,-2.5,429,381
22400979,1,89,2.0,1.348314606741573,381,292
22400979,1,60,3.0,3.0,292,232
22400979,1,211,3.0,0.8530805687203791,231,20
22400979,2,167,-3.0,-1.0778443113772456,720,553
22400979,2,35,-1.0,-1.7142857142857142,553,518
22400979,2,60,-3.0,-3.0,501,441
22400979,2,38,2.0,3.1578947368421053,427,389
22400979,2,96,-4.0,-2.5,371,275
22400979,2,24,0.0,0.0,271,247
22400979,2,187,5.0,1.6042780748663101,247,60
22400979,2,60,6.0,6.0,60,0
22400979,3,318,-5.0,-0.9433962264150944,720,402
22400979,3,43,0.0,0.0,393,350
22400979,3,41,-3.0,-4.390243902439024,350,309
22400979,3,124,0.0,0.0,309,185
22400979,3,12,0.0,0.0,165,153
22400979,3,4,1.0,15.0,153,149
22400979,3,149,-7.0,-2.8187919463087248,149,0
22400979,4,96,4.0,2.5,720,624
22400979,4,118,0.0,0.0,618,500
22400979,4,46,-3.0,-3.9130434782608696,451,405
22400979,4,96,2.0,1.25,381,285
22400979,4,152,0.0,0.0,280,128
22400979,4,114,-7.0,-3.6842105263157894,121,7
22400979,4,2,0.0,0.0,2,0
22400980,1,246,-14.0,-3.4146341463414633,720,474
22400980,1,91,-4.0,-2.6373626373626378,466,375
22400980,1,146,1.0,0.410958904109589,364,218
22400980,2,235,-3.0,-0.7659574468085106,720,485
22400980,2,9,0.0,0.0,470,461
22400980,2,127,3.0,1.4173228346456692,454,327
22400980,2,38,1.0,1.5789473684210527,317,279
22400980,2,44,0.0,0.0,279,235
22400980,2,133,1.0,0.45112781954887216,235,102
22400980,2,102,5.0,2.941176470588235,102,0
22400980,3,70,0.0,0.0,720,650
22400980,3,109,0.0,0.0,648,539
22400980,3,85,-3.0,-2.1176470588235294,526,441
22400980,3,24,0.0,0.0,441,417
22400980,3,21,-2.0,-5.7142857142857135,399,378
22400980,3,31,-2.0,-3.870967741935484,378,347
22400980,3,76,0.0,0.0,347,271
22400980,3,92,-3.0,-1.9565217391304348,263,171
22400980,3,15,0.0,0.0,171,156
22400980,3,155,10.0,3.870967741935484,155,0
22400980,4,91,-2.0,-1.3186813186813189,720,629
22400980,4,20,0.0,0.0,609,589
22400980,4,5,0.0,0.0,589,584
22400980,4,44,1.0,1.3636363636363638,568,524
22400980,4,7,3.0,25.71428571428571,506,499
22400980,4,22,-4.0,-10.90909090909091,479,457
22400980,4,115,1.0,0.5217391304347826,437,322
22400980,4,307,7.0,1.3680781758957654,312,5
22400980,4,3,0.0,0.0,3,0
22400981,1,336,11.0,1.9642857142857144,720,384
22400981,1,98,3.0,1.836734693877551,384,286
22400981,1,64,2.0,1.875,282,218
22400981,1,56,-2.0,-2.142857142857143,209,153
22400981,1,93,0.0,0.0,153,60
22400981,1,50,-3.0,-3.5999999999999996,50,0
22400981,2,169,-10.0,-3.5502958579881656,720,551
22400981,2,50,2.0,2.4,530,480
22400981,2,24,0.0,0.0,480,456
22400981,2,85,5.0,3.5294117647058822,456,371
22400981,2,34,-1.0,-1.7647058823529411,363,329
22400981,2,86,2.0,1.3953488372093024,329,243
22400981,2,129,1.0,0.46511627906976744,243,114
22400981,2,114,-6.0,-3.1578947368421053,114,0
22400981,3,181,6.0,1.9889502762430937,720,539
22400981,3,103,-1.0,-0.5825242718446602,531,428
22400981,3,57,2.0,2.1052631578947367,417,360
22400981,3,147,2.0,0.8163265306122449,360,213
22400981,3,32,-2.0,-3.75,202,170
22400981,3,170,4.0,1.4117647058823528,170,0
22400981,4,156,7.0,2.6923076923076925,720,564
22400981,4,90,1.0,0.6666666666666667,553,463
22400981,4,36,2.0,3.333333333333333,457,421
22400981,4,34,-2.0,-3.5294117647058822,411,377
22400981,4,149,-3.0,-1.2080536912751678,377,228
22400981,4,187,2.0,0.6417112299465241,228,41
22400981,4,19,0.0,0.0,19,0
22400982,1,314,1.0,0.1910828025477707,720,406
22400982,1,173,-4.0,-1.3872832369942196,396,223
22400982,1,59,0.0,0.0,210,151
22400982,1,57,3.0,3.1578947368421053,137,80
22400982,1,17,3.0,10.588235294117649,80,63
22400982,2,268,-7.0,-1.5671641791044775,720,452
22400982,2,8,-2.0,-15.0,445,437
22400982,2,49,1.0,1.2244897959183672,425,376
22400982,2,32,2.0,3.75,365,333
22400982,2,52,3.0,3.4615384615384617,333,281
22400982,2,34,-2.0,-3.5294117647058822,264,230
22400982,2,26,-2.0,-4.615384615384616,215,189
22400982,2,112,-3.0,-1.607142857142857,179,67
22400982,2,67,0.0,0.0,67,0
22400982,3,342,-2.0,-0.3508771929824561,720,378
22400982,3,78,3.0,2.307692307692308,362,284
22400982,3,36,-2.0,-3.333333333333333,276,240
22400982,3,54,2.0,2.2222222222222223,240,186
22400982,3,151,3.0,1.1920529801324504,178,27
22400982,3,27,-2.0,-4.444444444444445,27,0
22400982,4,81,-4.0,-2.962962962962963,720,639
22400982,4,94,-2.0,-1.2765957446808511,617,523
22400982,4,116,3.0,1.5517241379310345,523,407
22400982,4,48,0.0,0.0,386,338
22400982,4,48,1.0,1.25,325,277
22400982,4,37,2.0,3.2432432432432434,267,230
22400982,4,18,2.0,6.666666666666666,230,212
22400982,4,94,2.0,1.2765957446808511,212,118
22400982,4,45,0.0,0.0,110,65
22400982,4,24,-2.0,-5.0,65,41
22400982,4,41,0.0,0.0,41,0
22400983,1,476,9.0,1.134453781512605,720,244
22400983,1,36,-2.0,-3.333333333333333,230,194
22400983,1,6,0.0,0.0,181,175
22400983,1,159,-3.0,-1.1320754716981132,168,9
22400983,1,9,0.0,0.0,9,0
22400983,2,221,12.0,3.257918552036199,720,499
22400983,2,50,1.0,1.2,490,440
22400983,2,52,1.0,1.153846153846154,440,388
22400983,2,153,0.0,0.0,388,235
22400983,2,224,1.0,0.26785714285714285,224,0
22400983,3,466,-1.0,-0.12875536480686695,720,254
22400983,3,62,-3.0,-2.903225806451613,236,174
22400983,3,63,1.0,0.9523809523809523,174,111
22400983,3,105,0.0,0.0,111,6
22400983,3,1,0.0,0.0,1,0
22400983,4,97,-2.0,-1.2371134020618557,720,623
22400983,4,146,-3.0,-1.2328767123287672,606,460
22400983,4,184,5.0,1.6304347826086956,600,416
22400983,4,109,4.0,2.2018348623853212,403,294
22400983,4,106,0.0,0.0,294,188
22400983,4,72,-3.0,-2.5,173,101
22400983,4,93,0.0,0.0,93,0
22400984,1,437,-6.0,-0.8237986270022882,720,283
22400984,1,32,2.0,3.75,283,251
22400984,1,115,-6.0,-3.1304347826086953,235,120
22400984,1,64,-2.0,-1.875,104,40
22400984,1,32,2.0,3.75,38,6
22400984,1,1,0.0,0.0,1,0
22400984,2,145,5.0,2.0689655172413794,720,575
22400984,2,146,8.0,3.287671232876712,569,423
22400984,2,39,-3.0,-4.615384615384616,409,370
22400984,2,99,4.0,2.4242424242424243,370,271
22400984,2,145,-3.0,-1.2413793103448276,264,119
22400984,2,100,0.0,0.0,106,6
22400984,2,5,0.0,0.0,6,1
22400984,3,233,12.0,3.0901287553648067,720,487
22400984,3,140,-1.0,-0.42857142857142855,465,325
22400984,3,54,-2.0,-2.2222222222222223,318,264
22400984,3,60,3.0,3.0,251,191
22400984,3,58,4.0,4.137931034482759,175,117
22400984,3,99,8.0,4.848484848484849,99,0
22400984,4,163,3.0,1.1042944785276074,720,557
22400984,4,140,-3.0,-1.2857142857142858,543,403
22400984,4,217,3.0,0.8294930875576038,391,174
22400984,4,174,-2.0,-0.6896551724137931,174,0
22400985,1,289,-2.0,-0.4152249134948097,720,431
22400985,1,72,-6.0,-5.0,406,334
22400985,1,117,0.0,0.0,334,217
22400985,1,54,-3.0,-3.333333333333333,199,145
22400985,1,51,0.0,0.0,143,92
22400985,1,62,3.0,2.903225806451613,82,20
22400985,1,8,-3.0,-22.5,8,0
22400985,2,60,2.0,2.0,720,660
22400985,2,130,-1.0,-0.46153846153846156,648,518
22400985,2,24,0.0,0.0,518,494
22400985,2,23,-2.0,-5.217391304347826,480,457
22400985,2,85,-3.0,-2.1176470588235294,457,372
22400985,2,109,2.0,1.1009174311926606,357,248
22400985,2,51,1.0,1.1764705882352942,234,183
22400985,2,153,-3.0,-1.1764705882352942,153,0
22400985,3,333,7.0,1.2612612612612613,720,387
22400985,3,104,7.0,4.038461538461538,365,261
22400985,3,51,-3.0,-3.5294117647058822,253,202
22400985,3,80,5.0,3.75,193,113
22400985,3,108,3.0,1.6666666666666665,108,0
22400985,4,113,-7.0,-3.7168141592920354,720,607
22400985,4,266,5.0,1.1278195488721803,564,298
22400985,4,58,-2.0,-2.0689655172413794,290,232
22400985,4,159,2.0,0.7547169811320755,232,73
22400985,4,59,6.0,6.101694915254238,64,5
22400985,4,2,0.0,0.0,5,3
22400985,5,198,1.0,0.30303030303030304,300,102
22400985,5,95,4.0,2.526315789473684,95,0
22400986,1,160,3.0,1.125,720,560
22400986,1,28,0.0,0.0,543,515
22400986,1,89,-3.0,-2.0224719101123596,497,408
22400986,1,69,2.0,1.7391304347826086,408,339
22400986,1,97,0.0,0.0,339,242
22400986,1,59,-4.0,-4.067796610169491,242,183
22400986,1,112,0.0,0.0,183,71
22400986,1,37,1.0,1.6216216216216217,61,24
22400986,1,24,0.0,0.0,24,0
22400986,2,140,4.0,1.7142857142857142,720,580
22400986,2,122,-3.0,-1.4754098360655736,562,440
22400986,2,137,-5.0,-2.18978102189781,416,279
22400986,2,99,-3.0,-1.8181818181818183,265,166
22400986,2,32,-4.0,-7.5,160,128
22400986,2,38,0.0,0.0,108,70
22400986,3,104,5.0,2.8846153846153846,720,616
22400986,3,60,0.0,0.0,596,536
22400986,3,91,1.0,0.6593406593406594,568,477
22400986,3,44,6.0,8.181818181818182,428,384
22400986,3,57,-2.0,-2.1052631578947367,384,327
22400986,3,232,5.0,1.293103448275862,327,95
22400986,3,41,0.0,0.0,95,54
22400986,3,24,0.0,0.0,54,30
22400986,4,99,10.0,6.0606060606060606,720,621
22400986,4,133,-3.0,-1.3533834586466165,603,470
22400986,4,25,0.0,0.0,470,445
22400986,4,82,-3.0,-2.195121951219512,427,345
22400986,4,112,3.0,1.607142857142857,345,233
22400986,4,20,-2.0,-6.0,233,213
22400986,4,169,-4.0,-1.4201183431952662,199,30
22400986,4,16,0.0,0.0,30,14
22400986,5,57,2.0,2.1052631578947367,300,243
22400986,5,161,-1.0,-0.37267080745341613,243,82
22400986,5,40,-4.0,-6.0,66,26
22400986,5,15,-1.0,-4.0,18,3
22400987,1,49,0.0,0.0,720,671
22400987,1,279,-8.0,-1.7204301075268817,671,392
22400987,1,25,0.0,0.0,392,367
22400987,1,39,-2.0,-3.0769230769230766,349,310
22400987,1,83,-6.0,-4.337349397590361,290,207
22400987,1,38,1.0,1.5789473684210527,192,154
22400987,1,56,1.0,1.0714285714285714,154,98
22400987,1,98,-5.0,-3.0612244897959187,98,0
22400987,2,38,-2.0,-3.1578947368421053,720,682
22400987,2,179,-1.0,-0.335195530726257,682,503
22400987,2,33,-2.0,-3.6363636363636367,503,470
22400987,2,24,-2.0,-5.0,470,446
22400987,2,26,-2.0,-4.615384615384616,431,405
22400987,2,50,-2.0,-2.4,394,344
22400987,2,113,1.0,0.5309734513274336,344,231
22400987,2,69,-1.0,-0.8695652173913043,231,162
22400987,2,122,-1.0,-0.49180327868852464,139,17
22400987,3,287,8.0,1.6724738675958188,720,433
22400987,3,56,3.0,3.214285714285714,428,372
22400987,3,41,-2.0,-2.926829268292683,366,325
22400987,3,22,-2.0,-5.454545454545455,325,303
22400987,3,47,0.0,0.0,295,248
22400987,3,16,0.0,0.0,227,211
22400987,3,35,-5.0,-8.571428571428571,203,168
22400987,3,135,0.0,0.0,151,16
22400987,3,11,1.0,5.454545454545455,16,5
22400987,4,189,-8.0,-2.5396825396825395,720,531
22400987,4,36,2.0,3.333333333333333,519,483
22400987,4,65,1.0,0.9230769230769231,483,418
22400987,4,26,2.0,4.615384615384616,418,392
22400987,4,9,0.0,0.0,392,383
22400987,4,179,-12.0,-4.022346368715084,368,189
22400987,4,177,-4.0,-1.3559322033898304,177,0
22400988,1,394,1.0,0.15228426395939085,720,326
22400988,2,287,-2.0,-0.4181184668989547,720,433
22400988,2,53,-5.0,-5.660377358490567,412,359
22400988,2,132,0.0,0.0,359,227
22400988,2,41,0.0,0.0,195,154
22400988,2,134,0.0,0.0,140,6
22400988,2,6,0.0,0.0,6,0
22400988,3,64,0.0,0.0,720,656
22400988,3,260,2.0,0.46153846153846156,656,396
22400988,3,209,6.0,1.722488038277512,380,171
22400988,3,164,-5.0,-1.8292682926829267,164,0
22400988,4,92,2.0,1.3043478260869565,720,628
22400988,4,88,-5.0,-3.409090909090909,628,540
22400988,4,56,1.0,1.0714285714285714,540,484
22400988,4,60,0.0,0.0,471,411
22400988,4,36,-4.0,-6.666666666666666,397,361
22400988,4,68,0.0,0.0,348,280
22400988,4,33,-4.0,-7.272727272727273,269,236
22400988,4,45,2.0,2.666666666666667,236,191
22400988,4,1,0.0,0.0,184,183
22400988,4,79,2.0,1.5189873417721518,171,92
22400988,4,38,-4.0,-6.315789473684211,92,54
22400988,4,54,2.0,2.2222222222222223,54,0
22400989,1,266,-4.0,-0.9022556390977443,720,454
22400989,1,47,2.0,2.5531914893617023,454,407
22400989,1,55,1.0,1.0909090909090908,401,346
22400989,1,73,0.0,0.0,346,273
22400989,1,77,-2.0,-1.5584415584415585,263,186
22400989,1,91,1.0,0.6593406593406594,179,88
22400989,2,143,2.0,0.8391608391608392,720,577
22400989,2,79,2.0,1.5189873417721518,562,483
22400989,2,75,1.0,0.8,481,406
22400989,2,30,0.0,0.0,406,376
22400989,2,172,-2.0,-0.6976744186046512,375,203
22400989,2,67,0.0,0.0,203,136
22400989,2,128,1.0,0.46875,128,0
22400989,3,214,-1.0,-0.2803738317757009,720,506
22400989,3,19,0.0,0.0,491,472
22400989,3,59,-4.0,-4.067796610169491,462,403
22400989,3,92,0.0,0.0,403,311
22400989,3,37,0.0,0.0,311,274
22400989,3,18,2.0,6.666666666666666,253,235
22400989,3,55,-5.0,-5.454545454545455,229,174
22400989,3,174,4.0,1.3793103448275863,174,0
22400989,4,171,-3.0,-1.0526315789473684,720,549
22400989,4,16,0.0,0.0,549,533
22400989,4,12,2.0,10.0,521,509
22400989,4,14,0.0,0.0,461,447
22400989,4,13,0.0,0.0,447,434
22400989,4,70,-3.0,-2.5714285714285716,425,355
22400989,4,59,-2.0,-2.0338983050847457,355,296
22400989,4,92,-2.0,-1.3043478260869565,291,199
22400989,4,195,2.0,0.6153846153846154,195,0
22400990,1,257,-6.0,-1.4007782101167314,720,463
22400990,1,41,0.0,0.0,454,413
22400990,1,52,-4.0,-4.615384615384616,406,354
22400990,1,100,2.0,1.2,344,244
22400990,1,31,0.0,0.0,220,189
22400990,1,67,3.0,2.6865671641791042,189,122
22400990,1,83,-6.0,-4.337349397590361,122,39
22400990,1,13,-1.0,-4.615384615384616,29,16
22400990,1,16,0.0,0.0,16,0
22400990,2,82,6.0,4.390243902439024,720,638
22400990,2,124,-6.0,-2.903225806451613,630,506
22400990,2,8,-2.0,-15.0,495,487
22400990,2,107,-6.0,-3.364485981308411,477,370
22400990,2,16,0.0,0.0,354,338
22400990,2,90,1.0,0.6666666666666667,328,238
22400990,2,74,2.0,1.6216216216216217,223,149
22400990,2,107,1.0,0.5607476635514018,149,42
22400990,3,335,0.0,0.0,720,385
22400990,3,109,1.0,0.5504587155963303,365,256
22400990,3,122,-2.0,-0.9836065573770493,242,120
22400990,3,108,1.0,0.5555555555555556,108,0
22400990,4,229,3.0,0.7860262008733624,720,491
22400990,4,41,-1.0,-1.4634146341463414,491,450
22400990,4,72,4.0,3.333333333333333,445,373
22400990,4,31,-2.0,-3.870967741935484,360,329
22400990,4,46,-2.0,-2.608695652173913,317,271
22400990,4,200,1.0,0.3,271,71
22400990,4,71,-1.0,-0.8450704225352113,71,0
22400991,1,299,-6.0,-1.2040133779264215,720,421
22400991,1,37,2.0,3.2432432432432434,409,372
22400991,1,23,0.0,0.0,372,349
22400991,1,78,1.0,0.7692307692307692,334,256
22400991,1,78,-3.0,-2.307692307692308,254,176
22400991,1,76,1.0,0.7894736842105263,176,100
22400991,1,7,-2.0,-17.142857142857142,93,86
22400991,2,138,10.0,4.3478260869565215,720,582
22400991,2,98,4.0,2.4489795918367343,567,469
22400991,2,69,1.0,0.8695652173913043,456,387
22400991,2,13,3.0,13.846153846153847,387,374
22400991,2,68,7.0,6.1764705882352935,354,286
22400991,2,111,3.0,1.6216216216216217,274,163
22400991,2,20,-1.0,-3.0,161,141
22400991,2,49,2.0,2.4489795918367343,141,92
22400991,2,75,2.0,1.6,75,0
22400991,3,153,-3.0,-1.1764705882352942,720,567
22400991,3,137,4.0,1.751824817518248,567,430
22400991,3,35,0.0,0.0,424,389
22400991,3,53,2.0,2.2641509433962264,365,312
22400991,3,14,0.0,0.0,300,286
22400991,3,78,1.0,0.7692307692307692,286,208
22400991,3,99,3.0,1.8181818181818183,205,106
22400991,3,106,2.0,1.1320754716981132,106,0
22400991,4,139,6.0,2.589928057553957,720,581
22400991,4,124,-3.0,-1.4516129032258065,562,438
22400991,4,53,1.0,1.1320754716981132,424,371
22400991,4,39,2.0,3.0769230769230766,371,332
22400991,4,124,-1.0,-0.4838709677419355,319,195
22400991,4,183,6.0,1.9672131147540985,183,0
22400992,1,168,1.0,0.3571428571428571,720,552
22400992,1,136,0.0,0.0,537,401
22400992,1,150,0.0,0.0,401,251
22400992,1,64,3.0,2.8125,235,171
22400992,1,18,1.0,3.333333333333333,91,73
22400992,1,39,7.0,10.76923076923077,73,34
22400992,1,15,0.0,0.0,15,0
22400992,2,86,-3.0,-2.0930232558139537,720,634
22400992,2,118,0.0,0.0,623,505
22400992,2,54,1.0,1.1111111111111112,496,442
22400992,2,141,2.0,0.851063829787234,442,301
22400992,2,85,1.0,0.7058823529411764,290,205
22400992,2,59,3.0,3.050847457627119,205,146
22400992,2,37,-4.0,-6.486486486486487,146,109
22400992,3,51,-3.0,-3.5294117647058822,720,669
22400992,3,8,2.0,15.0,669,661
22400992,3,135,-5.0,-2.2222222222222223,653,518
22400992,3,63,5.0,4.761904761904762,503,440
22400992,3,71,3.0,2.535211267605634,430,359
22400992,3,30,-2.0,-4.0,350,320
22400992,3,80,0.0,0.0,320,240
22400992,3,82,-1.0,-0.7317073170731707,233,151
22400992,3,108,-2.0,-1.1111111111111112,151,43
22400992,3,19,1.0,3.1578947368421053,32,13
22400992,3,13,2.0,9.230769230769232,13,0
22400992,4,84,5.0,3.571428571428571,720,636
22400992,4,90,-1.0,-0.6666666666666667,619,529
22400992,4,62,2.0,1.935483870967742,517,455
22400992,4,88,0.0,0.0,455,367
22400992,4,82,-6.0,-4.390243902439024,367,285
22400992,4,63,0.0,0.0,285,222
22400992,4,222,-2.0,-0.5405405405405406,222,0
22400993,1,317,-7.0,-1.324921135646688,720,403
22400993,1,94,0.0,0.0,403,309
22400993,1,81,4.0,2.962962962962963,303,222
22400993,1,142,-3.0,-1.267605633802817,198,56
22400993,2,92,3.0,1.9565217391304348,720,628
22400993,2,49,-5.0,-6.122448979591837,628,579
22400993,2,44,2.0,2.7272727272727275,579,535
22400993,2,148,0.0,0.0,513,365
22400993,2,43,3.0,4.186046511627907,352,309
22400993,2,192,-4.0,-1.25,301,109
22400993,2,28,1.0,2.142857142857143,109,81
22400993,2,49,-4.0,-4.897959183673469,81,32
22400993,3,307,-13.0,-2.54071661237785,720,413
22400993,3,26,-2.0,-4.615384615384616,392,366
22400993,3,52,-5.0,-5.769230769230769,354,302
22400993,3,12,0.0,0.0,287,275
22400993,3,121,1.0,0.49586776859504134,262,141
22400993,3,123,4.0,1.9512195121951221,123,0
22400993,4,122,-1.0,-0.49180327868852464,720,598
22400993,4,42,-2.0,-2.8571428571428568,598,556
22400993,4,58,-3.0,-3.103448275862069,540,482
22400993,4,38,-3.0,-4.7368421052631575,474,436
22400993,4,2,0.0,0.0,419,417
22400993,4,38,0.0,0.0,409,371
22400993,4,64,0.0,0.0,353,289
22400993,4,43,-2.0,-2.7906976744186047,281,238
22400993,4,238,3.0,0.7563025210084033,238,0
22400994,1,406,-2.0,-0.2955665024630542,720,314
22400994,1,106,2.0,1.1320754716981132,299,193
22400994,1,180,-1.0,-0.33333333333333337,180,0
22400994,2,239,0.0,0.0,720,481
22400994,2,31,-3.0,-5.806451612903226,481,450
22400994,2,101,5.0,2.9702970297029703,427,326
22400994,2,110,-7.0,-3.818181818181818,308,198
22400994,2,174,2.0,0.6896551724137931,174,0
22400994,3,329,4.0,0.729483282674772,720,391
22400994,3,108,7.0,3.888888888888889,389,281
22400994,3,18,0.0,0.0,264,246
22400994,3,87,-4.0,-2.7586206896551726,246,159
22400994,3,61,-2.0,-1.9672131147540985,159,98
22400994,3,81,2.0,1.4814814814814814,82,1
22400994,3,1,3.0,180.0,1,0
22400994,4,199,2.0,0.6030150753768845,720,521
22400994,4,72,-4.0,-3.333333333333333,521,449
22400994,4,44,6.0,8.181818181818182,440,396
22400994,4,11,1.0,5.454545454545455,370,359
22400994,4,121,-2.0,-0.9917355371900827,359,238
22400994,4,232,2.0,0.5172413793103449,232,0
22400995,1,293,-1.0,-0.20477815699658702,720,427
22400995,1,71,1.0,0.8450704225352113,408,337
22400995,1,98,-4.0,-2.4489795918367343,337,239
22400995,1,2,0.0,0.0,239,237
22400995,1,232,15.0,3.8793103448275863,232,0
22400995,2,134,-4.0,-1.791044776119403,720,586
22400995,2,71,-2.0,-1.6901408450704225,574,503
22400995,2,17,0.0,0.0,493,476
22400995,2,109,5.0,2.7522935779816518,469,360
22400995,2,97,0.0,0.0,345,248
22400995,2,14,0.0,0.0,248,234
22400995,2,51,2.0,2.3529411764705883,219,168
22400995,2,143,4.0,1.6783216783216783,168,25
22400995,2,25,0.0,0.0,25,0
22400995,3,329,4.0,0.729483282674772,720,391
22400995,3,134,3.0,1.3432835820895521,391,257
22400995,3,84,2.0,1.4285714285714284,255,171
22400995,3,171,-1.0,-0.3508771929824561,171,0
22400995,4,97,5.0,3.092783505154639,720,623
22400995,4,87,1.0,0.6896551724137931,605,518
22400995,4,81,-6.0,-4.444444444444445,505,424
22400995,4,137,-5.0,-2.18978102189781,410,273
22400995,4,13,0.0,0.0,273,260
22400995,4,176,3.0,1.0227272727272727,251,75
22400995,4,55,0.0,0.0,55,0
22400996,1,304,-2.0,-0.39473684210526316,720,416
22400996,1,69,0.0,0.0,397,328
22400996,1,116,-7.0,-3.620689655172414,328,212
22400996,1,33,-4.0,-7.272727272727273,194,161
22400996,1,161,-1.0,-0.37267080745341613,161,0
22400996,2,84,-5.0,-3.571428571428571,720,636
22400996,2,27,-3.0,-6.666666666666666,636,609
22400996,2,49,0.0,0.0,600,551
22400996,2,37,-1.0,-1.6216216216216217,541,504
22400996,2,15,0.0,0.0,504,489
22400996,2,50,0.0,0.0,489,439
22400996,2,112,6.0,3.214285714285714,432,320
22400996,2,192,5.0,1.5625,307,115
22400996,2,42,-3.0,-4.285714285714286,103,61
22400996,2,51,0.0,0.0,51,0
22400996,3,269,1.0,0.22304832713754646,720,451
22400996,3,88,-2.0,-1.3636363636363638,451,363
22400996,3,16,-1.0,-3.75,354,338
22400996,3,75,2.0,1.6,338,263
22400996,3,48,-2.0,-2.5,258,210
22400996,3,32,-3.0,-5.625,210,178
22400996,3,167,-4.0,-1.437125748502994,167,0
22400996,4,171,-4.0,-1.4035087719298245,720,549
22400996,4,97,1.0,0.6185567010309279,536,439
22400996,4,26,3.0,6.923076923076923,439,413
22400996,4,107,-3.0,-1.6822429906542056,409,302
22400996,4,34,0.0,0.0,297,263
22400996,4,46,-4.0,-5.217391304347826,247,201
22400996,4,182,3.0,0.989010989010989,182,0
22400997,1,273,-4.0,-0.8791208791208791,720,447
22400997,1,39,-2.0,-3.0769230769230766,433,394
22400997,1,10,-2.0,-12.0,378,368
22400997,1,143,3.0,1.2587412587412588,363,220
22400997,1,210,-1.0,-0.28571428571428575,210,0
22400997,2,161,9.0,3.3540372670807455,720,559
22400997,2,120,-1.0,-0.5,538,418
22400997,2,162,-4.0,-1.4814814814814814,418,256
22400997,2,61,0.0,0.0,256,195
22400997,2,134,1.0,0.44776119402985076,181,47
22400997,2,15,0.0,0.0,47,32
22400997,2,32,-1.0,-1.875,32,0
22400997,3,275,7.0,1.5272727272727273,720,445
22400997,3,135,-4.0,-1.777777777777778,340,205
22400997,3,35,2.0,3.4285714285714284,186,151
22400997,3,10,1.0,6.0,151,141
22400997,3,141,5.0,2.127659574468085,141,0
22400997,4,118,4.0,2.0338983050847457,720,602
22400997,4,42,2.0,2.8571428571428568,593,551
22400997,4,45,-4.0,-5.333333333333334,535,490
22400997,4,17,-1.0,-3.5294117647058822,470,453
22400997,4,135,-1.0,-0.4444444444444445,446,311
22400997,4,89,2.0,1.348314606741573,300,211
22400997,4,122,5.0,2.4590163934426226,199,77
22400997,4,68,0.0,0.0,68,0
22400998,1,266,2.0,0.45112781954887216,720,454
22400998,1,66,-2.0,-1.8181818181818183,454,388
22400998,1,53,4.0,4.528301886792453,365,312
22400998,1,52,0.0,0.0,312,260
22400998,1,3,0.0,0.0,244,241
22400998,1,21,2.0,5.7142857142857135,225,204
22400998,1,43,-2.0,-2.7906976744186047,204,161
22400998,1,161,8.0,2.981366459627329,161,0
22400998,2,183,1.0,0.32786885245901637,720,537
22400998,2,128,2.0,0.9375,537,409
22400998,2,47,-5.0,-6.382978723404255,396,349
22400998,2,104,-2.0,-1.153846153846154,333,229
22400998,2,25,-2.0,-4.8,227,202
22400998,2,136,7.0,3.0882352941176467,186,50
22400998,2,50,-3.0,-3.5999999999999996,50,0
22400998,3,17,2.0,7.0588235294117645,720,703
22400998,3,163,-6.0,-2.208588957055215,703,540
22400998,3,120,-1.0,-0.5,540,420
22400998,3,99,-2.0,-1.2121212121212122,420,321
22400998,3,41,-1.0,-1.4634146341463414,309,268
22400998,3,54,3.0,3.333333333333333,268,214
22400998,3,90,1.0,0.6666666666666667,201,111
22400998,3,111,-3.0,-1.6216216216216217,111,0
22400998,4,164,-3.0,-1.097560975609756,720,556
22400998,4,72,-2.0,-1.6666666666666665,556,484
22400998,4,31,-1.0,-1.935483870967742,475,444
22400998,4,68,-3.0,-2.647058823529412,444,376
22400998,4,10,0.0,0.0,368,358
22400998,4,32,3.0,5.625,354,322
22400998,4,61,3.0,2.9508196721311473,299,238
22400998,4,81,1.0,0.7407407407407407,238,157
22400998,4,128,2.0,0.9375,157,29
22400998,4,3,0.0,0.0,29,26
22400998,4,12,3.0,15.0,26,14
22400998,4,3,0.0,0.0,12,9
22400998,4,9,2.0,13.333333333333332,9,0
22400999,1,238,-1.0,-0.25210084033613445,720,482
22400999,1,52,2.0,2.307692307692308,482,430
22400999,1,117,5.0,2.5641025641025643,430,313
22400999,1,144,-4.0,-1.6666666666666665,288,144
22400999,1,53,-5.0,-5.660377358490567,134,81
22400999,1,70,-3.0,-2.5714285714285716,70,0
22400999,2,140,6.0,2.5714285714285716,720,580
22400999,2,27,0.0,0.0,580,553
22400999,2,73,5.0,4.10958904109589,553,480
22400999,2,88,2.0,1.3636363636363638,480,392
22400999,2,212,-7.0,-1.9811320754716981,392,180
22400999,2,58,-3.0,-3.103448275862069,166,108
22400999,2,108,-3.0,-1.6666666666666665,108,0
22400999,3,340,0.0,0.0,720,380
22400999,3,111,-4.0,-2.1621621621621623,370,259
22400999,3,32,-7.0,-13.125,259,227
22400999,3,137,-3.0,-1.3138686131386863,218,81
22400999,4,233,2.0,0.5150214592274678,720,487
22400999,4,6,-2.0,-20.0,421,415
22400999,4,106,0.0,0.0,415,309
22400999,4,53,2.0,2.2641509433962264,292,239
22400999,4,43,0.0,0.0,227,184
22400999,4,125,2.0,0.96,165,40
22400999,4,8,0.0,0.0,36,28
22400999,4,1,-1.0,-60.0,28,27
22400999,4,27,0.0,0.0,27,0
22401000,1,242,1.0,0.24793388429752067,720,478
22401000,1,111,4.0,2.1621621621621623,469,358
22401000,1,45,2.0,2.666666666666667,358,313
22401000,1,144,4.0,1.6666666666666665,299,155
22401000,1,41,0.0,0.0,134,93
22401000,1,85,-1.0,-0.7058823529411764,85,0
22401000,2,241,-5.0,-1.2448132780082988,720,479
22401000,2,67,-1.0,-0.8955223880597015,479,412
22401000,2,27,0.0,0.0,412,385
22401000,2,125,-4.0,-1.92,385,260
22401000,2,234,3.0,0.7692307692307692,239,5
22401000,3,342,1.0,0.17543859649122806,720,378
22401000,3,61,-4.0,-3.934426229508197,353,292
22401000,3,97,2.0,1.2371134020618557,285,188
22401000,3,164,2.0,0.7317073170731707,164,0
22401000,4,118,2.0,1.0169491525423728,720,602
22401000,4,139,-3.0,-1.2949640287769786,586,447
22401000,4,5,0.0,0.0,447,442
22401000,4,138,-2.0,-0.8695652173913043,435,297
22401000,4,77,-2.0,-1.5584415584415585,297,220
22401000,4,82,-2.0,-1.4634146341463414,205,123
22401000,4,89,-1.0,-0.6741573033707865,107,18
22401000,4,2,0.0,0.0,2,0
22401001,1,232,4.0,1.0344827586206897,720,488
22401001,1,93,1.0,0.6451612903225807,488,395
22401001,1,180,2.0,0.6666666666666667,395,215
22401001,1,32,0.0,0.0,200,168
22401001,1,104,1.0,0.576923076923077,168,64
22401001,1,53,-2.0,-2.2641509433962264,53,0
22401001,2,184,5.0,1.6304347826086956,720,536
22401001,2,57,-3.0,-3.1578947368421053,526,469
22401001,2,35,0.0,0.0,469,434
22401001,2,139,-4.0,-1.7266187050359714,431,292
22401001,2,17,1.0,3.5294117647058822,283,266
22401001,2,55,0.0,0.0,266,211
22401001,2,39,0.0,0.0,211,172
22401001,2,76,1.0,0.7894736842105263,156,80
22401001,2,67,-1.0,-0.8955223880597015,80,13
22401001,2,13,0.0,0.0,13,0
22401001,3,256,-2.0,-0.46875,720,464
22401001,3,48,4.0,5.0,464,416
22401001,3,43,-3.0,-4.186046511627907,406,363
22401001,3,26,0.0,0.0,360,334
22401001,3,13,2.0,9.230769230769232,319,306
22401001,3,40,0.0,0.0,306,266
22401001,3,41,0.0,0.0,266,225
22401001,3,48,3.0,3.75,225,177
22401001,3,157,-7.0,-2.6751592356687897,157,0
22401001,4,178,1.0,0.33707865168539325,720,542
22401001,4,108,-2.0,-1.1111111111111112,526,418
22401001,4,118,3.0,1.5254237288135595,402,284
22401001,4,43,-3.0,-4.186046511627907,284,241
22401001,4,9,0.0,0.0,241,232
22401001,4,32,-2.0,-3.75,232,200
22401001,4,28,4.0,8.571428571428571,188,160
22401001,4,156,-5.0,-1.923076923076923,160,4
22401002,1,227,11.0,2.907488986784141,720,493
22401002,1,78,-3.0,-2.307692307692308,493,415
22401002,1,112,-3.0,-1.607142857142857,405,293
22401002,1,44,-2.0,-2.7272727272727275,279,235
22401002,1,106,3.0,1.6981132075471699,235,129
22401002,1,111,5.0,2.7027027027027026,111,0
22401002,2,83,-2.0,-1.4457831325301205,720,637
22401002,2,157,2.0,0.7643312101910829,627,470
22401002,2,49,-5.0,-6.122448979591837,456,407
22401002,2,39,1.0,1.5384615384615383,386,347
22401002,2,35,0.0,0.0,338,303
22401002,2,154,-2.0,-0.7792207792207793,289,135
22401002,2,129,6.0,2.7906976744186047,129,0
22401002,3,293,8.0,1.6382252559726962,720,427
22401002,3,56,-2.0,-2.142857142857143,420,364
22401002,3,61,1.0,0.9836065573770493,364,303
22401002,3,143,7.0,2.937062937062937,303,160
22401002,3,160,2.0,0.75,160,0
22401002,4,168,6.0,2.142857142857143,720,552
22401002,4,15,0.0,0.0,542,527
22401002,4,108,3.0,1.6666666666666665,509,401
22401002,4,234,-9.0,-2.307692307692308,388,154
22401002,4,154,3.0,1.1688311688311688,154,0
22401003,1,327,9.0,1.651376146788991,720,393
22401003,1,50,0.0,0.0,393,343
22401003,1,71,8.0,6.76056338028169,332,261
22401003,1,145,-4.0,-1.6551724137931034,251,106
22401003,1,58,2.0,2.0689655172413794,99,41
22401003,1,34,0.0,0.0,39,5
22401003,2,55,-3.0,-3.2727272727272725,720,665
22401003,2,68,2.0,1.7647058823529411,665,597
22401003,2,224,7.0,1.875,597,373
22401003,2,58,4.0,4.137931034482759,370,312
22401003,2,10,1.0,6.0,301,291
22401003,2,74,0.0,0.0,291,217
22401003,2,24,0.0,0.0,200,176
22401003,2,169,1.0,0.35502958579881655,169,0
22401003,3,335,-16.0,-2.8656716417910446,720,385
22401003,3,139,2.0,0.8633093525179857,370,231
22401003,3,78,4.0,3.0769230769230766,221,143
22401003,4,39,0.0,0.0,720,681
22401003,4,23,4.0,10.434782608695652,673,650
22401003,4,127,0.0,0.0,650,523
22401003,4,35,-4.0,-6.857142857142857,515,480
22401003,4,101,-1.0,-0.594059405940594,480,379
22401003,4,65,1.0,0.9230769230769231,379,314
22401003,4,65,0.0,0.0,302,237
22401003,4,111,5.0,2.7027027027027026,218,107
22401003,4,104,-2.0,-1.153846153846154,107,3
22401004,1,324,-5.0,-0.9259259259259258,720,396
22401004,1,32,-1.0,-1.875,373,341
22401004,1,43,2.0,2.7906976744186047,341,298
22401004,1,13,0.0,0.0,298,285
22401004,1,85,6.0,4.235294117647059,285,200
22401004,1,186,5.0,1.6129032258064517,186,0
22401004,2,41,2.0,2.926829268292683,720,679
22401004,2,86,0.0,0.0,670,584
22401004,2,82,2.0,1.4634146341463414,578,496
22401004,2,76,1.0,0.7894736842105263,484,408
22401004,2,39,-2.0,-3.0769230769230766,408,369
22401004,2,291,-8.0,-1.6494845360824741,364,73
22401004,2,43,-1.0,-1.3953488372093024,43,0
22401004,3,317,3.0,0.5678233438485805,720,403
22401004,3,45,2.0,2.666666666666667,397,352
22401004,3,75,2.0,1.6,352,277
22401004,3,19,1.0,3.1578947368421053,277,258
22401004,3,149,-6.0,-2.4161073825503356,258,109
22401004,3,109,-1.0,-0.5504587155963303,109,0
22401004,4,135,-3.0,-1.3333333333333335,720,585
22401004,4,79,-2.0,-1.5189873417721518,585,506
22401004,4,54,-3.0,-3.333333333333333,495,441
22401004,4,71,-2.0,-1.6901408450704225,441,370
22401004,4,56,-1.0,-1.0714285714285714,370,314
22401004,4,133,2.0,0.9022556390977443,314,181
22401004,4,136,-2.0,-0.8823529411764706,181,45
22401004,4,44,0.0,0.0,45,1
22401004,5,94,-2.0,-1.2765957446808511,300,206
22401004,5,112,3.0,1.607142857142857,206,94
22401004,5,57,-2.0,-2.1052631578947367,88,31
22401004,5,12,2.0,10.0,29,17
22401004,5,16,0.0,0.0,16,0
22401005,1,259,3.0,0.6949806949806949,720,461
22401005,1,57,-2.0,-2.1052631578947367,461,404
22401005,1,63,-3.0,-2.8571428571428568,383,320
22401005,1,64,-3.0,-2.8125,307,243
22401005,1,67,1.0,0.8955223880597015,232,165
22401005,1,62,-1.0,-0.967741935483871,165,103
22401005,1,76,0.0,0.0,103,27
22401005,1,9,0.0,0.0,9,0
22401005,2,290,1.0,0.20689655172413793,720,430
22401005,2,71,3.0,2.535211267605634,422,351
22401005,2,18,0.0,0.0,351,333
22401005,2,172,1.0,0.3488372093023256,322,150
22401005,2,91,-3.0,-1.978021978021978,146,55
22401005,2,55,-2.0,-2.1818181818181817,55,0
22401005,3,96,-1.0,-0.625,720,624
22401005,3,164,-4.0,-1.4634146341463414,624,460
22401005,3,56,-2.0,-2.142857142857143,460,404
22401005,3,37,2.0,3.2432432432432434,396,359
22401005,3,64,-6.0,-5.625,359,295
22401005,3,91,1.0,0.6593406593406594,295,204
22401005,3,97,2.0,1.2371134020618557,197,100
22401005,3,43,2.0,2.7906976744186047,94,51
22401005,3,51,3.0,3.5294117647058822,51,0
22401005,4,131,1.0,0.4580152671755725,720,589
22401005,4,2,0.0,0.0,476,474
22401005,4,66,-3.0,-2.7272727272727275,459,393
22401005,4,147,6.0,2.4489795918367343,393,246
22401005,4,167,-2.0,-0.718562874251497,219,52
22401005,4,23,1.0,2.608695652173913,38,15
22401005,4,4,1.0,15.0,4,0
22401006,1,348,3.0,0.5172413793103449,720,372
22401006,1,53,6.0,6.7924528301886795,368,315
22401006,1,44,6.0,8.181818181818182,307,263
22401006,1,49,0.0,0.0,263,214
22401006,1,27,3.0,6.666666666666666,201,174
22401006,1,150,0.0,0.0,166,16
22401006,1,4,0.0,0.0,4,0
22401006,2,85,7.0,4.9411764705882355,720,635
22401006,2,128,1.0,0.46875,624,496
22401006,2,115,2.0,1.0434782608695652,477,362
22401006,2,101,-1.0,-0.594059405940594,362,261
22401006,2,44,1.0,1.3636363636363638,252,208
22401006,2,6,0.0,0.0,189,183
22401006,2,39,-2.0,-3.0769230769230766,183,144
22401006,3,305,3.0,0.5901639344262296,720,415
22401006,3,58,-2.0,-2.0689655172413794,402,344
22401006,3,61,7.0,6.885245901639345,332,271
22401006,3,71,3.0,2.535211267605634,254,183
22401006,3,17,0.0,0.0,183,166
22401006,3,147,3.0,1.2244897959183672,166,19
22401006,4,221,-5.0,-1.3574660633484164,720,499
22401006,4,90,-1.0,-0.6666666666666667,485,395
22401006,4,46,-3.0,-3.9130434782608696,395,349
22401006,4,111,-5.0,-2.7027027027027026,349,238
22401006,4,227,-4.0,-1.0572687224669604,227,0
22401007,1,257,2.0,0.4669260700389105,720,463
22401007,1,133,-2.0,-0.9022556390977443,449,316
22401007,1,33,0.0,0.0,308,275
22401007,1,62,-2.0,-1.935483870967742,261,199
22401007,1,171,5.0,1.7543859649122806,187,16
22401007,1,56,0.0,0.0,56,0
22401007,2,173,1.0,0.3468208092485549,720,547
22401007,2,41,0.0,0.0,533,492
22401007,2,15,0.0,0.0,486,471
22401007,2,29,-4.0,-8.275862068965518,460,431
22401007,2,44,0.0,0.0,431,387
22401007,2,24,-1.0,-2.5,382,358
22401007,2,161,9.0,3.3540372670807455,358,197
22401007,2,197,0.0,0.0,197,0
22401007,3,367,3.0,0.49046321525885556,720,353
22401007,3,10,2.0,12.0,343,333
22401007,3,51,4.0,4.705882352941177,333,282
22401007,3,20,-2.0,-6.0,268,248
22401007,3,31,1.0,1.935483870967742,248,217
22401007,3,178,-2.0,-0.6741573033707865,217,39
22401007,3,35,-2.0,-3.4285714285714284,35,0
22401007,4,143,2.0,0.8391608391608392,720,577
22401007,4,80,1.0,0.75,577,497
22401007,4,115,-4.0,-2.0869565217391304,485,370
22401007,4,57,0.0,0.0,350,293
22401007,4,34,-2.0,-3.5294117647058822,177,143
22401007,4,63,-1.0,-0.9523809523809523,143,80
22401007,4,4,0.0,0.0,68,64
22401007,4,29,-3.0,-6.206896551724138,55,26
22401007,4,6,-1.0,-10.0,25,19
22401007,4,19,0.0,0.0,19,0
22401008,1,270,7.0,1.5555555555555556,720,450
22401008,1,51,2.0,2.3529411764705883,437,386
22401008,1,132,-1.0,-0.4545454545454546,369,237
22401008,1,113,0.0,0.0,237,124
22401008,1,112,-1.0,-0.5357142857142857,112,0
22401008,2,130,-2.0,-0.9230769230769231,720,590
22401008,2,95,1.0,0.631578947368421,579,484
22401008,2,58,-2.0,-2.0689655172413794,484,426
22401008,2,70,3.0,2.5714285714285716,413,343
22401008,2,13,1.0,4.615384615384616,330,317
22401008,2,59,1.0,1.0169491525423728,317,258
22401008,2,15,-1.0,-4.0,251,236
22401008,2,106,0.0,0.0,236,130
22401008,2,90,0.0,0.0,117,27
22401008,2,22,1.0,2.7272727272727275,27,5
22401008,2,5,0.0,0.0,5,0
22401008,3,246,4.0,0.9756097560975611,720,474
22401008,3,94,-1.0,-0.6382978723404256,474,380
22401008,3,134,-5.0,-2.2388059701492535,380,246
22401008,3,71,-2.0,-1.6901408450704225,234,163
22401008,3,56,-2.0,-2.142857142857143,151,95
22401008,3,83,2.0,1.4457831325301205,95,12
22401008,3,12,-2.0,-10.0,12,0
22401008,4,68,2.0,1.7647058823529411,720,652
22401008,4,18,2.0,6.666666666666666,652,634
22401008,4,141,-1.0,-0.425531914893617,623,482
22401008,4,55,-2.0,-2.1818181818181817,458,403
22401008,4,34,1.0,1.7647058823529411,394,360
22401008,4,47,4.0,5.1063829787234045,360,313
22401008,4,27,0.0,0.0,313,286
22401008,4,151,6.0,2.384105960264901,271,120
22401008,4,97,-5.0,-3.092783505154639,97,0
22401009,1,330,-5.0,-0.9090909090909092,720,390
22401009,1,206,-7.0,-2.0388349514563107,390,184
22401009,1,158,6.0,2.278481012658228,158,0
22401009,2,194,5.0,1.5463917525773194,720,526
22401009,2,9,0.0,0.0,505,496
22401009,2,25,-2.0,-4.8,490,465
22401009,2,12,0.0,0.0,450,438
22401009,2,65,0.0,0.0,424,359
22401009,2,90,4.0,2.666666666666667,353,263
22401009,2,34,-2.0,-3.5294117647058822,263,229
22401009,2,158,1.0,0.37974683544303794,221,63
22401009,2,24,-2.0,-5.0,63,39
22401009,3,251,3.0,0.7171314741035857,720,469
22401009,3,107,2.0,1.1214953271028036,454,347
22401009,3,58,0.0,0.0,333,275
22401009,3,129,8.0,3.7209302325581395,275,146
22401009,3,118,-10.0,-5.084745762711864,128,10
22401009,3,1,0.0,0.0,1,0
22401009,4,124,0.0,0.0,720,596
22401009,4,44,-3.0,-4.090909090909091,585,541
22401009,4,47,-1.0,-1.2765957446808511,515,468
22401009,4,34,-1.0,-1.7647058823529411,468,434
22401009,4,53,0.0,0.0,417,364
22401009,4,72,7.0,5.833333333333333,356,284
22401009,4,144,2.0,0.8333333333333333,273,129
22401009,4,129,1.0,0.46511627906976744,129,0
22401010,1,226,2.0,0.5309734513274336,720,494
22401010,1,64,2.0,1.875,494,430
22401010,1,59,-3.0,-3.050847457627119,421,362
22401010,1,9,0.0,0.0,362,353
22401010,1,193,3.0,0.9326424870466321,353,160
22401010,1,110,3.0,1.6363636363636362,142,32
22401010,1,32,0.0,0.0,32,0
22401010,2,96,-1.0,-0.625,720,624
22401010,2,2,0.0,0.0,612,610
22401010,2,75,0.0,0.0,600,525
22401010,2,42,2.0,2.8571428571428568,517,475
22401010,2,131,2.0,0.916030534351145,475,344
22401010,2,83,-4.0,-2.891566265060241,344,261
22401010,2,114,2.0,1.0526315789473684,241,127
22401010,2,84,-1.0,-0.7142857142857142,127,43
22401010,3,218,-2.0,-0.5504587155963303,720,502
22401010,3,20,1.0,3.0,502,482
22401010,3,109,1.0,0.5504587155963303,482,373
22401010,3,176,1.0,0.34090909090909094,373,197
22401010,3,13,0.0,0.0,181,168
22401010,3,119,5.0,2.521008403361345,156,37
22401010,3,37,-2.0,-3.2432432432432434,37,0
22401010,4,99,0.0,0.0,720,621
22401010,4,201,-3.0,-0.8955223880597015,605,404
22401010,4,38,2.0,3.1578947368421053,397,359
22401010,4,36,-3.0,-5.0,347,311
22401010,4,191,4.0,1.256544502617801,311,120
22401010,4,40,0.0,0.0,120,80
22401010,4,70,-2.0,-1.7142857142857142,70,0
22401011,1,214,0.0,0.0,720,506
22401011,1,85,4.0,2.8235294117647056,495,410
22401011,1,39,-4.0,-6.153846153846153,410,371
22401011,1,40,4.0,6.0,357,317
22401011,1,95,-3.0,-1.8947368421052633,317,222
22401011,1,69,-1.0,-0.8695652173913043,211,142
22401011,1,142,-7.0,-2.957746478873239,142,0
22401011,2,42,-2.0,-2.8571428571428568,720,678
22401011,2,29,-3.0,-6.206896551724138,659,630
22401011,2,130,5.0,2.307692307692308,588,458
22401011,2,65,3.0,2.769230769230769,458,393
22401011,2,46,-3.0,-3.9130434782608696,371,325
22401011,2,162,-2.0,-0.7407407407407407,312,150
22401011,2,11,-1.0,-5.454545454545455,147,136
22401011,2,136,0.0,0.0,136,0
22401011,3,304,1.0,0.19736842105263158,720,416
22401011,3,63,4.0,3.8095238095238093,402,339
22401011,3,92,3.0,1.9565217391304348,339,247
22401011,3,20,-2.0,-6.0,247,227
22401011,3,28,-1.0,-2.142857142857143,211,183
22401011,3,21,0.0,0.0,183,162
22401011,3,108,2.0,1.1111111111111112,147,39
22401011,3,37,0.0,0.0,37,0
22401011,4,87,2.0,1.3793103448275863,720,633
22401011,4,119,-3.0,-1.5126050420168067,633,514
22401011,4,27,-2.0,-4.444444444444445,501,474
22401011,4,174,0.0,0.0,462,288
22401011,4,39,2.0,3.0769230769230766,264,225
22401011,4,223,2.0,0.5381165919282511,223,0
22401011,5,17,0.0,0.0,300,283
22401011,5,283,7.0,1.4840989399293285,283,0
22401012,1,280,7.0,1.5,720,440
22401012,1,10,0.0,0.0,440,430
22401012,1,63,-1.0,-0.9523809523809523,427,364
22401012,1,57,-5.0,-5.263157894736842,364,307
22401012,1,84,2.0,1.4285714285714284,301,217
22401012,1,28,-2.0,-4.285714285714286,217,189
22401012,1,26,-3.0,-6.923076923076923,166,140
22401012,1,134,3.0,1.3432835820895521,140,6
22401012,2,162,5.0,1.8518518518518516,720,558
22401012,2,32,0.0,0.0,549,517
22401012,2,54,0.0,0.0,512,458
22401012,2,92,-1.0,-0.6521739130434783,442,350
22401012,2,28,0.0,0.0,344,316
22401012,2,136,4.0,1.7647058823529411,316,180
22401012,2,40,0.0,0.0,171,131
22401012,2,105,0.0,0.0,131,26
22401012,2,24,0.0,0.0,26,2
22401012,3,219,-7.0,-1.917808219178082,720,501
22401012,3,91,-3.0,-1.978021978021978,473,382
22401012,3,122,-3.0,-1.4754098360655736,369,247
22401012,3,28,0.0,0.0,240,212
22401012,3,109,1.0,0.5504587155963303,212,103
22401012,3,66,-1.0,-0.9090909090909092,92,26
22401012,3,26,3.0,6.923076923076923,26,0
22401012,4,22,0.0,0.0,720,698
22401012,4,101,8.0,4.752475247524752,698,597
22401012,4,118,-2.0,-1.0169491525423728,587,469
22401012,4,23,2.0,5.217391304347826,469,446
22401012,4,169,-1.0,-0.35502958579881655,433,264
22401012,4,1,0.0,0.0,256,255
22401012,4,255,6.0,1.4117647058823528,255,0
22401013,1,244,6.0,1.4754098360655736,720,476
22401013,1,58,-2.0,-2.0689655172413794,457,399
22401013,1,54,1.0,1.1111111111111112,399,345
22401013,1,47,3.0,3.829787234042553,332,285
22401013,1,30,2.0,4.0,271,241
22401013,1,62,-3.0,-2.903225806451613,241,179
22401013,1,163,5.0,1.8404907975460123,163,0
22401013,2,83,-2.0,-1.4457831325301205,720,637
22401013,2,90,7.0,4.666666666666667,632,542
22401013,2,27,0.0,0.0,528,501
22401013,2,61,2.0,1.9672131147540985,482,421
22401013,2,108,1.0,0.5555555555555556,414,306
22401013,2,95,1.0,0.631578947368421,295,200
22401013,2,52,-4.0,-4.615384615384616,200,148
22401013,2,128,-2.0,-0.9375,128,0
22401013,3,205,-4.0,-1.170731707317073,720,515
22401013,3,15,-3.0,-12.0,502,487
22401013,3,11,1.0,5.454545454545455,487,476
22401013,3,29,2.0,4.137931034482759,476,447
22401013,3,164,0.0,0.0,433,269
22401013,3,57,0.0,0.0,258,201
22401013,3,35,-5.0,-8.571428571428571,201,166
22401013,3,8,0.0,0.0,160,152
22401013,3,19,-2.0,-6.315789473684211,152,133
22401013,3,35,2.0,3.4285714285714284,133,98
22401013,3,98,2.0,1.2244897959183672,98,0
22401013,4,96,0.0,0.0,720,624
22401013,4,70,5.0,4.285714285714286,624,554
22401013,4,116,-5.0,-2.586206896551724,554,438
22401013,4,9,0.0,0.0,438,429
22401013,4,12,-1.0,-5.0,414,402
22401013,4,99,-4.0,-2.4242424242424243,402,303
22401013,4,106,0.0,0.0,282,176
22401013,4,52,-6.0,-6.923076923076923,171,119
22401013,4,112,-3.0,-1.607142857142857,112,0
22401014,1,326,1.0,0.18404907975460122,720,394
22401014,1,11,0.0,0.0,383,372
22401014,1,99,-4.0,-2.4242424242424243,361,262
22401014,1,37,3.0,4.864864864864865,246,209
22401014,1,86,-4.0,-2.7906976744186047,193,107
22401014,1,105,2.0,1.142857142857143,105,0
22401014,2,113,0.0,0.0,720,607
22401014,2,90,-2.0,-1.3333333333333335,595,505
22401014,2,6,1.0,10.0,504,498
22401014,2,63,1.0,0.9523809523809523,498,435
22401014,2,10,-1.0,-6.0,425,415
22401014,2,228,-2.0,-0.5263157894736842,415,187
22401014,2,23,-3.0,-7.826086956521739,176,153
22401014,2,153,-3.0,-1.1764705882352942,153,0
22401014,3,364,-13.0,-2.142857142857143,720,356
22401014,3,88,1.0,0.6818181818181819,332,244
22401014,3,106,1.0,0.5660377358490566,244,138
22401014,3,138,-7.0,-3.0434782608695654,138,0
22401014,4,144,1.0,0.41666666666666663,720,576
22401014,4,36,1.0,1.6666666666666665,556,520
22401014,4,25,-3.0,-7.199999999999999,520,495
22401014,4,91,1.0,0.6593406593406594,489,398
22401014,4,59,2.0,2.0338983050847457,380,321
22401014,4,321,13.0,2.4299065420560746,321,0
22401015,1,313,-2.0,-0.38338658146964855,720,407
22401015,1,40,2.0,3.0,407,367
22401015,1,45,2.0,2.666666666666667,361,316
22401015,1,15,0.0,0.0,316,301
22401015,1,166,4.0,1.4457831325301205,290,124
22401015,1,419,3.0,0.42959427207637235,425,6
22401015,1,6,0.0,0.0,6,0
22401015,2,212,-6.0,-1.6981132075471699,720,508
22401015,2,33,-3.0,-5.454545454545455,490,457
22401015,2,17,1.0,3.5294117647058822,457,440
22401015,2,186,4.0,1.2903225806451615,440,254
22401015,2,82,-3.0,-2.195121951219512,254,172
22401015,2,155,7.0,2.7096774193548385,155,0
22401015,3,307,0.0,0.0,720,413
22401015,3,318,-7.0,-1.320754716981132,579,261
22401015,3,47,2.0,2.5531914893617023,261,214
22401015,3,68,2.0,1.7647058823529411,214,146
22401015,3,58,-4.0,-4.137931034482759,134,76
22401015,4,149,-6.0,-2.4161073825503356,720,571
22401015,4,67,1.0,0.8955223880597015,551,484
22401015,4,38,-3.0,-4.7368421052631575,482,444
22401015,4,24,-2.0,-5.0,440,416
22401015,4,44,0.0,0.0,401,357
22401015,4,63,2.0,1.9047619047619047,328,265
22401015,4,55,0.0,0.0,255,200
22401015,4,139,-1.0,-0.43165467625899284,188,49
22401016,1,370,3.0,0.4864864864864865,720,350
22401016,1,12,0.0,0.0,329,317
22401016,1,34,0.0,0.0,317,283
22401016,1,34,0.0,0.0,272,238
22401016,1,36,-2.0,-3.333333333333333,229,193
22401016,1,75,1.0,0.8,193,118
22401016,1,16,0.0,0.0,103,87
22401016,1,84,4.0,2.8571428571428568,84,0
22401016,2,210,-10.0,-2.8571428571428568,720,510
22401016,2,18,2.0,6.666666666666666,501,483
22401016,2,45,2.0,2.666666666666667,477,432
22401016,2,82,0.0,0.0,412,330
22401016,2,16,0.0,0.0,316,300
22401016,2,53,0.0,0.0,295,242
22401016,2,73,-2.0,-1.643835616438356,237,164
22401016,2,162,7.0,2.5925925925925926,164,2
22401016,3,205,4.0,1.170731707317073,720,515
22401016,3,58,1.0,1.0344827586206897,509,451
22401016,3,54,0.0,0.0,451,397
22401016,3,32,3.0,5.625,382,350
22401016,3,57,0.0,0.0,336,279
22401016,3,154,2.0,0.7792207792207793,259,105
22401016,3,74,1.0,0.8108108108108109,105,31
22401016,3,31,0.0,0.0,31,0
22401016,4,160,8.0,3.0,720,560
22401016,4,88,-1.0,-0.6818181818181819,560,472
22401016,4,82,3.0,2.195121951219512,472,390
22401016,4,105,3.0,1.7142857142857142,430,325
22401016,4,317,4.0,0.7570977917981072,317,0
22401017,1,160,3.0,1.125,720,560
22401017,1,207,3.0,0.8695652173913043,551,344
22401017,1,30,0.0,0.0,319,289
22401017,1,157,6.0,2.2929936305732483,283,126
22401017,1,115,1.0,0.5217391304347826,115,0
22401017,2,55,4.0,4.363636363636363,720,665
22401017,2,124,2.0,0.967741935483871,655,531
22401017,2,119,-5.0,-2.521008403361345,531,412
22401017,2,69,-2.0,-1.7391304347826086,405,336
22401017,2,28,1.0,2.142857142857143,336,308
22401017,2,80,-2.0,-1.5,308,228
22401017,2,34,3.0,5.294117647058824,210,176
22401017,2,119,-2.0,-1.0084033613445378,159,40
22401017,3,330,3.0,0.5454545454545454,720,390
22401017,3,15,0.0,0.0,371,356
22401017,3,55,4.0,4.363636363636363,347,292
22401017,3,74,1.0,0.8108108108108109,292,218
22401017,3,207,0.0,0.0,207,0
22401017,4,190,1.0,0.3157894736842105,720,530
22401017,4,80,3.0,2.25,521,441
22401017,4,34,-3.0,-5.294117647058824,439,405
22401017,4,34,5.0,8.823529411764707,405,371
22401017,4,354,4.0,0.6779661016949152,354,0
22401018,1,440,-3.0,-0.40909090909090906,720,280
22401018,1,55,3.0,3.2727272727272725,280,225
22401018,1,3,0.0,0.0,195,192
22401018,1,74,0.0,0.0,176,102
22401018,1,13,0.0,0.0,100,87
22401018,1,87,1.0,0.6896551724137931,87,0
22401018,2,151,4.0,1.5894039735099337,720,569
22401018,2,37,2.0,3.2432432432432434,560,523
22401018,2,65,2.0,1.8461538461538463,523,458
22401018,2,21,0.0,0.0,458,437
22401018,2,80,-2.0,-1.5,429,349
22401018,2,133,0.0,0.0,341,208
22401018,2,208,1.0,0.2884615384615385,208,0
22401018,3,359,0.0,0.0,720,361
22401018,3,84,-5.0,-3.571428571428571,361,277
22401018,3,129,-4.0,-1.8604651162790697,270,141
22401018,3,132,-7.0,-3.181818181818182,132,0
22401018,4,147,1.0,0.40816326530612246,720,573
22401018,4,130,-4.0,-1.8461538461538463,573,443
22401018,4,147,6.0,2.4489795918367343,430,283
22401018,4,64,4.0,3.75,258,194
22401018,4,86,2.0,1.3953488372093024,173,87
22401018,4,76,7.0,5.526315789473684,76,0
22401019,1,294,8.0,1.6326530612244898,720,426
22401019,1,54,1.0,1.1111111111111112,426,372
22401019,1,83,-2.0,-1.4457831325301205,361,278
22401019,1,68,-5.0,-4.411764705882353,271,203
22401019,1,96,3.0,1.875,189,93
22401019,2,143,-4.0,-1.6783216783216783,720,577
22401019,2,79,-2.0,-1.5189873417721518,540,461
22401019,2,61,0.0,0.0,453,392
22401019,2,30,2.0,4.0,392,362
22401019,2,54,1.0,1.1111111111111112,337,283
22401019,2,23,-1.0,-2.608695652173913,275,252
22401019,2,99,-2.0,-1.2121212121212122,252,153
22401019,2,42,1.0,1.4285714285714284,141,99
22401019,2,69,0.0,0.0,99,30
22401019,2,30,-1.0,-2.0,30,0
22401019,3,245,0.0,0.0,720,475
22401019,3,129,6.0,2.7906976744186047,468,339
22401019,3,80,-3.0,-2.25,339,259
22401019,3,8,0.0,0.0,226,218
22401019,3,50,2.0,2.4,208,158
22401019,3,118,-2.0,-1.0169491525423728,142,24
22401019,3,24,0.0,0.0,24,0
22401019,4,107,4.0,2.2429906542056073,720,613
22401019,4,43,-2.0,-2.7906976744186047,599,556
22401019,4,196,-2.0,-0.6122448979591836,548,352
22401019,4,71,3.0,2.535211267605634,334,263
22401019,4,200,-2.0,-0.6,248,48
22401019,4,3,-1.0,-20.0,48,45
22401019,4,4,1.0,15.0,4,0
22401020,1,240,-9.0,-2.25,720,480
22401020,1,224,-1.0,-0.26785714285714285,464,240
22401020,1,52,0.0,0.0,183,131
22401020,1,82,-1.0,-0.7317073170731707,111,29
22401020,1,29,0.0,0.0,29,0
22401020,2,175,5.0,1.7142857142857142,720,545
22401020,2,57,-1.0,-1.0526315789473684,545,488
22401020,2,110,-1.0,-0.5454545454545454,487,377
22401020,2,196,1.0,0.3061224489795918,355,159
22401020,2,100,1.0,0.6,142,42
22401020,2,9,2.0,13.333333333333332,42,33
22401020,2,33,-2.0,-3.6363636363636367,33,0
22401020,3,256,5.0,1.171875,720,464
22401020,3,40,1.0,1.5,448,408
22401020,3,42,-5.0,-7.142857142857142,389,347
22401020,3,41,-3.0,-4.390243902439024,327,286
22401020,3,91,-5.0,-3.2967032967032965,269,178
22401020,3,175,-1.0,-0.34285714285714286,175,0
22401020,4,195,2.0,0.6153846153846154,720,525
22401020,4,81,-6.0,-4.444444444444445,509,428
22401020,4,117,1.0,0.5128205128205129,428,311
22401020,4,101,0.0,0.0,291,190
22401020,4,58,-2.0,-2.0689655172413794,190,132
22401021,1,308,8.0,1.5584415584415585,720,412
22401021,1,47,1.0,1.2765957446808511,388,341
22401021,1,31,3.0,5.806451612903226,341,310
22401021,1,23,-1.0,-2.608695652173913,301,278
22401021,1,275,-2.0,-0.43636363636363634,278,3
22401021,2,287,10.0,2.090592334494773,720,433
22401021,2,104,-1.0,-0.576923076923077,433,329
22401021,2,105,5.0,2.8571428571428568,317,212
22401021,2,51,0.0,0.0,202,151
22401021,2,14,0.0,0.0,136,122
22401021,3,273,4.0,0.8791208791208791,720,447
22401021,3,12,0.0,0.0,433,421
22401021,3,47,2.0,2.5531914893617023,414,367
22401021,3,97,0.0,0.0,367,270
22401021,3,14,2.0,8.571428571428571,261,247
22401021,3,131,-1.0,-0.4580152671755725,247,116
22401021,3,58,0.0,0.0,116,58
22401021,3,58,2.0,2.0689655172413794,58,0
22401021,4,276,-5.0,-1.0869565217391304,720,444
22401021,4,239,0.0,0.0,677,438
22401021,4,173,-3.0,-1.0404624277456647,424,251
22401021,4,113,-5.0,-2.6548672566371683,245,132
22401021,4,120,4.0,2.0,120,0
22401022,1,228,-7.0,-1.8421052631578947,720,492
22401022,1,133,3.0,1.3533834586466165,482,349
22401022,1,10,0.0,0.0,349,339
22401022,1,119,2.0,1.0084033613445378,320,201
22401022,1,25,0.0,0.0,201,176
22401022,1,59,0.0,0.0,166,107
22401022,1,86,1.0,0.6976744186046512,86,0
22401022,2,132,-1.0,-0.4545454545454546,720,588
22401022,2,98,2.0,1.2244897959183672,576,478
22401022,2,14,0.0,0.0,464,450
22401022,2,12,0.0,0.0,430,418
22401022,2,90,-4.0,-2.666666666666667,418,328
22401022,2,92,5.0,3.260869565217391,314,222
22401022,2,81,3.0,2.2222222222222223,219,138
22401022,2,55,-4.0,-4.363636363636363,118,63
22401022,2,3,0.0,0.0,58,55
22401022,2,32,2.0,3.75,32,0
22401022,3,248,10.0,2.4193548387096775,720,472
22401022,3,94,1.0,0.6382978723404256,455,361
22401022,3,71,-3.0,-2.535211267605634,347,276
22401022,3,51,-1.0,-1.1764705882352942,268,217
22401022,3,101,0.0,0.0,217,116
22401022,3,101,5.0,2.9702970297029703,102,1
22401022,4,169,3.0,1.0650887573964498,720,551
22401022,4,190,6.0,1.8947368421052633,551,361
22401022,4,102,5.0,2.941176470588235,361,259
22401022,4,112,1.0,0.5357142857142857,259,147
22401022,4,132,-4.0,-1.8181818181818183,132,0
22401023,1,359,-3.0,-0.5013927576601671,720,361
22401023,1,96,-3.0,-1.875,344,248
22401023,1,61,-1.0,-0.9836065573770493,232,171
22401023,1,10,0.0,0.0,171,161
22401023,1,142,-3.0,-1.267605633802817,147,5
22401023,2,57,1.0,1.0526315789473684,720,663
22401023,2,86,-1.0,-0.6976744186046512,663,577
22401023,2,54,-5.0,-5.555555555555555,569,515
22401023,2,14,-1.0,-4.285714285714286,496,482
22401023,2,106,3.0,1.6981132075471699,482,376
22401023,2,101,-2.0,-1.188118811881188,362,261
22401023,2,139,2.0,0.8633093525179857,261,122
22401023,2,53,-2.0,-2.2641509433962264,109,56
22401023,2,52,-3.0,-3.4615384615384617,56,4
22401023,2,4,0.0,0.0,4,0
22401023,3,133,9.0,4.060150375939849,720,587
22401023,3,89,5.0,3.3707865168539324,576,487
22401023,3,133,-3.0,-1.3533834586466165,486,353
22401023,3,49,3.0,3.673469387755102,333,284
22401023,3,51,2.0,2.3529411764705883,272,221
22401023,3,91,5.0,3.2967032967032965,210,119
22401023,3,66,2.0,1.8181818181818183,103,37
22401023,4,97,-2.0,-1.2371134020618557,720,623
22401023,4,39,3.0,4.615384615384616,622,583
22401023,4,25,1.0,2.4,580,555
22401023,4,82,2.0,1.4634146341463414,555,473
22401023,4,19,0.0,0.0,473,454
22401023,4,61,-2.0,-1.9672131147540985,446,385
22401023,4,139,-1.0,-0.43165467625899284,366,227
22401023,4,147,4.0,1.6326530612244898,227,80
22401023,4,22,1.0,2.7272727272727275,69,47
22401023,4,47,0.0,0.0,47,0
22401024,1,285,-3.0,-0.631578947368421,720,435
22401024,1,60,0.0,0.0,435,375
22401024,1,42,2.0,2.8571428571428568,357,315
22401024,1,59,2.0,2.0338983050847457,315,256
22401024,1,11,0.0,0.0,234,223
22401024,1,188,-2.0,-0.6382978723404256,223,35
22401024,1,32,-1.0,-1.875,35,3
22401024,1,3,0.0,0.0,3,0
22401024,2,171,0.0,0.0,720,549
22401024,2,29,-1.0,-2.0689655172413794,535,506
22401024,2,71,1.0,0.8450704225352113,506,435
22401024,2,124,4.0,1.935483870967742,429,305
22401024,2,54,0.0,0.0,305,251
22401024,2,148,-3.0,-1.2162162162162162,232,84
22401024,2,72,-2.0,-1.6666666666666665,81,9
22401024,2,79,1.0,0.7594936708860759,84,5
22401024,3,168,3.0,1.0714285714285714,720,552
22401024,3,105,3.0,1.7142857142857142,552,447
22401024,3,72,0.0,0.0,431,359
22401024,3,25,-2.0,-4.8,340,315
22401024,3,74,0.0,0.0,254,180
22401024,3,17,1.0,3.5294117647058822,174,157
22401024,3,142,4.0,1.6901408450704225,148,6
22401024,3,3,0.0,0.0,3,0
22401024,4,98,-4.0,-2.4489795918367343,720,622
22401024,4,167,-7.0,-2.5149700598802394,622,455
22401024,4,29,-3.0,-6.206896551724138,447,418
22401024,4,144,-5.0,-2.0833333333333335,413,269
22401024,4,45,1.0,1.3333333333333335,253,208
22401024,4,200,-2.0,-0.6,208,8
22401024,4,4,-1.0,-15.0,7,3
22401024,4,3,3.0,60.0,3,0
22401025,1,293,6.0,1.2286689419795223,720,427
22401025,1,23,2.0,5.217391304347826,416,393
22401025,1,68,4.0,3.5294117647058822,371,303
22401025,1,10,0.0,0.0,294,284
22401025,1,110,6.0,3.2727272727272725,267,157
22401025,1,136,-1.0,-0.4411764705882353,136,0
22401025,2,30,-2.0,-4.0,720,690
22401025,2,58,0.0,0.0,676,618
22401025,2,84,3.0,2.142857142857143,618,534
22401025,2,63,0.0,0.0,524,461
22401025,2,26,-4.0,-9.230769230769232,461,435
22401025,2,150,1.0,0.4,435,285
22401025,2,193,-1.0,-0.31088082901554404,268,75
22401025,2,75,1.0,0.8,75,0
22401025,3,304,-4.0,-0.7894736842105263,720,416
22401025,3,9,2.0,13.333333333333332,403,394
22401025,3,30,2.0,4.0,384,354
22401025,3,23,3.0,7.826086956521739,335,312
22401025,3,6,0.0,0.0,280,274
22401025,3,25,1.0,2.4,269,244
22401025,3,11,2.0,10.90909090909091,244,233
22401025,3,233,0.0,0.0,233,0
22401025,4,192,4.0,1.25,720,528
22401025,4,131,-5.0,-2.290076335877863,528,397
22401025,4,331,-7.0,-1.2688821752265862,380,49
22401025,4,46,0.0,0.0,46,0
22401026,1,365,10.0,1.643835616438356,720,355
22401026,1,66,1.0,0.9090909090909092,346,280
22401026,1,54,1.0,1.1111111111111112,267,213
22401026,1,213,-1.0,-0.28169014084507044,213,0
22401026,2,232,4.0,1.0344827586206897,720,488
22401026,2,50,6.0,7.199999999999999,475,425
22401026,2,141,2.0,0.851063829787234,417,276
22401026,2,122,-2.0,-0.9836065573770493,264,142
22401026,2,97,0.0,0.0,132,35
22401026,2,30,1.0,2.0,35,5
22401026,3,342,6.0,1.0526315789473684,720,378
22401026,3,20,-9.0,-27.0,369,349
22401026,3,11,0.0,0.0,272,261
22401026,3,40,1.0,1.5,259,219
22401026,3,76,-3.0,-2.3684210526315788,206,130
22401026,3,106,-6.0,-3.3962264150943398,106,0
22401026,4,96,-7.0,-4.375,720,624
22401026,4,117,-1.0,-0.5128205128205129,612,495
22401026,4,15,0.0,0.0,495,480
22401026,4,2,2.0,60.0,462,460
22401026,4,74,2.0,1.6216216216216217,438,364
22401026,4,44,2.0,2.7272727272727275,344,300
22401026,4,40,-2.0,-3.0,290,250
22401026,4,25,3.0,7.199999999999999,250,225
22401026,4,59,0.0,0.0,217,158
22401026,4,29,1.0,2.0689655172413794,158,129
22401026,4,117,2.0,1.0256410256410258,117,0
22401027,1,296,8.0,1.6216216216216217,720,424
22401027,1,47,4.0,5.1063829787234045,409,362
22401027,1,73,0.0,0.0,362,289
22401027,1,63,2.0,1.9047619047619047,284,221
22401027,1,18,0.0,0.0,216,198
22401027,1,129,-3.0,-1.3953488372093024,129,0
22401027,2,302,-2.0,-0.3973509933774834,720,418
22401027,2,116,-1.0,-0.5172413793103449,401,285
22401027,2,39,2.0,3.0769230769230766,285,246
22401027,2,6,-1.0,-10.0,218,212
22401027,2,21,2.0,5.7142857142857135,201,180
22401027,2,37,3.0,4.864864864864865,148,111
22401027,2,80,2.0,1.5,111,31
22401027,3,329,-3.0,-0.547112462006079,720,391
22401027,3,15,-2.0,-8.0,370,355
22401027,3,115,-2.0,-1.0434782608695652,355,240
22401027,3,47,-3.0,-3.829787234042553,240,193
22401027,3,172,1.0,0.3488372093023256,172,0
22401027,4,193,-1.0,-0.31088082901554404,720,527
22401027,4,23,2.0,5.217391304347826,527,504
22401027,4,140,-7.0,-3.0,490,350
22401027,4,51,1.0,1.1764705882352942,333,282
22401027,4,79,-3.0,-2.278481012658228,264,185
22401027,4,165,-4.0,-1.4545454545454546,165,0
22401028,1,366,0.0,0.0,720,354
22401028,1,144,5.0,2.0833333333333335,352,208
22401028,1,39,-3.0,-4.615384615384616,195,156
22401028,1,83,3.0,2.1686746987951806,156,73
22401028,1,60,-3.0,-3.0,60,0
22401028,2,86,0.0,0.0,720,634
22401028,2,22,0.0,0.0,622,600
22401028,2,92,-4.0,-2.608695652173913,593,501
22401028,2,13,-1.0,-4.615384615384616,484,471
22401028,2,75,2.0,1.6,471,396
22401028,2,17,0.0,0.0,384,367
22401028,2,107,0.0,0.0,350,243
22401028,2,70,1.0,0.8571428571428571,236,166
22401028,2,56,2.0,2.142857142857143,144,88
22401028,2,66,-1.0,-0.9090909090909092,66,0
22401028,3,160,-2.0,-0.75,720,560
22401028,3,52,-3.0,-3.4615384615384617,552,500
22401028,3,121,-4.0,-1.9834710743801653,481,360
22401028,3,107,-1.0,-0.5607476635514018,346,239
22401028,3,29,0.0,0.0,234,205
22401028,3,82,0.0,0.0,200,118
22401028,3,48,0.0,0.0,113,65
22401028,3,65,-2.0,-1.8461538461538463,65,0
22401028,4,144,-2.0,-0.8333333333333333,720,576
22401028,4,57,-1.0,-1.0526315789473684,568,511
22401028,4,60,1.0,1.0,503,443
22401028,4,41,-7.0,-10.24390243902439,443,402
22401028,4,164,-7.0,-2.5609756097560976,386,222
22401028,4,10,1.0,6.0,222,212
22401028,4,20,0.0,0.0,212,192
22401028,4,66,-2.0,-1.8181818181818183,179,113
22401028,4,103,1.0,0.5825242718446602,103,0
22401029,1,190,-1.0,-0.3157894736842105,720,530
22401029,1,43,-3.0,-4.186046511627907,512,469
22401029,1,50,5.0,6.0,460,410
22401029,1,56,1.0,1.0714285714285714,398,342
22401029,1,23,1.0,2.608695652173913,331,308
22401029,1,54,-3.0,-3.333333333333333,300,246
22401029,1,75,-5.0,-4.0,242,167
22401029,1,93,8.0,5.161290322580646,167,74
22401029,1,62,0.0,0.0,62,0
22401029,2,158,-4.0,-1.5189873417721518,720,562
22401029,2,79,2.0,1.5189873417721518,547,468
22401029,2,51,4.0,4.705882352941177,468,417
22401029,2,1,0.0,0.0,417,416
22401029,2,32,-2.0,-3.75,416,384
22401029,2,81,2.0,1.4814814814814814,384,303
22401029,2,25,0.0,0.0,291,266
22401029,2,26,-1.0,-2.307692307692308,248,222
22401029,2,43,-3.0,-4.186046511627907,222,179
22401029,2,167,-2.0,-0.718562874251497,167,0
22401029,3,106,-2.0,-1.1320754716981132,720,614
22401029,3,74,0.0,0.0,593,519
22401029,3,135,-8.0,-3.555555555555556,519,384
22401029,3,50,0.0,0.0,260,210
22401029,3,144,-1.0,-0.41666666666666663,210,66
22401029,3,49,4.0,4.897959183673469,52,3
22401029,3,1,0.0,0.0,1,0
22401029,4,177,0.0,0.0,720,543
22401029,4,28,-1.0,-2.142857142857143,543,515
22401029,4,21,0.0,0.0,501,480
22401029,4,36,0.0,0.0,480,444
22401029,4,67,0.0,0.0,444,377
22401029,4,30,2.0,4.0,360,330
22401029,4,58,2.0,2.0689655172413794,323,265
22401029,4,158,5.0,1.89873417721519,240,82
22401029,4,22,3.0,8.181818181818182,78,56
22401029,4,9,-3.0,-20.0,41,32
22401029,4,30,-2.0,-4.0,30,0
22401030,1,240,-4.0,-1.0,720,480
22401030,1,111,-1.0,-0.5405405405405406,466,355
22401030,1,51,-1.0,-1.1764705882352942,353,302
22401030,1,107,-3.0,-1.6822429906542056,291,184
22401030,1,16,0.0,0.0,176,160
22401030,1,160,5.0,1.875,160,0
22401030,2,149,4.0,1.610738255033557,720,571
22401030,2,41,0.0,0.0,571,530
22401030,2,17,0.0,0.0,508,491
22401030,2,59,3.0,3.050847457627119,475,416
22401030,2,23,3.0,7.826086956521739,416,393
22401030,2,223,-3.0,-0.8071748878923767,386,163
22401030,2,135,-7.0,-3.111111111111111,138,3
22401030,2,3,0.0,0.0,3,0
22401030,3,234,-13.0,-3.333333333333333,720,486
22401030,3,75,-2.0,-1.6,469,394
22401030,3,22,-2.0,-5.454545454545455,380,358
22401030,3,184,-3.0,-0.9782608695652174,358,174
22401030,3,38,0.0,0.0,164,126
22401030,4,140,0.0,0.0,720,580
22401030,4,43,0.0,0.0,580,537
22401030,4,9,0.0,0.0,524,515
22401030,4,47,1.0,1.2765957446808511,508,461
22401030,4,90,-2.0,-1.3333333333333335,449,359
22401030,4,94,-2.0,-1.2765957446808511,352,258
22401030,4,244,-4.0,-0.9836065573770493,244,0
22401031,1,333,0.0,0.0,720,387
22401031,1,170,7.0,2.4705882352941178,387,217
22401031,1,52,-1.0,-1.153846153846154,204,152
22401031,1,152,7.0,2.763157894736842,152,0
22401031,2,237,3.0,0.7594936708860759,720,483
22401031,2,53,0.0,0.0,483,430
22401031,2,100,3.0,1.7999999999999998,407,307
22401031,2,79,1.0,0.7594936708860759,289,210
22401031,2,63,4.0,3.8095238095238093,210,147
22401031,2,13,0.0,0.0,133,120
22401031,2,115,-3.0,-1.5652173913043477,115,0
22401031,3,286,7.0,1.4685314685314685,720,434
22401031,3,97,2.0,1.2371134020618557,423,326
22401031,3,60,-1.0,-1.0,319,259
22401031,3,51,3.0,3.5294117647058822,259,208
22401031,3,116,6.0,3.103448275862069,152,36
22401031,3,36,0.0,0.0,36,0
22401031,4,132,-3.0,-1.3636363636363638,720,588
22401031,4,56,-1.0,-1.0714285714285714,588,532
22401031,4,13,0.0,0.0,523,510
22401031,4,54,-4.0,-4.444444444444445,497,443
22401031,4,44,0.0,0.0,443,399
22401031,4,37,-2.0,-3.2432432432432434,384,347
22401031,4,223,5.0,1.3452914798206277,347,124
22401031,4,19,2.0,6.315789473684211,124,105
22401031,4,31,-3.0,-5.806451612903226,105,74
22401031,4,74,-2.0,-1.6216216216216217,74,0
22401032,1,268,7.0,1.5671641791044775,720,452
22401032,1,66,0.0,0.0,438,372
22401032,1,31,-4.0,-7.741935483870968,371,340
22401032,1,65,-3.0,-2.769230769230769,322,257
22401032,1,75,-1.0,-0.8,234,159
22401032,1,44,-2.0,-2.7272727272727275,150,106
22401032,1,33,0.0,0.0,98,65
22401032,1,57,2.0,2.1052631578947367,57,0
22401032,2,155,-4.0,-1.5483870967741935,720,565
22401032,2,1,0.0,0.0,561,560
22401032,2,93,3.0,1.935483870967742,548,455
22401032,2,83,4.0,2.891566265060241,455,372
22401032,2,26,2.0,4.615384615384616,370,344
22401032,2,168,7.0,2.5,323,155
22401032,2,34,3.0,5.294117647058824,147,113
22401032,2,97,2.0,1.2371134020618557,97,0
22401032,3,342,2.0,0.3508771929824561,720,378
22401032,3,209,3.0,0.861244019138756,363,154
22401032,3,118,-1.0,-0.5084745762711864,154,36
22401032,3,15,0.0,0.0,15,0
22401032,4,238,0.0,0.0,720,482
22401032,4,42,-4.0,-5.7142857142857135,482,440
22401032,4,47,-4.0,-5.1063829787234045,424,377
22401032,4,50,5.0,6.0,377,327
22401032,4,214,-2.0,-0.5607476635514018,327,113
22401032,4,94,0.0,0.0,113,19
22401033,1,290,-1.0,-0.20689655172413793,720,430
22401033,1,111,-5.0,-2.7027027027027026,415,304
22401033,1,7,-1.0,-8.571428571428571,290,283
22401033,1,35,-2.0,-3.4285714285714284,283,248
22401033,1,240,-10.0,-2.5,240,0
22401033,2,117,6.0,3.0769230769230766,720,603
22401033,2,41,3.0,4.390243902439024,582,541
22401033,2,67,-1.0,-0.8955223880597015,538,471
22401033,2,26,-2.0,-4.615384615384616,459,433
22401033,2,84,0.0,0.0,422,338
22401033,2,36,0.0,0.0,314,278
22401033,2,201,-6.0,-1.791044776119403,278,77
22401033,2,51,1.0,1.1764705882352942,51,0
22401033,3,235,-3.0,-0.7659574468085106,720,485
22401033,3,37,1.0,1.6216216216216217,478,441
22401033,3,14,0.0,0.0,419,405
22401033,3,51,-2.0,-2.3529411764705883,397,346
22401033,3,72,-2.0,-1.6666666666666665,335,263
22401033,3,62,4.0,3.870967741935484,255,193
22401033,3,37,-4.0,-6.486486486486487,176,139
22401033,3,125,-4.0,-1.92,125,0
22401033,4,110,-2.0,-1.0909090909090908,720,610
22401033,4,124,6.0,2.903225806451613,583,459
22401033,4,72,0.0,0.0,459,387
22401033,4,248,-5.0,-1.2096774193548387,372,124
22401034,1,279,1.0,0.21505376344086022,720,441
22401034,1,20,0.0,0.0,433,413
22401034,1,96,-5.0,-3.125,400,304
22401034,1,119,0.0,0.0,304,185
22401034,1,37,0.0,0.0,185,148
22401034,1,89,-6.0,-4.044943820224719,131,42
22401034,1,19,0.0,0.0,32,13
22401034,1,3,0.0,0.0,3,0
22401034,2,160,1.0,0.375,720,560
22401034,2,12,0.0,0.0,540,528
22401034,2,51,2.0,2.3529411764705883,516,465
22401034,2,135,0.0,0.0,455,320
22401034,2,85,-5.0,-3.5294117647058822,308,223
22401034,2,23,0.0,0.0,214,191
22401034,2,40,1.0,1.5,184,144
22401034,2,121,-3.0,-1.487603305785124,144,23
22401034,2,2,0.0,0.0,2,0
22401034,3,243,-2.0,-0.4938271604938272,720,477
22401034,3,103,0.0,0.0,477,374
22401034,3,73,5.0,4.10958904109589,374,301
22401034,3,219,-6.0,-1.643835616438356,287,68
22401034,3,26,-2.0,-4.615384615384616,57,31
22401034,3,31,2.0,3.870967741935484,31,0
22401034,4,75,-2.0,-1.6,720,645
22401034,4,124,-2.0,-0.967741935483871,645,521
22401034,4,69,0.0,0.0,515,446
22401034,4,92,0.0,0.0,439,347
22401034,4,219,3.0,0.821917808219178,239,20
22401034,4,30,0.0,0.0,30,0
22401035,1,427,-7.0,-0.9836065573770493,720,293
22401035,1,45,0.0,0.0,281,236
22401035,1,65,-3.0,-2.769230769230769,236,171
22401035,1,65,0.0,0.0,171,106
22401035,1,74,2.0,1.6216216216216217,94,20
22401035,1,16,0.0,0.0,20,4
22401035,2,45,0.0,0.0,720,675
22401035,2,100,0.0,0.0,662,562
22401035,2,23,2.0,5.217391304347826,562,539
22401035,2,143,2.0,0.8391608391608392,526,383
22401035,2,124,-2.0,-0.967741935483871,370,246
22401035,2,138,0.0,0.0,223,85
22401035,2,65,1.0,0.9230769230769231,73,8
22401035,3,265,-6.0,-1.3584905660377358,720,455
22401035,3,125,2.0,0.96,437,312
22401035,3,134,-4.0,-1.791044776119403,293,159
22401035,3,9,2.0,13.333333333333332,159,150
22401035,3,40,-3.0,-4.5,150,110
22401035,3,80,-4.0,-3.0,101,21
22401035,3,2,0.0,0.0,21,19
22401035,3,8,2.0,15.0,8,0
22401035,4,20,1.0,3.0,720,700
22401035,4,209,6.0,1.722488038277512,700,491
22401035,4,35,-1.0,-1.7142857142857142,491,456
22401035,4,173,0.0,0.0,456,283
22401035,4,201,4.0,1.1940298507462686,266,65
22401035,4,3,0.0,0.0,54,51
22401035,4,1,0.0,0.0,29,28
22401035,4,7,-2.0,-17.142857142857142,21,14
22401035,4,2,-1.0,-30.0,9,7
22401036,1,357,0.0,0.0,720,363
22401036,1,52,3.0,3.4615384615384617,363,311
22401036,1,8,0.0,0.0,303,295
22401036,1,92,-2.0,-1.3043478260869565,282,190
22401036,1,45,-2.0,-2.666666666666667,190,145
22401036,1,47,5.0,6.382978723404255,138,91
22401036,1,77,1.0,0.7792207792207793,77,0
22401036,2,140,-4.0,-1.7142857142857142,720,580
22401036,2,68,-3.0,-2.647058823529412,577,509
22401036,2,14,-2.0,-8.571428571428571,497,483
22401036,2,86,3.0,2.0930232558139537,465,379
22401036,2,151,0.0,0.0,452,301
22401036,2,139,-2.0,-0.8633093525179857,301,162
22401036,2,26,0.0,0.0,162,136
22401036,2,47,-3.0,-3.829787234042553,125,78
22401036,2,15,1.0,4.0,78,63
22401036,2,63,-3.0,-2.8571428571428568,63,0
22401036,3,295,0.0,0.0,720,425
22401036,3,89,4.0,2.696629213483146,412,323
22401036,3,52,-1.0,-1.153846153846154,287,235
22401036,3,89,2.0,1.348314606741573,227,138
22401036,3,90,0.0,0.0,136,46
22401036,4,183,-1.0,-0.32786885245901637,720,537
22401036,4,116,4.0,2.0689655172413794,536,420
22401036,4,36,-2.0,-3.333333333333333,420,384
22401036,4,83,4.0,2.891566265060241,370,287
22401036,4,265,-5.0,-1.1320754716981132,265,0
22401036,4,2,0.0,0.0,99,97
22401037,1,349,2.0,0.3438395415472779,720,371
22401037,1,146,-3.0,-1.2328767123287672,366,220
22401037,1,11,2.0,10.90909090909091,220,209
22401037,1,99,3.0,1.8181818181818183,209,110
22401037,1,18,-3.0,-10.0,110,92
22401037,1,60,0.0,0.0,80,20
22401037,1,20,0.0,0.0,20,0
22401037,2,114,0.0,0.0,720,606
22401037,2,68,2.0,1.7647058823529411,593,525
22401037,2,23,0.0,0.0,523,500
22401037,2,84,-2.0,-1.4285714285714284,500,416
22401037,2,57,1.0,1.0526315789473684,407,350
22401037,2,84,-2.0,-1.4285714285714284,340,256
22401037,2,34,2.0,3.5294117647058822,250,216
22401037,2,100,2.0,1.2,210,110
22401037,2,110,-5.0,-2.7272727272727275,110,0
22401037,3,297,6.0,1.2121212121212122,720,423
22401037,3,131,4.0,1.83206106870229,415,284
22401037,3,94,2.0,1.2765957446808511,271,177
22401037,3,106,5.0,2.8301886792452833,177,71
22401037,3,71,1.0,0.8450704225352113,71,0
22401037,4,162,-6.0,-2.2222222222222223,720,558
22401037,4,128,1.0,0.46875,545,417
22401037,4,12,1.0,5.0,403,391
22401037,4,52,0.0,0.0,391,339
22401037,4,52,-1.0,-1.153846153846154,325,273
22401037,4,114,-2.0,-1.0526315789473684,264,150
22401037,4,31,1.0,1.935483870967742,141,110
22401037,4,13,-2.0,-9.230769230769232,110,97
22401037,4,81,-3.0,-2.2222222222222223,81,0
22401038,1,303,-5.0,-0.99009900990099,720,417
22401038,1,69,4.0,3.4782608695652173,417,348
22401038,1,26,-2.0,-4.615384615384616,348,322
22401038,1,98,-1.0,-0.6122448979591836,322,224
22401038,1,47,-2.0,-2.5531914893617023,220,173
22401038,1,40,2.0,3.0,162,122
22401038,1,75,-3.0,-2.4,103,28
22401038,2,139,-1.0,-0.43165467625899284,720,581
22401038,2,55,6.0,6.545454545454545,572,517
22401038,2,40,0.0,0.0,517,477
22401038,2,65,3.0,2.769230769230769,477,412
22401038,2,17,0.0,0.0,396,379
22401038,2,37,-1.0,-1.6216216216216217,369,332
22401038,2,29,-6.0,-12.413793103448276,322,293
22401038,2,68,0.0,0.0,273,205
22401038,2,81,-2.0,-1.4814814814814814,205,124
22401038,2,19,1.0,3.1578947368421053,124,105
22401038,2,12,-1.0,-5.0,105,93
22401038,2,93,5.0,3.2258064516129035,93,0
22401038,3,113,3.0,1.592920353982301,720,607
22401038,3,249,5.0,1.2048192771084336,607,358
22401038,3,48,0.0,0.0,342,294
22401038,3,50,5.0,6.0,280,230
22401038,3,36,0.0,0.0,222,186
22401038,3,118,2.0,1.0169491525423728,163,45
22401038,3,45,-3.0,-4.0,45,0
22401038,4,194,0.0,0.0,720,526
22401038,4,24,-3.0,-7.5,510,486
22401038,4,90,-4.0,-2.666666666666667,475,385
22401038,4,45,-1.0,-1.3333333333333335,366,321
22401038,4,275,3.0,0.6545454545454545,310,35
22401038,4,29,0.0,0.0,29,0
22401039,1,113,2.0,1.0619469026548671,720,607
22401039,1,120,0.0,0.0,600,480
22401039,1,109,0.0,0.0,480,371
22401039,1,44,3.0,4.090909090909091,371,327
22401039,1,57,-2.0,-2.1052631578947367,327,270
22401039,1,57,-3.0,-3.1578947368421053,262,205
22401039,1,111,0.0,0.0,205,94
22401039,1,83,-1.0,-0.7228915662650602,83,0
22401039,2,172,-1.0,-0.3488372093023256,720,548
22401039,2,101,-4.0,-2.376237623762376,545,444
22401039,2,86,0.0,0.0,428,342
22401039,2,29,0.0,0.0,335,306
22401039,2,115,-1.0,-0.5217391304347826,304,189
22401039,2,185,-3.0,-0.972972972972973,189,4
22401039,3,276,-6.0,-1.3043478260869565,720,444
22401039,3,95,8.0,5.052631578947368,424,329
22401039,3,39,-2.0,-3.0769230769230766,329,290
22401039,3,55,3.0,3.2727272727272725,268,213
22401039,3,55,-3.0,-3.2727272727272725,204,149
22401039,3,11,0.0,0.0,149,138
22401039,3,111,0.0,0.0,111,0
22401039,4,94,-3.0,-1.9148936170212765,720,626
22401039,4,114,2.0,1.0526315789473684,626,512
22401039,4,52,1.0,1.153846153846154,493,441
22401039,4,122,-6.0,-2.9508196721311473,441,319
22401039,4,130,-3.0,-1.3846153846153846,235,105
22401039,4,105,3.0,1.7142857142857142,105,0
22401040,1,252,-4.0,-0.9523809523809523,720,468
22401040,1,53,-3.0,-3.3962264150943398,448,395
22401040,1,65,-4.0,-3.6923076923076925,383,318
22401040,1,48,3.0,3.75,304,256
22401040,1,14,0.0,0.0,236,222
22401040,1,131,-4.0,-1.83206106870229,220,89
22401040,2,253,0.0,0.0,720,467
22401040,2,51,3.0,3.5294117647058822,467,416
22401040,2,49,0.0,0.0,416,367
22401040,2,59,0.0,0.0,351,292
22401040,2,73,-2.0,-1.643835616438356,292,219
22401040,2,89,0.0,0.0,205,116
22401040,2,66,1.0,0.9090909090909092,106,40
22401040,2,27,3.0,6.666666666666666,27,0
22401040,3,217,2.0,0.5529953917050692,720,503
22401040,3,84,-4.0,-2.8571428571428568,488,404
22401040,3,86,2.0,1.3953488372093024,404,318
22401040,3,10,0.0,0.0,301,291
22401040,3,119,-6.0,-3.0252100840336134,154,35
22401040,3,35,2.0,3.4285714285714284,35,0
22401040,4,216,2.0,0.5555555555555556,720,504
22401040,4,57,-1.0,-1.0526315789473684,490,433
22401040,4,49,0.0,0.0,433,384
22401040,4,90,-4.0,-2.666666666666667,369,279
22401040,4,68,-1.0,-0.8823529411764706,203,135
22401040,4,126,-2.0,-0.9523809523809523,126,0
22401041,1,328,0.0,0.0,720,392
22401041,1,34,2.0,3.5294117647058822,392,358
22401041,1,45,1.0,1.3333333333333335,349,304
22401041,1,150,-2.0,-0.8,304,154
22401041,1,119,2.0,1.0084033613445378,153,34
22401041,2,271,1.0,0.22140221402214022,720,449
22401041,2,52,2.0,2.307692307692308,435,383
22401041,2,21,1.0,2.8571428571428568,383,362
22401041,2,29,-2.0,-4.137931034482759,362,333
22401041,2,122,-1.0,-0.49180327868852464,321,199
22401041,2,5,0.0,0.0,186,181
22401041,2,12,0.0,0.0,169,157
22401041,2,67,1.0,0.8955223880597015,139,72
22401041,2,39,2.0,3.0769230769230766,72,33
22401041,2,91,-2.0,-1.3186813186813189,91,0
22401041,3,433,-6.0,-0.8314087759815243,720,287
22401041,3,15,-1.0,-4.0,274,259
22401041,3,68,5.0,4.411764705882353,259,191
22401041,3,88,6.0,4.090909090909091,108,20
22401041,3,2,0.0,0.0,2,0
22401041,4,129,3.0,1.3953488372093024,720,591
22401041,4,85,3.0,2.1176470588235294,580,495
22401041,4,64,0.0,0.0,470,406
22401041,4,60,-3.0,-3.0,396,336
22401041,4,40,-3.0,-4.5,336,296
22401041,4,42,0.0,0.0,284,242
22401041,4,103,2.0,1.1650485436893203,238,135
22401041,4,121,-2.0,-0.9917355371900827,121,0
22401042,1,265,1.0,0.22641509433962265,720,455
22401042,1,102,0.0,0.0,443,341
22401042,1,115,5.0,2.608695652173913,331,216
22401042,1,105,6.0,3.4285714285714284,216,111
22401042,1,111,-4.0,-2.1621621621621623,111,0
22401042,2,122,-6.0,-2.9508196721311473,720,598
22401042,2,116,1.0,0.5172413793103449,580,464
22401042,2,31,-1.0,-1.935483870967742,464,433
22401042,2,27,1.0,2.2222222222222223,433,406
22401042,2,112,3.0,1.607142857142857,406,294
22401042,2,4,1.0,15.0,279,275
22401042,2,237,-2.0,-0.5063291139240506,275,38
22401042,2,33,1.0,1.8181818181818183,33,0
22401042,3,398,0.0,0.0,720,322
22401042,3,89,2.0,1.348314606741573,322,233
22401042,3,57,3.0,3.1578947368421053,215,158
22401042,3,55,0.0,0.0,158,103
22401042,3,94,1.0,0.6382978723404256,94,0
22401042,4,33,0.0,0.0,720,687
22401042,4,45,2.0,2.666666666666667,682,637
22401042,4,80,-7.0,-5.25,620,540
22401042,4,82,-4.0,-2.926829268292683,514,432
22401042,4,167,-2.0,-0.718562874251497,414,247
22401042,4,194,1.0,0.30927835051546393,239,45
22401042,4,39,-2.0,-3.0769230769230766,39,0
22401043,1,389,0.0,0.0,720,331
22401043,1,20,-3.0,-9.0,318,298
22401043,1,40,1.0,1.5,298,258
22401043,1,45,0.0,0.0,258,213
22401043,1,59,-3.0,-3.050847457627119,209,150
22401043,1,150,2.0,0.8,150,0
22401043,2,178,4.0,1.348314606741573,720,542
22401043,2,23,-3.0,-7.826086956521739,540,517
22401043,2,68,-1.0,-0.8823529411764706,509,441
22401043,2,99,0.0,0.0,441,342
22401043,2,76,-1.0,-0.7894736842105263,334,258
22401043,2,99,-7.0,-4.242424242424242,242,143
22401043,2,85,0.0,0.0,135,50
22401043,2,50,3.0,3.5999999999999996,50,0
22401043,3,283,1.0,0.21201413427561838,720,437
22401043,3,64,3.0,2.8125,437,373
22401043,3,133,1.0,0.45112781954887216,373,240
22401043,3,41,0.0,0.0,240,199
22401043,3,68,-3.0,-2.647058823529412,191,123
22401043,3,40,0.0,0.0,102,62
22401043,3,7,0.0,0.0,62,55
22401043,3,5,0.0,0.0,55,50
22401043,3,27,1.0,2.2222222222222223,33,6
22401043,3,6,0.0,0.0,6,0
22401043,4,224,-1.0,-0.26785714285714285,720,496
22401043,4,40,-3.0,-4.5,484,444
22401043,4,88,5.0,3.409090909090909,444,356
22401043,4,13,3.0,13.846153846153847,353,340
22401043,4,183,-2.0,-0.6557377049180327,322,139
22401043,4,129,-1.0,-0.46511627906976744,139,10
22401043,4,4,1.0,15.0,5,1
22401044,1,227,10.0,2.643171806167401,720,493
22401044,1,241,-2.0,-0.4979253112033195,493,252
22401044,1,206,-2.0,-0.5825242718446602,237,31
22401044,1,11,-3.0,-16.363636363636363,11,0
22401044,2,194,2.0,0.6185567010309279,720,526
22401044,2,73,-2.0,-1.643835616438356,511,438
22401044,2,70,0.0,0.0,432,362
22401044,2,362,-4.0,-0.6629834254143646,362,0
22401044,3,505,-5.0,-0.594059405940594,720,215
22401044,3,50,-2.0,-2.4,215,165
22401044,3,22,0.0,0.0,164,142
22401044,3,133,2.0,0.9022556390977443,133,0
22401044,4,170,-2.0,-0.7058823529411764,720,550
22401044,4,40,5.0,7.5,536,496
22401044,4,33,-3.0,-5.454545454545455,472,439
22401044,4,265,-5.0,-1.1320754716981132,421,156
22401044,4,75,-2.0,-1.6,147,72
22401044,4,61,2.0,1.9672131147540985,61,0
22401045,1,320,-11.0,-2.0625,720,400
22401045,1,80,1.0,0.75,385,305
22401045,1,78,-5.0,-3.846153846153846,294,216
22401045,1,10,1.0,6.0,204,194
22401045,1,194,5.0,1.5463917525773194,194,0
22401045,2,131,1.0,0.4580152671755725,720,589
22401045,2,32,-5.0,-9.375,580,548
22401045,2,113,-3.0,-1.592920353982301,534,421
22401045,2,62,-1.0,-0.967741935483871,376,314
22401045,2,69,4.0,3.4782608695652173,301,232
22401045,2,232,-1.0,-0.25862068965517243,232,0
22401045,3,308,16.0,3.116883116883117,720,412
22401045,3,71,0.0,0.0,439,368
22401045,3,21,0.0,0.0,347,326
22401045,3,37,3.0,4.864864864864865,304,267
22401045,3,34,1.0,1.7647058823529411,250,216
22401045,3,209,-8.0,-2.2966507177033493,216,7
22401045,4,199,-7.0,-2.1105527638190953,720,521
22401045,4,66,-2.0,-1.8181818181818183,500,434
22401045,4,146,1.0,0.410958904109589,434,288
22401045,4,234,-3.0,-0.7692307692307692,269,35
22401045,4,27,0.0,0.0,27,0
22401046,1,302,-3.0,-0.5960264900662252,720,418
22401046,1,75,-2.0,-1.6,405,330
22401046,1,26,0.0,0.0,322,296
22401046,1,19,0.0,0.0,296,277
22401046,1,22,3.0,8.181818181818182,277,255
22401046,1,126,0.0,0.0,236,110
22401046,1,98,4.0,2.4489795918367343,98,0
22401046,2,132,4.0,1.8181818181818183,720,588
22401046,2,93,2.0,1.2903225806451615,571,478
22401046,2,52,2.0,2.307692307692308,478,426
22401046,2,34,0.0,0.0,413,379
22401046,2,46,5.0,6.521739130434782,364,318
22401046,2,11,-1.0,-5.454545454545455,300,289
22401046,2,61,3.0,2.9508196721311473,289,228
22401046,2,50,2.0,2.4,228,178
22401046,2,157,2.0,0.7643312101910829,157,0
22401046,3,333,-4.0,-0.7207207207207207,720,387
22401046,3,47,-3.0,-3.829787234042553,379,332
22401046,3,63,0.0,0.0,332,269
22401046,3,87,-2.0,-1.3793103448275863,269,182
22401046,3,158,2.0,0.7594936708860759,170,12
22401046,3,12,-2.0,-10.0,12,0
22401046,4,206,3.0,0.8737864077669903,720,514
22401046,4,70,-3.0,-2.5714285714285716,502,432
22401046,4,17,1.0,3.5294117647058822,419,402
22401046,4,118,0.0,0.0,402,284
22401046,4,13,-1.0,-4.615384615384616,284,271
22401046,4,16,3.0,11.25,271,255
22401046,4,239,3.0,0.7531380753138075,239,0
22401047,1,291,2.0,0.41237113402061853,720,429
22401047,1,185,0.0,0.0,429,244
22401047,1,143,-5.0,-2.097902097902098,219,76
22401047,2,258,6.0,1.3953488372093024,720,462
22401047,2,40,-1.0,-1.5,450,410
22401047,2,61,2.0,1.9672131147540985,410,349
22401047,2,69,2.0,1.7391304347826086,343,274
22401047,2,49,-2.0,-2.4489795918367343,274,225
22401047,2,68,-1.0,-0.8823529411764706,201,133
22401047,2,81,2.0,1.4814814814814814,133,52
22401047,2,45,3.0,4.0,52,7
22401047,3,256,-1.0,-0.234375,720,464
22401047,3,83,-1.0,-0.7228915662650602,452,369
22401047,3,85,1.0,0.7058823529411764,354,269
22401047,3,40,-4.0,-6.0,266,226
22401047,3,16,0.0,0.0,226,210
22401047,3,62,0.0,0.0,196,134
22401047,3,89,-3.0,-2.0224719101123596,122,33
22401047,3,27,3.0,6.666666666666666,27,0
22401047,4,157,4.0,1.5286624203821657,720,563
22401047,4,122,0.0,0.0,563,441
22401047,4,26,3.0,6.923076923076923,403,377
22401047,4,110,2.0,1.0909090909090908,363,253
22401047,4,15,-1.0,-4.0,231,216
22401047,4,216,0.0,0.0,216,0
22401048,1,186,5.0,1.6129032258064517,720,534
22401048,1,239,-3.0,-0.7531380753138075,521,282
22401048,1,192,-4.0,-1.25,275,83
22401048,1,38,0.0,0.0,73,35
22401048,1,31,4.0,7.741935483870968,31,0
22401048,2,71,-1.0,-0.8450704225352113,720,649
22401048,2,84,2.0,1.4285714285714284,649,565
22401048,2,150,2.0,0.8,565,415
22401048,2,68,-4.0,-3.5294117647058822,370,302
22401048,2,16,-2.0,-7.5,294,278
22401048,2,164,1.0,0.36585365853658536,278,114
22401048,2,21,0.0,0.0,114,93
22401048,2,78,-3.0,-2.307692307692308,78,0
22401048,3,147,7.0,2.8571428571428568,720,573
22401048,3,65,-4.0,-3.6923076923076925,573,508
22401048,3,102,5.0,2.941176470588235,508,406
22401048,3,21,0.0,0.0,404,383
22401048,3,179,1.0,0.335195530726257,383,204
22401048,3,87,1.0,0.6896551724137931,204,117
22401048,3,102,3.0,1.7647058823529411,102,0
22401048,4,76,-2.0,-1.5789473684210527,720,644
22401048,4,160,3.0,1.125,631,471
22401048,4,164,8.0,2.926829268292683,448,284
22401048,4,30,2.0,4.0,272,242
22401048,4,11,0.0,0.0,228,217
22401048,4,19,-2.0,-6.315789473684211,208,189
22401048,4,89,-4.0,-2.696629213483146,182,93
22401048,4,93,-4.0,-2.580645161290323,93,0
22401049,1,296,3.0,0.6081081081081081,720,424
22401049,1,26,-2.0,-4.615384615384616,424,398
22401049,1,79,-4.0,-3.0379746835443036,383,304
22401049,1,82,5.0,3.6585365853658534,301,219
22401049,1,23,0.0,0.0,200,177
22401049,1,146,8.0,3.287671232876712,167,21
22401049,2,65,2.0,1.8461538461538463,720,655
22401049,2,119,4.0,2.0168067226890756,655,536
22401049,2,80,5.0,3.75,526,446
22401049,2,123,-3.0,-1.4634146341463414,428,305
22401049,2,94,-2.0,-1.2765957446808511,287,193
22401049,2,102,2.0,1.1764705882352942,190,88
22401049,2,69,1.0,0.8695652173913043,81,12
22401049,2,9,0.0,0.0,12,3
22401049,3,210,3.0,0.8571428571428571,720,510
22401049,3,168,0.0,0.0,510,342
22401049,3,24,-3.0,-7.5,342,318
22401049,3,26,1.0,2.307692307692308,318,292
22401049,3,42,-1.0,-1.4285714285714284,292,250
22401049,3,127,3.0,1.4173228346456692,250,123
22401049,3,25,-1.0,-2.4,54,29
22401049,3,29,-2.0,-4.137931034482759,29,0
22401049,4,158,-9.0,-3.4177215189873418,720,562
22401049,4,81,-3.0,-2.2222222222222223,554,473
22401049,4,55,-2.0,-2.1818181818181817,461,406
22401049,4,199,7.0,2.1105527638190953,397,198
22401049,4,168,-8.0,-2.8571428571428568,186,18
22401049,4,14,2.0,8.571428571428571,14,0
22401050,1,268,3.0,0.6716417910447761,720,452
22401050,1,74,2.0,1.6216216216216217,434,360
22401050,1,26,0.0,0.0,360,334
22401050,1,29,0.0,0.0,324,295
22401050,1,81,1.0,0.7407407407407407,295,214
22401050,1,140,-2.0,-0.8571428571428571,198,58
22401050,1,41,0.0,0.0,52,11
22401050,1,1,0.0,0.0,1,0
22401050,2,122,4.0,1.9672131147540985,720,598
22401050,2,48,-1.0,-1.25,587,539
22401050,2,77,-2.0,-1.5584415584415585,534,457
22401050,2,94,10.0,6.382978723404255,457,363
22401050,2,24,-2.0,-5.0,345,321
22401050,2,37,2.0,3.2432432432432434,312,275
22401050,2,57,-5.0,-5.263157894736842,267,210
22401050,2,45,0.0,0.0,210,165
22401050,2,164,-9.0,-3.292682926829268,164,0
22401050,3,165,-5.0,-1.8181818181818183,720,555
22401050,3,93,-2.0,-1.2903225806451615,552,459
22401050,3,122,-6.0,-2.9508196721311473,459,337
22401050,3,24,1.0,2.5,328,304
22401050,3,121,-4.0,-1.9834710743801653,296,175
22401050,3,20,-1.0,-3.0,175,155
22401050,3,155,-4.0,-1.5483870967741935,155,0
22401050,4,131,-1.0,-0.4580152671755725,720,589
22401050,4,106,-9.0,-5.094339622641509,576,470
22401050,4,47,-1.0,-1.2765957446808511,458,411
22401050,4,144,-1.0,-0.41666666666666663,411,267
22401050,4,262,-3.0,-0.6870229007633588,262,0
22401051,1,294,-4.0,-0.8163265306122449,720,426
22401051,1,174,7.0,2.413793103448276,416,242
22401051,1,84,-2.0,-1.4285714285714284,232,148
22401051,1,131,-4.0,-1.83206106870229,131,0
22401051,2,150,-2.0,-0.8,720,570
22401051,2,52,1.0,1.153846153846154,570,518
22401051,2,66,1.0,0.9090909090909092,518,452
22401051,2,17,0.0,0.0,442,425
22401051,2,70,3.0,2.5714285714285716,411,341
22401051,2,75,-1.0,-0.8,341,266
22401051,2,93,-5.0,-3.2258064516129035,266,173
22401051,2,134,3.0,1.3432835820895521,165,31
22401051,3,252,0.0,0.0,720,468
22401051,3,53,2.0,2.2641509433962264,465,412
22401051,3,60,3.0,3.0,412,352
22401051,3,88,-1.0,-0.6818181818181819,352,264
22401051,3,92,3.0,1.9565217391304348,264,172
22401051,3,167,-2.0,-0.718562874251497,172,5
22401051,4,119,-1.0,-0.5042016806722689,720,601
22401051,4,66,1.0,0.9090909090909092,601,535
22401051,4,32,4.0,7.5,530,498
22401051,4,150,-3.0,-1.2,482,332
22401051,4,82,-3.0,-2.195121951219512,313,231
22401051,4,49,-4.0,-4.897959183673469,231,182
22401052,1,303,-5.0,-0.99009900990099,720,417
22401052,1,58,0.0,0.0,404,346
22401052,1,97,3.0,1.8556701030927836,335,238
22401052,1,25,-1.0,-2.4,221,196
22401052,1,193,-8.0,-2.4870466321243523,196,3
22401052,1,3,0.0,0.0,3,0
22401052,2,146,-2.0,-0.821917808219178,720,574
22401052,2,81,-1.0,-0.7407407407407407,566,485
22401052,2,43,-5.0,-6.976744186046512,485,442
22401052,2,78,1.0,0.7692307692307692,428,350
22401052,2,30,-1.0,-2.0,335,305
22401052,2,74,-4.0,-3.2432432432432434,305,231
22401052,2,84,6.0,4.285714285714286,222,138
22401052,2,124,-6.0,-2.903225806451613,132,8
22401052,3,487,10.0,1.2320328542094456,720,233
22401052,3,232,0.0,0.0,459,227
22401052,3,108,4.0,2.2222222222222223,223,115
22401052,4,99,-3.0,-1.8181818181818183,720,621
22401052,4,38,0.0,0.0,621,583
22401052,4,24,-3.0,-7.5,576,552
22401052,4,19,0.0,0.0,541,522
22401052,4,94,-3.0,-1.9148936170212765,510,416
22401052,4,100,0.0,0.0,399,299
22401052,4,175,-12.0,-4.114285714285715,288,113
22401053,1,291,-12.0,-2.4742268041237114,720,429
22401053,1,32,-3.0,-5.625,412,380
22401053,1,110,-8.0,-4.363636363636363,369,259
22401053,1,129,4.0,1.8604651162790697,241,112
22401053,1,112,-5.0,-2.678571428571429,112,0
22401053,2,255,8.0,1.8823529411764706,720,465
22401053,2,59,-2.0,-2.0338983050847457,465,406
22401053,2,46,0.0,0.0,392,346
22401053,2,26,0.0,0.0,322,296
22401053,2,14,1.0,4.285714285714286,279,265
22401053,2,265,0.0,0.0,265,0
22401053,3,334,2.0,0.3592814371257485,720,386
22401053,3,79,0.0,0.0,383,304
22401053,3,71,-3.0,-2.535211267605634,289,218
22401053,3,49,0.0,0.0,196,147
22401053,3,7,1.0,8.571428571428571,134,127
22401053,3,18,0.0,0.0,18,0
22401053,4,157,-4.0,-1.5286624203821657,720,563
22401053,4,98,6.0,3.673469387755102,563,465
22401053,4,56,1.0,1.0714285714285714,465,409
22401053,4,30,0.0,0.0,409,379
22401053,4,8,-2.0,-15.0,379,371
22401053,4,210,2.0,0.5714285714285715,371,161
22401053,4,79,3.0,2.278481012658228,148,69
22401053,4,41,0.0,0.0,59,18
22401053,4,3,0.0,0.0,16,13
22401053,4,12,0.0,0.0,13,1
22401054,1,267,-5.0,-1.1235955056179776,720,453
22401054,1,49,2.0,2.4489795918367343,431,382
22401054,1,26,-1.0,-2.307692307692308,368,342
22401054,1,112,0.0,0.0,342,230
22401054,1,30,0.0,0.0,230,200
22401054,1,181,-2.0,-0.6629834254143646,181,0
22401054,2,161,6.0,2.236024844720497,720,559
22401054,2,44,-5.0,-6.818181818181818,559,515
22401054,2,26,0.0,0.0,494,468
22401054,2,13,0.0,0.0,461,448
22401054,2,75,2.0,1.6,441,366
22401054,2,44,-1.0,-1.3636363636363638,366,322
22401054,2,9,0.0,0.0,322,313
22401054,2,48,0.0,0.0,313,265
22401054,2,132,-4.0,-1.8181818181818183,250,118
22401054,2,99,-1.0,-0.6060606060606061,99,0
22401054,3,277,-1.0,-0.21660649819494585,720,443
22401054,3,55,0.0,0.0,429,374
22401054,3,24,2.0,5.0,366,342
22401054,3,37,0.0,0.0,321,284
22401054,3,100,-1.0,-0.6,260,160
22401054,3,3,0.0,0.0,160,157
22401054,3,136,-10.0,-4.411764705882353,136,0
22401054,4,90,0.0,0.0,720,630
22401054,4,16,2.0,7.5,619,603
22401054,4,58,-3.0,-3.103448275862069,603,545
22401054,4,98,-3.0,-1.836734693877551,526,428
22401054,4,26,-2.0,-4.615384615384616,403,377
22401054,4,51,0.0,0.0,374,323
22401054,4,38,0.0,0.0,310,272
22401054,4,10,0.0,0.0,264,254
22401054,4,88,2.0,1.3636363636363638,247,159
22401054,4,159,0.0,0.0,159,0
22401055,1,360,5.0,0.8333333333333333,720,360
22401055,1,66,0.0,0.0,356,290
22401055,1,36,-1.0,-1.6666666666666665,281,245
22401055,1,64,2.0,1.875,243,179
22401055,1,100,5.0,3.0,159,59
22401055,2,95,-6.0,-3.7894736842105265,720,625
22401055,2,92,-8.0,-5.217391304347826,609,517
22401055,2,80,-1.0,-0.75,517,437
22401055,2,40,-2.0,-3.0,437,397
22401055,2,63,-1.0,-0.9523809523809523,392,329
22401055,2,30,-2.0,-4.0,329,299
22401055,2,37,2.0,3.2432432432432434,276,239
22401055,2,37,-3.0,-4.864864864864865,232,195
22401055,2,57,-5.0,-5.263157894736842,193,136
22401055,2,45,1.0,1.3333333333333335,125,80
22401055,2,80,-1.0,-0.75,80,0
22401055,3,224,6.0,1.607142857142857,720,496
22401055,3,123,-3.0,-1.4634146341463414,483,360
22401055,3,126,5.0,2.380952380952381,351,225
22401055,3,56,4.0,4.285714285714286,218,162
22401055,3,63,-2.0,-1.9047619047619047,139,76
22401055,3,67,2.0,1.791044776119403,76,9
22401055,3,8,0.0,0.0,8,0
22401055,4,105,-7.0,-4.0,720,615
22401055,4,49,0.0,0.0,615,566
22401055,4,34,0.0,0.0,566,532
22401055,4,68,5.0,4.411764705882353,529,461
22401055,4,116,1.0,0.5172413793103449,448,332
22401055,4,88,-1.0,-0.6818181818181819,332,244
22401055,4,190,0.0,0.0,232,42
22401055,4,35,-2.0,-3.4285714285714284,35,0
22401056,1,354,10.0,1.694915254237288,720,366
22401056,1,225,0.0,0.0,366,141
22401056,1,115,2.0,1.0434782608695652,141,26
22401056,1,26,0.0,0.0,26,0
22401056,2,9,0.0,0.0,720,711
22401056,2,293,-1.0,-0.20477815699658702,696,403
22401056,2,26,2.0,4.615384615384616,401,375
22401056,2,168,-7.0,-2.5,370,202
22401056,2,135,1.0,0.4444444444444445,189,54
22401056,2,35,-3.0,-5.142857142857143,35,0
22401056,3,394,-3.0,-0.4568527918781726,720,326
22401056,3,125,3.0,1.44,326,201
22401056,3,20,1.0,3.0,195,175
22401056,3,175,-12.0,-4.114285714285715,175,0
22401056,4,140,-3.0,-1.2857142857142858,720,580
22401056,4,109,-4.0,-2.2018348623853212,580,471
22401056,4,63,2.0,1.9047619047619047,471,408
22401056,4,70,2.0,1.7142857142857142,408,338
22401056,4,24,0.0,0.0,338,314
22401056,4,269,4.0,0.8921933085501859,314,45
22401056,4,24,0.0,0.0,24,0
22401057,1,198,2.0,0.6060606060606061,720,522
22401057,1,155,11.0,4.258064516129032,522,367
22401057,1,44,0.0,0.0,353,309
22401057,1,9,0.0,0.0,293,284
22401057,1,105,-1.0,-0.5714285714285715,281,176
22401057,1,110,0.0,0.0,176,66
22401057,1,3,-2.0,-40.0,64,61
22401057,2,12,-1.0,-5.0,720,708
22401057,2,182,-4.0,-1.3186813186813189,708,526
22401057,2,91,1.0,0.6593406593406594,520,429
22401057,2,18,0.0,0.0,429,411
22401057,2,80,-4.0,-3.0,397,317
22401057,2,78,0.0,0.0,317,239
22401057,2,149,-2.0,-0.8053691275167785,231,82
22401057,2,76,-1.0,-0.7894736842105263,82,6
22401057,2,4,0.0,0.0,4,0
22401057,3,392,0.0,0.0,720,328
22401057,3,38,-5.0,-7.894736842105263,318,280
22401057,3,159,3.0,1.1320754716981132,280,121
22401057,3,50,6.0,7.199999999999999,121,71
22401057,3,51,4.0,4.705882352941177,58,7
22401057,3,3,0.0,0.0,3,0
22401057,4,178,-2.0,-0.6741573033707865,720,542
22401057,4,95,1.0,0.631578947368421,542,447
22401057,4,109,4.0,2.2018348623853212,415,306
22401057,4,121,1.0,0.49586776859504134,298,177
22401057,4,95,2.0,1.263157894736842,160,65
22401057,4,65,2.0,1.8461538461538463,65,0
22401058,1,381,0.0,0.0,720,339
22401058,1,107,-3.0,-1.6822429906542056,326,219
22401058,1,61,0.0,0.0,218,157
22401058,1,143,2.0,0.8391608391608392,157,14
22401058,1,14,0.0,0.0,14,0
22401058,2,160,0.0,0.0,720,560
22401058,2,81,-3.0,-2.2222222222222223,559,478
22401058,2,36,1.0,1.6666666666666665,471,435
22401058,2,80,0.0,0.0,435,355
22401058,2,61,-1.0,-0.9836065573770493,337,276
22401058,2,35,-2.0,-3.4285714285714284,254,219
22401058,2,20,-1.0,-3.0,201,181
22401058,2,142,-2.0,-0.8450704225352113,181,39
22401058,2,39,0.0,0.0,39,0
22401058,3,331,-6.0,-1.0876132930513596,720,389
22401058,3,12,0.0,0.0,371,359
22401058,3,71,-4.0,-3.380281690140845,353,282
22401058,3,41,-2.0,-2.926829268292683,274,233
22401058,3,202,3.0,0.891089108910891,233,31
22401058,4,75,-5.0,-4.0,720,645
22401058,4,101,-3.0,-1.782178217821782,645,544
22401058,4,76,4.0,3.1578947368421053,539,463
22401058,4,77,-2.0,-1.5584415584415585,463,386
22401058,4,2,0.0,0.0,369,367
22401058,4,127,6.0,2.8346456692913384,357,230
22401058,4,219,-3.0,-0.821917808219178,219,0
22401059,1,289,-1.0,-0.20761245674740486,720,431
22401059,1,37,0.0,0.0,416,379
22401059,1,138,1.0,0.43478260869565216,359,221
22401059,1,56,0.0,0.0,211,155
22401059,1,145,8.0,3.310344827586207,145,0
22401059,2,153,-1.0,-0.39215686274509803,720,567
22401059,2,15,2.0,8.0,547,532
22401059,2,60,4.0,4.0,512,452
22401059,2,81,-3.0,-2.2222222222222223,452,371
22401059,2,137,-3.0,-1.3138686131386863,355,218
22401059,2,346,-2.0,-0.3468208092485549,532,186
22401059,2,34,2.0,3.5294117647058822,179,145
22401059,2,105,-2.0,-1.142857142857143,135,30
22401059,2,24,-2.0,-5.0,24,0
22401059,3,271,-1.0,-0.22140221402214022,720,449
22401059,3,87,-2.0,-1.3793103448275863,449,362
22401059,3,53,3.0,3.3962264150943398,362,309
22401059,3,47,0.0,0.0,305,258
22401059,3,247,1.0,0.24291497975708504,247,0
22401059,4,144,-2.0,-0.8333333333333333,720,576
22401059,4,57,-4.0,-4.2105263157894735,576,519
22401059,4,14,-2.0,-8.571428571428571,509,495
22401059,4,73,4.0,3.287671232876712,495,422
22401059,4,133,4.0,1.8045112781954886,422,289
22401059,4,269,3.0,0.6691449814126393,269,0
22401060,1,241,3.0,0.7468879668049792,720,479
22401060,1,119,1.0,0.5042016806722689,466,347
22401060,1,30,-4.0,-8.0,332,302
22401060,1,131,2.0,0.916030534351145,286,155
22401060,1,133,-1.0,-0.45112781954887216,152,19
22401060,1,19,0.0,0.0,19,0
22401060,2,112,6.0,3.214285714285714,720,608
22401060,2,98,-1.0,-0.6122448979591836,608,510
22401060,2,34,0.0,0.0,510,476
22401060,2,11,0.0,0.0,476,465
22401060,2,73,-1.0,-0.821917808219178,465,392
22401060,2,401,-1.0,-0.14962593516209477,685,284
22401060,2,21,2.0,5.7142857142857135,269,248
22401060,2,34,-2.0,-3.5294117647058822,248,214
22401060,2,86,-3.0,-2.0930232558139537,201,115
22401060,2,84,5.0,3.571428571428571,115,31
22401060,2,31,5.0,9.67741935483871,31,0
22401060,3,306,0.0,0.0,720,414
22401060,3,85,4.0,2.8235294117647056,406,321
22401060,3,77,0.0,0.0,321,244
22401060,3,7,-2.0,-17.142857142857142,234,227
22401060,3,63,-3.0,-2.8571428571428568,227,164
22401060,3,82,-8.0,-5.853658536585366,140,58
22401060,3,27,1.0,2.2222222222222223,58,31
22401060,3,31,-3.0,-5.806451612903226,31,0
22401060,4,117,2.0,1.0256410256410258,720,603
22401060,4,41,0.0,0.0,603,562
22401060,4,108,-1.0,-0.5555555555555556,560,452
22401060,4,23,-1.0,-2.608695652173913,400,377
22401060,4,128,2.0,0.9375,321,193
22401060,4,71,-1.0,-0.8450704225352113,171,100
22401060,4,15,2.0,8.0,15,0
22401061,1,181,-2.0,-0.6629834254143646,720,539
22401061,1,138,2.0,0.8695652173913043,539,401
22401061,1,68,-4.0,-3.5294117647058822,395,327
22401061,1,20,3.0,9.0,309,289
22401061,1,42,-5.0,-7.142857142857142,278,236
22401061,1,32,-2.0,-3.75,227,195
22401061,1,78,-3.0,-2.307692307692308,195,117
22401061,1,100,1.0,0.6,100,0
22401061,2,205,-2.0,-0.5853658536585366,720,515
22401061,2,76,-4.0,-3.1578947368421053,496,420
22401061,2,80,1.0,0.75,420,340
22401061,2,86,-4.0,-2.7906976744186047,329,243
22401061,2,202,1.0,0.297029702970297,224,22
22401061,2,22,-2.0,-5.454545454545455,22,0
22401061,3,284,1.0,0.2112676056338028,720,436
22401061,3,115,-1.0,-0.5217391304347826,416,301
22401061,3,7,-1.0,-8.571428571428571,291,284
22401061,3,118,-1.0,-0.5084745762711864,284,166
22401061,3,12,-1.0,-5.0,166,154
22401061,4,157,-7.0,-2.6751592356687897,720,563
22401061,4,22,2.0,5.454545454545455,563,541
22401061,4,69,-1.0,-0.8695652173913043,530,461
22401061,4,15,1.0,4.0,446,431
22401061,4,431,-13.0,-1.8097447795823665,431,0
22401062,1,327,-12.0,-2.2018348623853212,720,393
22401062,1,96,0.0,0.0,393,297
22401062,1,83,0.0,0.0,297,214
22401062,1,25,0.0,0.0,205,180
22401062,1,106,1.0,0.5660377358490566,180,74
22401062,2,157,4.0,1.5286624203821657,720,563
22401062,2,40,0.0,0.0,563,523
22401062,2,14,1.0,4.285714285714286,523,509
22401062,2,87,1.0,0.6896551724137931,509,422
22401062,2,36,0.0,0.0,403,367
22401062,2,73,-5.0,-4.10958904109589,359,286
22401062,2,49,0.0,0.0,264,215
22401062,2,54,5.0,5.555555555555555,211,157
22401062,2,126,7.0,3.333333333333333,146,20
22401062,3,334,15.0,2.694610778443114,720,386
22401062,3,68,-3.0,-2.647058823529412,386,318
22401062,3,41,-2.0,-2.926829268292683,318,277
22401062,3,79,-2.0,-1.5189873417721518,266,187
22401062,3,49,-2.0,-2.4489795918367343,165,116
22401062,3,106,0.0,0.0,106,0
22401062,4,169,-1.0,-0.35502958579881655,720,551
22401062,4,51,4.0,4.705882352941177,541,490
22401062,4,134,-4.0,-1.791044776119403,473,339
22401062,4,339,-1.0,-0.17699115044247787,339,0
22401063,1,239,7.0,1.7573221757322175,720,481
22401063,1,128,-2.0,-0.9375,471,343
22401063,1,134,6.0,2.6865671641791042,343,209
22401063,1,53,-1.0,-1.1320754716981132,195,142
22401063,1,134,1.0,0.44776119402985076,142,8
22401063,1,2,0.0,0.0,2,0
22401063,2,206,-8.0,-2.3300970873786406,720,514
22401063,2,70,5.0,4.285714285714286,478,408
22401063,2,6,-1.0,-10.0,396,390
22401063,2,83,1.0,0.7228915662650602,390,307
22401063,2,74,-2.0,-1.6216216216216217,297,223
22401063,2,66,0.0,0.0,212,146
22401063,2,104,-6.0,-3.4615384615384617,104,0
22401063,3,311,-6.0,-1.157556270096463,720,409
22401063,3,168,0.0,0.0,390,222
22401063,3,63,-1.0,-0.9523809523809523,222,159
22401063,3,27,-2.0,-4.444444444444445,146,119
22401063,3,9,-3.0,-20.0,111,102
22401063,3,85,-1.0,-0.7058823529411764,85,0
22401063,4,91,1.0,0.6593406593406594,720,629
22401063,4,43,2.0,2.7906976744186047,618,575
22401063,4,97,8.0,4.948453608247423,575,478
22401063,4,76,-2.0,-1.5789473684210527,452,376
22401063,4,21,2.0,5.7142857142857135,364,343
22401063,4,216,5.0,1.3888888888888888,242,26
22401063,4,7,4.0,34.285714285714285,13,6
22401063,4,3,3.0,60.0,3,0
22401064,1,245,-1.0,-0.2448979591836735,720,475
22401064,1,29,2.0,4.137931034482759,475,446
22401064,1,16,-2.0,-7.5,446,430
22401064,1,124,-1.0,-0.4838709677419355,412,288
22401064,1,126,0.0,0.0,288,162
22401064,1,41,4.0,5.853658536585366,162,121
22401064,1,52,0.0,0.0,121,69
22401064,2,236,-1.0,-0.2542372881355932,720,484
22401064,2,80,4.0,3.0,484,404
22401064,2,105,-6.0,-3.4285714285714284,393,288
22401064,2,46,2.0,2.608695652173913,265,219
22401064,2,105,1.0,0.5714285714285715,219,114
22401064,2,27,0.0,0.0,98,71
22401064,2,59,4.0,4.067796610169491,63,4
22401064,2,4,0.0,0.0,4,0
22401064,3,319,2.0,0.37617554858934166,720,401
22401064,3,16,-1.0,-3.75,390,374
22401064,3,99,-2.0,-1.2121212121212122,374,275
22401064,3,48,2.0,2.5,261,213
22401064,3,43,-1.0,-1.3953488372093024,205,162
22401064,3,149,-5.0,-2.0134228187919465,162,13
22401064,3,2,0.0,0.0,13,11
22401064,4,231,-1.0,-0.2597402597402597,720,489
22401064,4,13,0.0,0.0,489,476
22401064,4,56,-3.0,-3.214285714285714,476,420
22401064,4,20,2.0,6.0,396,376
22401064,4,79,8.0,6.075949367088607,356,277
22401064,4,106,3.0,1.6981132075471699,260,154
22401064,4,12,2.0,10.0,145,133
22401064,4,114,1.0,0.5263157894736842,114,0
22401065,1,233,-7.0,-1.8025751072961373,720,487
22401065,1,53,0.0,0.0,469,416
22401065,1,73,0.0,0.0,416,343
22401065,1,198,-1.0,-0.30303030303030304,342,144
22401065,1,55,2.0,2.1818181818181817,137,82
22401065,1,73,-1.0,-0.821917808219178,73,0
22401065,2,128,-3.0,-1.40625,720,592
22401065,2,102,-2.0,-1.1764705882352942,592,490
22401065,2,47,-4.0,-5.1063829787234045,483,436
22401065,2,46,0.0,0.0,418,372
22401065,2,40,-3.0,-4.5,361,321
22401065,2,39,3.0,4.615384615384616,317,278
22401065,2,145,1.0,0.41379310344827586,278,133
22401065,2,124,8.0,3.870967741935484,124,0
22401065,3,218,-12.0,-3.302752293577982,720,502
22401065,3,40,1.0,1.5,386,346
22401065,3,103,2.0,1.1650485436893203,342,239
22401065,3,31,-3.0,-5.806451612903226,239,208
22401065,3,96,3.0,1.875,196,100
22401065,3,83,-2.0,-1.4457831325301205,83,0
22401065,4,175,0.0,0.0,720,545
22401065,4,34,3.0,5.294117647058824,540,506
22401065,4,46,2.0,2.608695652173913,506,460
22401065,4,71,-1.0,-0.8450704225352113,448,377
22401065,4,74,0.0,0.0,377,303
22401065,4,40,-1.0,-1.5,289,249
22401065,4,78,0.0,0.0,249,171
22401065,4,97,-4.0,-2.4742268041237114,171,74
22401066,1,310,1.0,0.1935483870967742,720,410
22401066,1,141,5.0,2.127659574468085,394,253
22401066,1,73,-1.0,-0.821917808219178,253,180
22401066,1,172,4.0,1.3953488372093024,180,8
22401066,1,2,0.0,0.0,2,0
22401066,2,245,2.0,0.489795918367347,720,475
22401066,2,103,2.0,1.1650485436893203,458,355
22401066,2,87,3.0,2.0689655172413794,355,268
22401066,2,205,0.0,0.0,259,54
22401066,2,43,1.0,1.3953488372093024,54,11
22401066,2,11,0.0,0.0,11,0
22401066,3,172,3.0,1.0465116279069768,720,548
22401066,3,112,-4.0,-2.142857142857143,530,418
22401066,3,21,-2.0,-5.7142857142857135,408,387
22401066,3,69,0.0,0.0,369,300
22401066,3,18,1.0,3.333333333333333,300,282
22401066,3,11,0.0,0.0,282,271
22401066,3,57,-1.0,-1.0526315789473684,271,214
22401066,3,185,-1.0,-0.32432432432432434,214,29
22401066,4,158,4.0,1.5189873417721518,720,562
22401066,4,78,-2.0,-1.5384615384615383,552,474
22401066,4,72,-1.0,-0.8333333333333333,474,402
22401066,4,45,0.0,0.0,402,357
22401066,4,246,1.0,0.24390243902439027,357,111
22401066,4,96,0.0,0.0,96,0
22401067,1,334,0.0,0.0,720,386
22401067,1,64,0.0,0.0,370,306
22401067,1,50,0.0,0.0,296,246
22401067,1,68,2.0,1.7647058823529411,246,178
22401067,1,94,2.0,1.2765957446808511,178,84
22401067,1,67,1.0,0.8955223880597015,70,3
22401067,1,1,0.0,0.0,1,0
22401067,2,105,-8.0,-4.571428571428572,720,615
22401067,2,45,-3.0,-4.0,601,556
22401067,2,67,7.0,6.26865671641791,545,478
22401067,2,87,0.0,0.0,460,373
22401067,2,11,0.0,0.0,373,362
22401067,2,64,0.0,0.0,348,284
22401067,2,122,-1.0,-0.49180327868852464,271,149
22401067,2,131,8.0,3.66412213740458,131,0
22401067,3,193,7.0,2.176165803108808,720,527
22401067,3,72,2.0,1.6666666666666665,527,455
22401067,3,91,0.0,0.0,442,351
22401067,3,91,-5.0,-3.2967032967032965,351,260
22401067,3,17,0.0,0.0,255,238
22401067,3,34,3.0,5.294117647058824,238,204
22401067,3,26,2.0,4.615384615384616,204,178
22401067,3,178,5.0,1.6853932584269662,178,0
22401067,4,109,1.0,0.5504587155963303,720,611
22401067,4,67,2.0,1.791044776119403,603,536
22401067,4,62,-2.0,-1.935483870967742,518,456
22401067,4,73,-4.0,-3.287671232876712,440,367
22401067,4,15,-2.0,-8.0,367,352
22401067,4,52,0.0,0.0,352,300
22401067,4,229,3.0,0.7860262008733624,300,71
22401067,4,62,-2.0,-1.935483870967742,62,0
22401068,1,300,4.0,0.8,720,420
22401068,1,31,0.0,0.0,418,387
22401068,1,150,5.0,2.0,387,237
22401068,1,102,-2.0,-1.1764705882352942,219,117
22401068,1,68,-1.0,-0.8823529411764706,107,39
22401068,2,205,-2.0,-0.5853658536585366,720,515
22401068,2,87,-3.0,-2.0689655172413794,506,419
22401068,2,24,0.0,0.0,407,383
22401068,2,45,0.0,0.0,372,327
22401068,2,100,-5.0,-3.0,315,215
22401068,2,213,-10.0,-2.816901408450704,213,0
22401068,3,284,-10.0,-2.1126760563380285,720,436
22401068,3,75,-5.0,-4.0,429,354
22401068,3,123,-7.0,-3.4146341463414633,337,214
22401068,3,29,-1.0,-2.0689655172413794,205,176
22401068,3,84,1.0,0.7142857142857142,176,92
22401068,3,24,2.0,5.0,92,68
22401068,4,129,4.0,1.8604651162790697,720,591
22401068,4,54,2.0,2.2222222222222223,591,537
22401068,4,64,-1.0,-0.9375,537,473
22401068,4,56,1.0,1.0714285714285714,461,405
22401068,4,26,-1.0,-2.307692307692308,399,373
22401068,4,113,0.0,0.0,373,260
22401068,4,47,1.0,1.2765957446808511,247,200
22401068,4,200,0.0,0.0,200,0
22401069,1,320,0.0,0.0,720,400
22401069,1,67,3.0,2.6865671641791042,391,324
22401069,1,31,-2.0,-3.870967741935484,312,281
22401069,1,25,-1.0,-2.4,272,247
22401069,1,125,2.0,0.96,247,122
22401069,1,49,3.0,3.673469387755102,116,67
22401069,1,64,2.0,1.875,67,3
22401069,2,99,0.0,0.0,720,621
22401069,2,75,-1.0,-0.8,613,538
22401069,2,34,2.0,3.5294117647058822,521,487
22401069,2,21,2.0,5.7142857142857135,478,457
22401069,2,21,0.0,0.0,437,416
22401069,2,59,0.0,0.0,394,335
22401069,2,82,-4.0,-2.926829268292683,322,240
22401069,2,180,-4.0,-1.3333333333333335,227,47
22401069,2,47,-1.0,-1.2765957446808511,47,0
22401069,3,298,6.0,1.2080536912751678,720,422
22401069,3,23,1.0,2.608695652173913,393,370
22401069,3,104,3.0,1.7307692307692308,370,266
22401069,3,61,-3.0,-2.9508196721311473,266,205
22401069,3,34,3.0,5.294117647058824,205,171
22401069,3,154,-1.0,-0.38961038961038963,165,11
22401069,3,11,2.0,10.90909090909091,11,0
22401069,4,224,3.0,0.8035714285714285,720,496
22401069,4,81,-1.0,-0.7407407407407407,496,415
22401069,4,170,1.0,0.3529411764705882,394,224
22401069,4,58,-3.0,-3.103448275862069,210,152
22401069,4,143,0.0,0.0,143,0
22401070,1,184,0.0,0.0,720,536
22401070,1,109,-6.0,-3.302752293577982,536,427
22401070,1,130,0.0,0.0,403,273
22401070,1,71,0.0,0.0,267,196
22401070,1,93,0.0,0.0,184,91
22401070,1,91,-2.0,-1.3186813186813189,91,0
22401070,2,202,-6.0,-1.782178217821782,720,518
22401070,2,128,-2.0,-0.9375,518,390
22401070,2,38,2.0,3.1578947368421053,390,352
22401070,2,9,0.0,0.0,344,335
22401070,2,97,-1.0,-0.6185567010309279,324,227
22401070,2,188,2.0,0.6382978723404256,227,39
22401070,2,36,4.0,6.666666666666666,36,0
22401070,3,399,7.0,1.0526315789473684,720,321
22401070,3,87,-3.0,-2.0689655172413794,316,229
22401070,3,145,2.0,0.8275862068965517,206,61
22401070,3,5,0.0,0.0,44,39
22401070,3,16,0.0,0.0,33,17
22401070,4,189,-8.0,-2.5396825396825395,720,531
22401070,4,132,4.0,1.8181818181818183,518,386
22401070,4,106,-1.0,-0.5660377358490566,370,264
22401070,4,95,-1.0,-0.631578947368421,251,156
22401070,4,122,-1.0,-0.49180327868852464,225,103
22401070,4,65,-1.0,-0.9230769230769231,97,32
22401070,4,24,0.0,0.0,32,8
22401070,4,4,0.0,0.0,4,0
22401071,1,208,9.0,2.5961538461538463,720,512
22401071,1,97,-4.0,-2.4742268041237114,495,398
22401071,1,89,5.0,3.3707865168539324,394,305
22401071,1,142,-2.0,-0.8450704225352113,305,163
22401071,1,147,-4.0,-1.6326530612244898,147,0
22401071,2,239,4.0,1.00418410041841,720,481
22401071,2,71,0.0,0.0,481,410
22401071,2,190,-4.0,-1.263157894736842,400,210
22401071,2,40,0.0,0.0,206,166
22401071,2,73,-1.0,-0.821917808219178,149,76
22401071,2,63,0.0,0.0,76,13
22401071,2,7,0.0,0.0,13,6
22401071,2,1,0.0,0.0,1,0
22401071,3,387,6.0,0.9302325581395349,720,333
22401071,3,93,1.0,0.6451612903225807,329,236
22401071,3,20,0.0,0.0,233,213
22401071,3,12,0.0,0.0,213,201
22401071,3,188,-1.0,-0.3191489361702128,191,3
22401071,3,1,2.0,120.0,1,0
22401071,4,196,4.0,1.2244897959183672,720,524
22401071,4,119,0.0,0.0,500,381
22401071,4,29,3.0,6.206896551724138,370,341
22401071,4,53,-2.0,-2.2641509433962264,334,281
22401071,4,140,-2.0,-0.8571428571428571,261,121
22401072,1,360,7.0,1.1666666666666667,720,360
22401072,1,44,-2.0,-2.7272727272727275,360,316
22401072,1,13,1.0,4.615384615384616,308,295
22401072,1,133,-6.0,-2.706766917293233,295,162
22401072,1,141,1.0,0.425531914893617,146,5
22401072,1,3,0.0,0.0,3,0
22401072,2,120,-3.0,-1.5,720,600
22401072,2,106,4.0,2.2641509433962264,591,485
22401072,2,28,-2.0,-4.285714285714286,467,439
22401072,2,10,0.0,0.0,439,429
22401072,2,128,-2.0,-0.9375,419,291
22401072,2,93,4.0,2.580645161290323,291,198
22401072,2,26,0.0,0.0,182,156
22401072,2,121,-2.0,-0.9917355371900827,156,35
22401072,2,35,0.0,0.0,35,0
22401072,3,260,-6.0,-1.3846153846153846,720,460
22401072,3,65,-2.0,-1.8461538461538463,460,395
22401072,3,51,-2.0,-2.3529411764705883,378,327
22401072,3,100,-1.0,-0.6,327,227
22401072,3,20,-1.0,-3.0,217,197
22401072,3,20,3.0,9.0,197,177
22401072,3,177,3.0,1.0169491525423728,177,0
22401072,4,90,-6.0,-4.0,720,630
22401072,4,114,-4.0,-2.1052631578947367,609,495
22401072,4,24,0.0,0.0,495,471
22401072,4,28,-3.0,-6.428571428571428,460,432
22401072,4,15,2.0,8.0,432,417
22401072,4,57,0.0,0.0,417,360
22401072,4,67,4.0,3.582089552238806,360,293
22401072,4,65,-3.0,-2.769230769230769,280,215
22401072,4,3,-1.0,-20.0,198,195
22401072,4,25,0.0,0.0,195,170
22401072,4,123,-2.0,-0.9756097560975611,170,47
22401072,4,8,-1.0,-7.5,8,0
22401073,1,217,0.0,0.0,720,503
22401073,1,51,4.0,4.705882352941177,503,452
22401073,1,62,-3.0,-2.903225806451613,431,369
22401073,1,151,6.0,2.384105960264901,369,218
22401073,1,55,2.0,2.1818181818181817,207,152
22401073,1,25,2.0,4.8,132,107
22401073,2,115,3.0,1.5652173913043477,720,605
22401073,2,60,1.0,1.0,597,537
22401073,2,79,-8.0,-6.075949367088607,532,453
22401073,2,84,-2.0,-1.4285714285714284,439,355
22401073,2,43,2.0,2.7906976744186047,338,295
22401073,2,158,4.0,1.5189873417721518,295,137
22401073,2,42,1.0,1.4285714285714284,113,71
22401073,2,71,1.0,0.8450704225352113,71,0
22401073,3,263,-1.0,-0.22813688212927757,720,457
22401073,3,38,4.0,6.315789473684211,457,419
22401073,3,46,2.0,2.608695652173913,402,356
22401073,3,124,0.0,0.0,356,232
22401073,3,113,3.0,1.592920353982301,227,114
22401073,3,99,2.0,1.2121212121212122,105,6
22401073,3,6,0.0,0.0,6,0
22401073,4,24,3.0,7.5,720,696
22401073,4,69,3.0,2.608695652173913,681,612
22401073,4,100,0.0,0.0,606,506
22401073,4,86,8.0,5.5813953488372094,497,411
22401073,4,117,3.0,1.5384615384615383,394,277
22401073,4,273,-2.0,-0.43956043956043955,273,0
22401074,1,225,3.0,0.8,720,495
22401074,1,223,-2.0,-0.5381165919282511,549,326
22401074,1,78,3.0,2.307692307692308,308,230
22401074,1,53,-1.0,-1.1320754716981132,230,177
22401074,1,104,10.0,5.769230769230769,175,71
22401074,2,215,0.0,0.0,720,505
22401074,2,43,3.0,4.186046511627907,492,449
22401074,2,186,-1.0,-0.32258064516129037,433,247
22401074,2,66,5.0,4.545454545454546,239,173
22401074,2,32,-3.0,-5.625,173,141
22401074,2,124,-1.0,-0.4838709677419355,133,9
22401074,3,204,1.0,0.29411764705882354,720,516
22401074,3,186,9.0,2.903225806451613,516,330
22401074,3,115,7.0,3.6521739130434785,330,215
22401074,3,9,-3.0,-20.0,200,191
22401074,3,174,3.0,1.0344827586206897,180,6
22401074,4,137,3.0,1.3138686131386863,720,583
22401074,4,24,3.0,7.5,569,545
22401074,4,139,-6.0,-2.589928057553957,533,394
22401074,4,239,2.0,0.502092050209205,379,140
22401075,1,326,0.0,0.0,720,394
22401075,1,38,-3.0,-4.7368421052631575,385,347
22401075,1,18,4.0,13.333333333333332,333,315
22401075,1,69,0.0,0.0,296,227
22401075,1,103,-1.0,-0.5825242718446602,227,124
22401075,1,121,3.0,1.487603305785124,121,0
22401075,2,221,1.0,0.2714932126696833,720,499
22401075,2,75,4.0,3.2,499,424
22401075,2,43,0.0,0.0,424,381
22401075,2,21,0.0,0.0,368,347
22401075,2,339,-2.0,-0.35398230088495575,339,0
22401075,3,210,-5.0,-1.4285714285714284,720,510
22401075,3,87,-1.0,-0.6896551724137931,503,416
22401075,3,68,3.0,2.647058823529412,416,348
22401075,3,17,0.0,0.0,341,324
22401075,3,103,0.0,0.0,316,213
22401075,3,211,0.0,0.0,211,0
22401075,4,306,-5.0,-0.9803921568627452,720,414
22401075,4,207,-5.0,-1.4492753623188406,408,201
22401075,4,20,0.0,0.0,198,178
22401075,4,154,6.0,2.3376623376623376,162,8
22401075,4,2,-2.0,-60.0,2,0
22401076,1,316,-5.0,-0.949367088607595,720,404
22401076,1,70,0.0,0.0,404,334
22401076,1,87,1.0,0.6896551724137931,334,247
22401076,1,109,-4.0,-2.2018348623853212,229,120
22401076,1,110,1.0,0.5454545454545454,110,0
22401076,2,199,-5.0,-1.5075376884422111,720,521
22401076,2,127,1.0,0.47244094488188976,487,360
22401076,2,102,-1.0,-0.5882352941176471,350,248
22401076,2,66,3.0,2.7272727272727275,231,165
22401076,2,86,-3.0,-2.0930232558139537,148,62
22401076,2,62,-4.0,-3.870967741935484,62,0
22401076,3,236,3.0,0.7627118644067797,720,484
22401076,3,83,-4.0,-2.891566265060241,484,401
22401076,3,43,3.0,4.186046511627907,389,346
22401076,3,101,-4.0,-2.376237623762376,327,226
22401076,3,44,0.0,0.0,215,171
22401076,3,366,-9.0,-1.4754098360655736,366,0
22401076,4,331,-1.0,-0.18126888217522658,720,389
22401076,4,257,4.0,0.933852140077821,377,120
22401076,4,70,-3.0,-2.5714285714285716,106,36
22401076,4,28,1.0,2.142857142857143,28,0
22401077,1,234,9.0,2.307692307692308,720,486
22401077,1,33,-1.0,-1.8181818181818183,478,445
22401077,1,49,0.0,0.0,445,396
22401077,1,107,-2.0,-1.1214953271028036,376,269
22401077,1,37,-2.0,-3.2432432432432434,258,221
22401077,1,28,-2.0,-4.285714285714286,221,193
22401077,1,44,0.0,0.0,181,137
22401077,1,14,1.0,4.285714285714286,115,101
22401077,1,101,7.0,4.158415841584159,101,0
22401077,2,157,6.0,2.2929936305732483,720,563
22401077,2,116,0.0,0.0,563,447
22401077,2,145,-5.0,-2.0689655172413794,447,302
22401077,2,6,0.0,0.0,288,282
22401077,2,52,-5.0,-5.769230769230769,280,228
22401077,2,20,-1.0,-3.0,221,201
22401077,2,126,-1.0,-0.47619047619047616,201,75
22401077,2,75,0.0,0.0,75,0
22401077,3,241,-5.0,-1.2448132780082988,720,479
22401077,3,89,2.0,1.348314606741573,479,390
22401077,3,24,2.0,5.0,376,352
22401077,3,18,2.0,6.666666666666666,344,326
22401077,3,50,-3.0,-3.5999999999999996,326,276
22401077,3,92,4.0,2.608695652173913,266,174
22401077,3,157,0.0,0.0,157,0
22401077,4,41,-3.0,-4.390243902439024,720,679
22401077,4,116,0.0,0.0,679,563
22401077,4,112,2.0,1.0714285714285714,548,436
22401077,4,103,-6.0,-3.4951456310679614,420,317
22401077,4,102,-4.0,-2.3529411764705883,299,197
22401077,4,161,5.0,1.8633540372670807,197,36
22401077,4,24,0.0,0.0,32,8
22401077,4,1,-1.0,-60.0,7,6
22401077,4,6,3.0,30.0,6,0
22401078,1,237,0.0,0.0,720,483
22401078,1,41,2.0,2.926829268292683,424,383
22401078,1,55,-1.0,-1.0909090909090908,372,317
22401078,1,13,0.0,0.0,315,302
22401078,1,9,-2.0,-13.333333333333332,292,283
22401078,1,56,3.0,3.214285714285714,283,227
22401078,1,83,-1.0,-0.7228915662650602,219,136
22401078,1,135,-4.0,-1.777777777777778,136,1
22401078,2,45,2.0,2.666666666666667,720,675
22401078,2,126,-6.0,-2.8571428571428568,661,535
22401078,2,56,-1.0,-1.0714285714285714,504,448
22401078,2,43,2.0,2.7906976744186047,448,405
22401078,2,8,0.0,0.0,405,397
22401078,2,26,3.0,6.923076923076923,386,360
22401078,2,113,4.0,2.1238938053097343,411,298
22401078,2,94,-4.0,-2.5531914893617023,298,204
22401078,2,11,0.0,0.0,204,193
22401078,2,85,1.0,0.7058823529411764,184,99
22401078,2,87,1.0,0.6896551724137931,87,0
22401078,3,113,7.0,3.7168141592920354,720,607
22401078,3,162,-1.0,-0.37037037037037035,601,439
22401078,3,49,1.0,1.2244897959183672,417,368
22401078,3,33,2.0,3.6363636363636367,356,323
22401078,3,103,-1.0,-0.5825242718446602,316,213
22401078,3,52,-2.0,-2.307692307692308,193,141
22401078,3,42,4.0,5.7142857142857135,141,99
22401078,3,81,1.0,0.7407407407407407,99,18
22401078,3,12,2.0,10.0,14,2
22401078,4,205,7.0,2.048780487804878,720,515
22401078,4,73,-3.0,-2.4657534246575343,500,427
22401078,4,81,-3.0,-2.2222222222222223,427,346
22401078,4,29,0.0,0.0,332,303
22401078,4,66,2.0,1.8181818181818183,285,219
22401078,4,17,-2.0,-7.0588235294117645,204,187
22401078,4,154,-3.0,-1.1688311688311688,187,33
22401078,4,27,-1.0,-2.2222222222222223,27,0
22401079,1,301,-2.0,-0.39867109634551495,720,419
22401079,1,74,-4.0,-3.2432432432432434,419,345
22401079,1,79,3.0,2.278481012658228,345,266
22401079,1,48,2.0,2.5,266,218
22401079,1,95,3.0,1.8947368421052633,205,110
22401079,1,84,3.0,2.142857142857143,110,26
22401079,1,21,0.0,0.0,23,2
22401079,1,1,0.0,0.0,1,0
22401079,2,289,1.0,0.20761245674740486,720,431
22401079,2,92,-2.0,-1.3043478260869565,418,326
22401079,2,34,0.0,0.0,312,278
22401079,2,29,3.0,6.206896551724138,278,249
22401079,2,2,0.0,0.0,235,233
22401079,2,88,6.0,4.090909090909091,228,140
22401079,2,58,2.0,2.0689655172413794,140,82
22401079,2,74,3.0,2.4324324324324325,82,8
22401079,3,342,2.0,0.3508771929824561,720,378
22401079,3,5,0.0,0.0,378,373
22401079,3,58,-1.0,-1.0344827586206897,373,315
22401079,3,106,0.0,0.0,303,197
22401079,3,163,8.0,2.9447852760736195,197,34
22401079,3,13,0.0,0.0,13,0
22401079,4,179,2.0,0.670391061452514,720,541
22401079,4,63,-3.0,-2.8571428571428568,541,478
22401079,4,117,0.0,0.0,466,349
22401079,4,59,-1.0,-1.0169491525423728,330,271
22401079,4,271,-4.0,-0.8856088560885609,271,0
22401080,1,346,-3.0,-0.5202312138728323,720,374
22401080,1,140,-1.0,-0.42857142857142855,374,234
22401080,1,215,-1.0,-0.27906976744186046,215,0
22401080,2,158,-4.0,-1.5189873417721518,720,562
22401080,2,49,-2.0,-2.4489795918367343,550,501
22401080,2,69,-2.0,-1.7391304347826086,501,432
22401080,2,61,4.0,3.934426229508197,432,371
22401080,2,31,1.0,1.935483870967742,371,340
22401080,2,77,3.0,2.3376623376623376,340,263
22401080,2,52,-3.0,-3.4615384615384617,263,211
22401080,2,135,0.0,0.0,199,64
22401080,2,64,-4.0,-3.75,64,0
22401080,3,171,5.0,1.7543859649122806,720,549
22401080,3,77,-2.0,-1.5584415584415585,549,472
22401080,3,54,-1.0,-1.1111111111111112,469,415
22401080,3,154,-3.0,-1.1688311688311688,399,245
22401080,3,94,2.0,1.2765957446808511,233,139
22401080,3,119,1.0,0.5042016806722689,119,0
22401080,4,100,-1.0,-0.6,720,620
22401080,4,9,0.0,0.0,620,611
22401080,4,59,2.0,2.0338983050847457,599,540
22401080,4,229,3.0,0.7860262008733624,510,281
22401080,4,52,1.0,1.153846153846154,275,223
22401080,4,223,-2.0,-0.5381165919282511,223,0
22401081,1,298,1.0,0.20134228187919462,720,422
22401081,1,114,-3.0,-1.5789473684210527,422,308
22401081,1,23,0.0,0.0,308,285
22401081,1,40,0.0,0.0,275,235
22401081,1,6,2.0,20.0,224,218
22401081,1,218,9.0,2.4770642201834865,218,0
22401081,2,206,-6.0,-1.7475728155339807,720,514
22401081,2,66,1.0,0.9090909090909092,514,448
22401081,2,64,1.0,0.9375,434,370
22401081,2,22,0.0,0.0,345,323
22401081,2,112,-1.0,-0.5357142857142857,323,211
22401081,2,179,-2.0,-0.670391061452514,205,26
22401081,2,26,0.0,0.0,26,0
22401081,3,302,4.0,0.7947019867549668,720,418
22401081,3,50,3.0,3.5999999999999996,418,368
22401081,3,69,3.0,2.608695652173913,368,299
22401081,3,50,2.0,2.4,282,232
22401081,3,27,0.0,0.0,232,205
22401081,3,188,5.0,1.5957446808510638,188,0
22401081,4,141,-3.0,-1.2765957446808511,720,579
22401081,4,91,4.0,2.6373626373626378,567,476
22401081,4,159,-6.0,-2.2641509433962264,469,310
22401081,4,101,2.0,1.188118811881188,297,196
22401081,4,146,-4.0,-1.643835616438356,196,50
22401081,4,18,-3.0,-10.0,41,23
22401081,4,19,0.0,0.0,19,0
22401082,1,421,-5.0,-0.7125890736342042,720,299
22401082,1,87,3.0,2.0689655172413794,299,212
22401082,1,112,0.0,0.0,204,92
22401082,1,31,3.0,5.806451612903226,64,33
22401082,1,31,2.0,3.870967741935484,33,2
22401082,2,181,5.0,1.6574585635359116,720,539
22401082,2,91,-2.0,-1.3186813186813189,529,438
22401082,2,10,0.0,0.0,438,428
22401082,2,64,5.0,4.6875,422,358
22401082,2,123,-5.0,-2.4390243902439024,333,210
22401082,2,191,-10.0,-3.141361256544503,193,2
22401082,2,2,0.0,0.0,2,0
22401082,3,318,3.0,0.5660377358490566,720,402
22401082,3,94,0.0,0.0,387,293
22401082,3,83,-2.0,-1.4457831325301205,275,192
22401082,3,84,2.0,1.4285714285714284,183,99
22401082,3,85,2.0,1.4117647058823528,85,0
22401082,4,130,6.0,2.769230769230769,720,590
22401082,4,111,2.0,1.0810810810810811,581,470
22401082,4,37,1.0,1.6216216216216217,470,433
22401082,4,11,0.0,0.0,433,422
22401082,4,38,-3.0,-4.7368421052631575,400,362
22401082,4,251,5.0,1.1952191235059761,408,157
22401082,4,69,3.0,2.608695652173913,143,74
22401082,4,33,2.0,3.6363636363636367,69,36
22401082,4,36,0.0,0.0,36,0
22401083,1,357,-1.0,-0.16806722689075632,720,363
22401083,1,35,0.0,0.0,363,328
22401083,1,79,2.0,1.5189873417721518,323,244
22401083,1,39,2.0,3.0769230769230766,244,205
22401083,1,72,2.0,1.6666666666666665,194,122
22401083,1,122,5.0,2.4590163934426226,122,0
22401083,2,109,-1.0,-0.5504587155963303,720,611
22401083,2,10,-1.0,-6.0,611,601
22401083,2,98,-3.0,-1.836734693877551,601,503
22401083,2,51,2.0,2.3529411764705883,497,446
22401083,2,13,-2.0,-9.230769230769232,434,421
22401083,2,47,0.0,0.0,421,374
22401083,2,30,-5.0,-10.0,374,344
22401083,2,64,-3.0,-2.8125,331,267
22401083,2,14,2.0,8.571428571428571,267,253
22401083,2,48,2.0,2.5,253,205
22401083,2,21,-1.0,-2.8571428571428568,186,165
22401083,2,165,0.0,0.0,165,0
22401083,3,208,-10.0,-2.8846153846153846,720,512
22401083,3,112,-2.0,-1.0714285714285714,506,394
22401083,3,24,-1.0,-2.5,389,365
22401083,3,135,-3.0,-1.3333333333333335,356,221
22401083,3,13,0.0,0.0,190,177
22401083,3,177,-1.0,-0.3389830508474576,177,0
22401083,4,166,6.0,2.1686746987951806,720,554
22401083,4,166,4.0,1.4457831325301205,549,383
22401083,4,89,3.0,2.0224719101123596,369,280
22401083,4,128,-4.0,-1.875,280,152
22401083,4,10,-2.0,-12.0,152,142
22401083,4,135,-2.0,-0.888888888888889,135,0
22401084,1,347,-10.0,-1.7291066282420748,720,373
22401084,1,20,0.0,0.0,373,353
22401084,1,111,-1.0,-0.5405405405405406,349,238
22401084,1,20,0.0,0.0,238,218
22401084,1,13,1.0,4.615384615384616,189,176
22401084,1,114,-3.0,-1.5789473684210527,176,62
22401084,1,61,0.0,0.0,61,0
22401084,2,204,5.0,1.4705882352941175,720,516
22401084,2,5,1.0,12.0,516,511
22401084,2,58,-1.0,-1.0344827586206897,496,438
22401084,2,104,-1.0,-0.576923076923077,516,412
22401084,2,51,2.0,2.3529411764705883,405,354
22401084,2,15,-2.0,-8.0,345,330
22401084,2,86,1.0,0.6976744186046512,330,244
22401084,2,33,3.0,5.454545454545455,244,211
22401084,2,172,0.0,0.0,211,39
22401084,3,434,10.0,1.3824884792626728,720,286
22401084,3,62,-2.0,-1.935483870967742,259,197
22401084,3,72,1.0,0.8333333333333333,174,102
22401084,3,102,1.0,0.5882352941176471,102,0
22401084,4,70,-2.0,-1.7142857142857142,720,650
22401084,4,94,-1.0,-0.6382978723404256,633,539
22401084,4,77,3.0,2.3376623376623376,530,453
22401084,4,11,3.0,16.363636363636363,432,421
22401084,4,63,2.0,1.9047619047619047,410,347
22401084,4,111,2.0,1.0810810810810811,347,236
22401084,4,84,0.0,0.0,217,133
22401084,4,122,-3.0,-1.4754098360655736,122,0
22401085,1,286,-3.0,-0.6293706293706294,720,434
22401085,1,43,-1.0,-1.3953488372093024,416,373
22401085,1,21,0.0,0.0,373,352
22401085,1,35,2.0,3.4285714285714284,338,303
22401085,1,37,1.0,1.6216216216216217,278,241
22401085,1,11,0.0,0.0,231,220
22401085,1,206,-2.0,-0.5825242718446602,206,0
22401085,2,51,3.0,3.5294117647058822,720,669
22401085,2,80,-4.0,-3.0,669,589
22401085,2,6,-2.0,-20.0,587,581
22401085,2,131,0.0,0.0,581,450
22401085,2,66,-1.0,-0.9090909090909092,441,375
22401085,2,80,0.0,0.0,356,276
22401085,2,19,-1.0,-3.1578947368421053,211,192
22401085,2,192,2.0,0.625,192,0
22401085,3,174,4.0,1.3793103448275863,720,546
22401085,3,93,-6.0,-3.870967741935484,546,453
22401085,3,84,4.0,2.8571428571428568,453,369
22401085,3,141,5.0,2.127659574468085,352,211
22401085,3,203,2.0,0.5911330049261084,203,0
22401085,4,203,1.0,0.2955665024630542,720,517
22401085,4,51,1.0,1.1764705882352942,507,456
22401085,4,55,-1.0,-1.0909090909090908,456,401
22401085,4,103,1.0,0.5825242718446602,401,298
22401085,4,259,-4.0,-0.9266409266409267,290,31
22401085,4,1,0.0,0.0,31,30
22401085,4,3,0.0,0.0,3,0
22401086,1,238,-8.0,-2.0168067226890756,720,482
22401086,1,25,-4.0,-9.6,482,457
22401086,1,59,1.0,1.0169491525423728,439,380
22401086,1,42,3.0,4.285714285714286,380,338
22401086,1,33,3.0,5.454545454545455,323,290
22401086,1,108,-5.0,-2.7777777777777777,281,173
22401086,1,46,-1.0,-1.3043478260869565,163,117
22401086,1,117,1.0,0.5128205128205129,117,0
22401086,2,72,0.0,0.0,720,648
22401086,2,156,0.0,0.0,631,475
22401086,2,44,-2.0,-2.7272727272727275,463,419
22401086,2,17,-1.0,-3.5294117647058822,403,386
22401086,2,40,0.0,0.0,386,346
22401086,2,54,-2.0,-2.2222222222222223,334,280
22401086,2,80,-3.0,-2.25,280,200
22401086,2,188,1.0,0.3191489361702128,188,0
22401086,3,282,-2.0,-0.425531914893617,720,438
22401086,3,52,-2.0,-2.307692307692308,426,374
22401086,3,67,-1.0,-0.8955223880597015,374,307
22401086,3,87,3.0,2.0689655172413794,302,215
22401086,3,9,0.0,0.0,203,194
22401086,3,130,-11.0,-5.0769230769230775,182,52
22401086,3,35,-2.0,-3.4285714285714284,35,0
22401086,4,108,2.0,1.1111111111111112,720,612
22401086,4,52,4.0,4.615384615384616,612,560
22401086,4,30,-2.0,-4.0,560,530
22401086,4,50,-2.0,-2.4,510,460
22401086,4,109,-1.0,-0.5504587155963303,443,334
22401086,4,91,-8.0,-5.2747252747252755,334,243
22401086,4,85,-2.0,-1.4117647058823528,227,142
22401086,4,142,3.0,1.267605633802817,142,0
22401087,1,323,-3.0,-0.5572755417956656,720,397
22401087,1,111,0.0,0.0,392,281
22401087,1,93,2.0,1.2903225806451615,242,149
22401087,1,149,0.0,0.0,149,0
22401087,2,134,-3.0,-1.3432835820895521,720,586
22401087,2,29,0.0,0.0,584,555
22401087,2,2,0.0,0.0,539,537
22401087,2,81,-6.0,-4.444444444444445,537,456
22401087,2,29,0.0,0.0,437,408
22401087,2,45,0.0,0.0,408,363
22401087,2,64,-2.0,-1.875,363,299
22401087,2,242,0.0,0.0,285,43
22401087,2,32,-2.0,-3.75,32,0
22401087,3,236,-4.0,-1.0169491525423728,720,484
22401087,3,88,7.0,4.7727272727272725,484,396
22401087,3,24,1.0,2.5,396,372
22401087,3,164,1.0,0.36585365853658536,372,208
22401087,3,117,-2.0,-1.0256410256410258,195,78
22401087,3,78,-4.0,-3.0769230769230766,78,0
22401087,4,237,-6.0,-1.5189873417721518,720,483
22401087,4,54,3.0,3.333333333333333,483,429
22401087,4,25,0.0,0.0,410,385
22401087,4,77,3.0,2.3376623376623376,374,297
22401087,4,82,-3.0,-2.195121951219512,294,212
22401087,4,203,4.0,1.1822660098522169,203,0
22401088,1,340,-1.0,-0.1764705882352941,720,380
22401088,1,102,-2.0,-1.1764705882352942,361,259
22401088,1,62,0.0,0.0,259,197
22401088,1,43,2.0,2.7906976744186047,197,154
22401088,1,153,-10.0,-3.9215686274509807,154,1
22401088,2,200,-3.0,-0.8999999999999999,720,520
22401088,2,65,-3.0,-2.769230769230769,515,450
22401088,2,32,2.0,3.75,450,418
22401088,2,71,-3.0,-2.535211267605634,418,347
22401088,2,35,-2.0,-3.4285714285714284,347,312
22401088,2,14,2.0,8.571428571428571,302,288
22401088,2,79,-8.0,-6.075949367088607,257,178
22401088,2,127,-5.0,-2.3622047244094486,155,28
22401088,3,303,-6.0,-1.188118811881188,720,417
22401088,3,139,1.0,0.43165467625899284,417,278
22401088,3,51,-1.0,-1.1764705882352942,276,225
22401088,3,97,3.0,1.8556701030927836,225,128
22401088,3,34,1.0,1.7647058823529411,118,84
22401088,3,42,-3.0,-4.285714285714286,42,0
22401088,4,138,3.0,1.3043478260869565,720,582
22401088,4,24,1.0,2.5,582,558
22401088,4,88,-4.0,-2.7272727272727275,558,470
22401088,4,454,-4.0,-0.5286343612334802,454,0
22401089,1,328,8.0,1.4634146341463414,720,392
22401089,1,92,2.0,1.3043478260869565,380,288
22401089,1,58,2.0,2.0689655172413794,279,221
22401089,1,45,-2.0,-2.666666666666667,213,168
22401089,1,168,-4.0,-1.4285714285714284,168,0
22401089,2,89,-3.0,-2.0224719101123596,720,631
22401089,2,177,9.0,3.050847457627119,626,449
22401089,2,3,0.0,0.0,422,419
22401089,2,33,-2.0,-3.6363636363636367,414,381
22401089,2,180,3.0,1.0,381,201
22401089,2,32,-1.0,-1.875,186,154
22401089,2,154,-1.0,-0.38961038961038963,154,0
22401089,3,240,0.0,0.0,720,480
22401089,3,90,0.0,0.0,468,378
22401089,3,48,1.0,1.25,365,317
22401089,3,53,-1.0,-1.1320754716981132,314,261
22401089,3,79,-2.0,-1.5189873417721518,261,182
22401089,3,171,1.0,0.3508771929824561,171,0
22401089,4,104,2.0,1.153846153846154,720,616
22401089,4,120,-5.0,-2.5,599,479
22401089,4,43,3.0,4.186046511627907,460,417
22401089,4,115,-1.0,-0.5217391304347826,415,300
22401089,4,154,1.0,0.38961038961038963,300,146
22401089,4,134,0.0,0.0,134,0
22401090,1,316,7.0,1.3291139240506329,720,404
22401090,1,18,-2.0,-6.666666666666666,393,375
22401090,1,47,0.0,0.0,362,315
22401090,1,68,-5.0,-4.411764705882353,315,247
22401090,1,94,0.0,0.0,247,153
22401090,1,142,0.0,0.0,142,0
22401090,2,229,2.0,0.5240174672489083,720,491
22401090,2,56,2.0,2.142857142857143,491,435
22401090,2,9,-2.0,-13.333333333333332,417,408
22401090,2,201,-3.0,-0.8955223880597015,396,195
22401090,2,59,-3.0,-3.050847457627119,173,114
22401090,2,93,-2.0,-1.2903225806451615,101,8
22401090,2,1,0.0,0.0,1,0
22401090,3,325,-10.0,-1.8461538461538463,720,395
22401090,3,17,0.0,0.0,390,373
22401090,3,111,3.0,1.6216216216216217,373,262
22401090,3,104,3.0,1.7307692307692308,262,158
22401090,3,145,3.0,1.2413793103448276,158,13
22401090,3,1,0.0,0.0,1,0
22401090,4,177,-4.0,-1.3559322033898304,720,543
22401090,4,89,5.0,3.3707865168539324,527,438
22401090,4,62,-2.0,-1.935483870967742,429,367
22401090,4,73,2.0,1.643835616438356,367,294
22401090,4,102,2.0,1.1764705882352942,284,182
22401090,4,229,3.0,0.7860262008733624,281,52
22401090,4,2,0.0,0.0,36,34
22401090,4,19,-1.0,-3.1578947368421053,32,13
22401090,4,13,-3.0,-13.846153846153847,13,0
22401091,1,339,-2.0,-0.35398230088495575,720,381
22401091,1,17,0.0,0.0,361,344
22401091,1,86,0.0,0.0,344,258
22401091,1,4,3.0,45.0,252,248
22401091,1,20,-2.0,-6.0,230,210
22401091,1,22,0.0,0.0,192,170
22401091,1,98,-1.0,-0.6122448979591836,157,59
22401091,1,54,1.0,1.1111111111111112,59,5
22401091,1,5,0.0,0.0,5,0
22401091,2,232,-4.0,-1.0344827586206897,720,488
22401091,2,2,0.0,0.0,472,470
22401091,2,24,0.0,0.0,470,446
22401091,2,51,-2.0,-2.3529411764705883,432,381
22401091,2,121,-2.0,-0.9917355371900827,381,260
22401091,2,238,10.0,2.521008403361345,255,17
22401091,2,17,-3.0,-10.588235294117649,17,0
22401091,3,368,-3.0,-0.4891304347826087,720,352
22401091,3,89,-2.0,-1.348314606741573,338,249
22401091,3,49,-1.0,-1.2244897959183672,227,178
22401091,3,163,-1.0,-0.36809815950920244,163,0
22401091,4,113,-3.0,-1.592920353982301,720,607
22401091,4,85,3.0,2.1176470588235294,595,510
22401091,4,20,0.0,0.0,497,477
22401091,4,58,-5.0,-5.172413793103448,462,404
22401091,4,104,3.0,1.7307692307692308,380,276
22401091,4,89,-3.0,-2.0224719101123596,272,183
22401091,4,59,3.0,3.050847457627119,183,124
22401091,4,74,-2.0,-1.6216216216216217,124,50
22401091,4,19,-2.0,-6.315789473684211,50,31
22401092,1,365,-15.0,-2.4657534246575343,720,355
22401092,1,47,-2.0,-2.5531914893617023,355,308
22401092,1,103,3.0,1.7475728155339807,300,197
22401092,1,18,-1.0,-3.333333333333333,186,168
22401092,1,56,-2.0,-2.142857142857143,168,112
22401092,1,112,4.0,2.142857142857143,112,0
22401092,2,186,-2.0,-0.6451612903225807,720,534
22401092,2,118,0.0,0.0,534,416
22401092,2,37,2.0,3.2432432432432434,396,359
22401092,2,70,-1.0,-0.8571428571428571,335,265
22401092,2,62,2.0,1.935483870967742,265,203
22401092,2,134,0.0,0.0,193,59
22401092,2,59,2.0,2.0338983050847457,59,0
22401092,3,55,0.0,0.0,720,665
22401092,3,303,-6.0,-1.188118811881188,665,362
22401092,3,7,0.0,0.0,362,355
22401092,3,102,-3.0,-1.7647058823529411,347,245
22401092,3,58,4.0,4.137931034482759,230,172
22401092,3,158,-2.0,-0.7594936708860759,164,6
22401092,3,3,0.0,0.0,6,3
22401092,4,107,-4.0,-2.2429906542056073,720,613
22401092,4,97,-4.0,-2.4742268041237114,511,414
22401092,4,95,-1.0,-0.631578947368421,414,319
22401092,4,190,-1.0,-0.3157894736842105,303,113
22401092,4,100,1.0,0.6,100,0
22401093,1,101,-1.0,-0.594059405940594,720,619
22401093,1,148,-4.0,-1.6216216216216217,619,471
22401093,1,96,1.0,0.625,465,369
22401093,1,90,-2.0,-1.3333333333333335,357,267
22401093,1,23,3.0,7.826086956521739,248,225
22401093,1,26,1.0,2.307692307692308,213,187
22401093,1,40,0.0,0.0,187,147
22401093,1,144,4.0,1.6666666666666665,147,3
22401093,1,3,0.0,0.0,3,0
22401093,2,201,2.0,0.5970149253731343,720,519
22401093,2,48,1.0,1.25,502,454
22401093,2,103,-8.0,-4.660194174757281,440,337
22401093,2,141,-6.0,-2.5531914893617023,325,184
22401093,2,87,-2.0,-1.3793103448275863,184,97
22401093,2,97,0.0,0.0,97,0
22401093,3,220,9.0,2.4545454545454546,720,500
22401093,3,54,-3.0,-3.333333333333333,497,443
22401093,3,75,-4.0,-3.2,443,368
22401093,3,215,-3.0,-0.8372093023255813,354,139
22401093,3,124,1.0,0.4838709677419355,124,0
22401093,4,107,2.0,1.1214953271028036,720,613
22401093,4,68,-4.0,-3.5294117647058822,613,545
22401093,4,9,-2.0,-13.333333333333332,545,536
22401093,4,109,-1.0,-0.5504587155963303,536,427
22401093,4,153,5.0,1.9607843137254903,409,256
22401093,4,170,-5.0,-1.7647058823529411,238,68
22401093,4,34,0.0,0.0,49,15
22401094,1,181,5.0,1.6574585635359116,720,539
22401094,1,53,3.0,3.3962264150943398,539,486
22401094,1,155,-5.0,-1.935483870967742,486,331
22401094,1,42,0.0,0.0,320,278
22401094,1,35,3.0,5.142857142857143,278,243
22401094,1,9,0.0,0.0,234,225
22401094,1,58,3.0,3.103448275862069,210,152
22401094,1,17,-1.0,-3.5294117647058822,142,125
22401094,1,123,4.0,1.9512195121951221,125,2
22401094,1,2,0.0,0.0,2,0
22401094,2,94,5.0,3.1914893617021276,720,626
22401094,2,113,1.0,0.5309734513274336,614,501
22401094,2,64,3.0,2.8125,501,437
22401094,2,76,2.0,1.5789473684210527,435,359
22401094,2,51,0.0,0.0,347,296
22401094,2,48,7.0,8.75,287,239
22401094,2,228,9.0,2.3684210526315788,228,0
22401094,3,249,2.0,0.48192771084337344,720,471
22401094,3,85,0.0,0.0,459,374
22401094,3,97,1.0,0.6185567010309279,360,263
22401094,3,76,-3.0,-2.3684210526315788,250,174
22401094,3,74,0.0,0.0,174,100
22401094,3,82,2.0,1.4634146341463414,82,0
22401094,4,81,-1.0,-0.7407407407407407,720,639
22401094,4,100,-3.0,-1.7999999999999998,624,524
22401094,4,39,-2.0,-3.0769230769230766,511,472
22401094,4,81,-2.0,-1.4814814814814814,472,391
22401094,4,363,0.0,0.0,363,0
22401095,1,252,-5.0,-1.1904761904761905,720,468
22401095,1,58,1.0,1.0344827586206897,454,396
22401095,1,112,0.0,0.0,383,271
22401095,1,28,0.0,0.0,270,242
22401095,1,54,1.0,1.1111111111111112,239,185
22401095,1,177,6.0,2.0338983050847457,177,0
22401095,2,156,-1.0,-0.3846153846153846,720,564
22401095,2,47,1.0,1.2765957446808511,554,507
22401095,2,21,0.0,0.0,494,473
22401095,2,92,2.0,1.3043478260869565,463,371
22401095,2,63,1.0,0.9523809523809523,359,296
22401095,2,101,-6.0,-3.564356435643564,296,195
22401095,2,181,6.0,1.9889502762430937,181,0
22401095,3,228,-1.0,-0.2631578947368421,720,492
22401095,3,200,3.0,0.8999999999999999,492,292
22401095,3,111,-4.0,-2.1621621621621623,292,181
22401095,3,181,4.0,1.3259668508287292,181,0
22401095,4,220,5.0,1.3636363636363638,720,500
22401095,4,8,0.0,0.0,484,476
22401095,4,38,-5.0,-7.894736842105263,471,433
22401095,4,39,-2.0,-3.0769230769230766,433,394
22401095,4,103,-5.0,-2.912621359223301,374,271
22401095,4,126,4.0,1.9047619047619047,253,127
22401095,4,34,1.0,1.7647058823529411,127,93
22401095,4,46,-6.0,-7.826086956521739,93,47
22401095,4,11,1.0,5.454545454545455,42,31
22401095,4,22,0.0,0.0,31,9
22401095,4,6,0.0,0.0,7,1
22401096,1,240,-2.0,-0.5,720,480
22401096,1,245,5.0,1.2244897959183672,480,235
22401096,1,124,-2.0,-0.967741935483871,227,103
22401096,1,94,-2.0,-1.2765957446808511,94,0
22401096,2,236,-1.0,-0.2542372881355932,720,484
22401096,2,48,0.0,0.0,464,416
22401096,2,27,-1.0,-2.2222222222222223,406,379
22401096,2,53,3.0,3.3962264150943398,379,326
22401096,2,23,0.0,0.0,314,291
22401096,2,102,1.0,0.5882352941176471,273,171
22401096,2,60,1.0,1.0,171,111
22401096,2,99,-2.0,-1.2121212121212122,100,1
22401096,2,1,0.0,0.0,1,0
22401096,3,163,-6.0,-2.208588957055215,720,557
22401096,3,124,3.0,1.4516129032258065,557,433
22401096,3,55,3.0,3.2727272727272725,433,378
22401096,3,161,1.0,0.37267080745341613,364,203
22401096,3,196,3.0,0.9183673469387755,378,182
22401096,3,116,0.0,0.0,176,60
22401096,3,16,1.0,3.75,60,44
22401096,3,44,-1.0,-1.3636363636363638,44,0
22401096,4,234,-1.0,-0.25641025641025644,720,486
22401096,4,49,2.0,2.4489795918367343,475,426
22401096,4,29,0.0,0.0,411,382
22401096,4,40,-3.0,-4.5,382,342
22401096,4,84,0.0,0.0,321,237
22401096,4,9,0.0,0.0,223,214
22401096,4,178,-2.0,-0.6741573033707865,198,20
22401096,4,2,1.0,30.0,13,11
22401096,4,8,2.0,15.0,8,0
22401097,1,237,0.0,0.0,720,483
22401097,1,81,-4.0,-2.962962962962963,483,402
22401097,1,24,-3.0,-7.5,402,378
22401097,1,102,-1.0,-0.5882352941176471,378,276
22401097,1,31,2.0,3.870967741935484,272,241
22401097,1,46,-2.0,-2.608695652173913,241,195
22401097,1,25,0.0,0.0,186,161
22401097,1,115,3.0,1.5652173913043477,161,46
22401097,1,46,0.0,0.0,46,0
22401097,2,80,5.0,3.75,720,640
22401097,2,96,-4.0,-2.5,617,521
22401097,2,39,-4.0,-6.153846153846153,511,472
22401097,2,57,-2.0,-2.1052631578947367,460,403
22401097,2,47,2.0,2.5531914893617023,399,352
22401097,2,8,0.0,0.0,341,333
22401097,2,79,0.0,0.0,323,244
22401097,2,244,1.0,0.24590163934426232,244,0
22401097,3,192,-6.0,-1.875,720,528
22401097,3,150,-8.0,-3.2,519,369
22401097,3,46,0.0,0.0,361,315
22401097,3,7,1.0,8.571428571428571,304,297
22401097,3,10,0.0,0.0,297,287
22401097,3,95,0.0,0.0,287,192
22401097,3,43,-3.0,-4.186046511627907,192,149
22401097,3,149,3.0,1.2080536912751678,149,0
22401097,4,66,8.0,7.272727272727273,720,654
22401097,4,134,1.0,0.44776119402985076,640,506
22401097,4,68,-1.0,-0.8823529411764706,506,438
22401097,4,78,-6.0,-4.615384615384616,438,360
22401097,4,147,-2.0,-0.8163265306122449,282,135
22401097,4,28,0.0,0.0,135,107
22401097,4,38,1.0,1.5789473684210527,107,69
22401097,4,57,0.0,0.0,69,12
22401098,1,401,7.0,1.0473815461346632,720,319
22401098,1,22,1.0,2.7272727272727275,316,294
22401098,1,120,-7.0,-3.5,294,174
22401098,1,167,5.0,1.7964071856287425,167,0
22401098,2,208,4.0,1.153846153846154,720,512
22401098,2,53,0.0,0.0,512,459
22401098,2,40,0.0,0.0,436,396
22401098,2,150,-1.0,-0.4,374,224
22401098,2,224,3.0,0.8035714285714285,224,0
22401098,3,422,-8.0,-1.137440758293839,720,298
22401098,3,120,-1.0,-0.5,286,166
22401098,3,166,3.0,1.0843373493975903,166,0
22401098,4,157,3.0,1.1464968152866242,720,563
22401098,4,6,2.0,20.0,543,537
22401098,4,140,5.0,2.142857142857143,537,397
22401098,4,68,1.0,0.8823529411764706,384,316
22401098,4,138,-1.0,-0.43478260869565216,316,178
22401098,4,11,0.0,0.0,178,167
22401098,4,153,-5.0,-1.9607843137254903,153,0
22401099,1,318,-1.0,-0.18867924528301888,720,402
22401099,1,96,7.0,4.375,394,298
22401099,1,65,-4.0,-3.6923076923076925,281,216
22401099,1,156,8.0,3.0769230769230766,216,60
22401099,2,229,3.0,0.7860262008733624,720,491
22401099,2,125,-1.0,-0.48,482,357
22401099,2,19,0.0,0.0,357,338
22401099,2,78,1.0,0.7692307692307692,334,256
22401099,2,79,3.0,2.278481012658228,256,177
22401099,2,84,0.0,0.0,169,85
22401099,2,85,0.0,0.0,85,0
22401099,3,254,-2.0,-0.47244094488188976,720,466
22401099,3,121,4.0,1.9834710743801653,466,345
22401099,3,52,2.0,2.307692307692308,341,289
22401099,3,51,1.0,1.1764705882352942,280,229
22401099,4,116,4.0,2.0689655172413794,720,604
22401099,4,103,-3.0,-1.7475728155339807,584,481
22401099,4,36,-1.0,-1.6666666666666665,469,433
22401099,4,67,2.0,1.791044776119403,433,366
22401099,4,109,-1.0,-0.5504587155963303,348,239
22401099,4,25,2.0,4.8,230,205
22401099,4,40,1.0,1.5,198,158
22401099,4,13,0.0,0.0,158,145
22401099,4,135,-8.0,-3.555555555555556,135,0
22401100,1,200,4.0,1.2,720,520
22401100,1,124,-7.0,-3.3870967741935485,516,392
22401100,1,71,-3.0,-2.535211267605634,372,301
22401100,1,18,-3.0,-10.0,296,278
22401100,1,149,-3.0,-1.2080536912751678,263,114
22401100,1,16,-1.0,-3.75,114,98
22401100,1,50,2.0,2.4,98,48
22401100,1,48,-2.0,-2.5,48,0
22401100,2,74,4.0,3.2432432432432434,720,646
22401100,2,109,-1.0,-0.5504587155963303,638,529
22401100,2,46,2.0,2.608695652173913,523,477
22401100,2,36,0.0,0.0,477,441
22401100,2,21,0.0,0.0,431,410
22401100,2,1,0.0,0.0,399,398
22401100,2,116,-1.0,-0.5172413793103449,391,275
22401100,2,10,2.0,12.0,259,249
22401100,2,43,1.0,1.3953488372093024,249,206
22401100,2,204,-4.0,-1.1764705882352942,206,2
22401100,3,243,7.0,1.7283950617283952,720,477
22401100,3,61,5.0,4.918032786885245,472,411
22401100,3,56,-1.0,-1.0714285714285714,397,341
22401100,3,162,-6.0,-2.2222222222222223,341,179
22401100,3,18,-1.0,-3.333333333333333,156,138
22401100,3,65,2.0,1.8461538461538463,138,73
22401100,4,242,-4.0,-0.9917355371900827,720,478
22401100,4,89,2.0,1.348314606741573,476,387
22401100,4,139,3.0,1.2949640287769786,374,235
22401100,4,118,-3.0,-1.5254237288135595,233,115
22401100,4,44,-3.0,-4.090909090909091,115,71
22401100,4,40,0.0,0.0,61,21
22401100,4,16,-2.0,-7.5,16,0
22401101,1,243,7.0,1.7283950617283952,720,477
22401101,1,57,2.0,2.1052631578947367,462,405
22401101,1,21,0.0,0.0,395,374
22401101,1,85,-2.0,-1.4117647058823528,374,289
22401101,1,68,0.0,0.0,280,212
22401101,1,24,0.0,0.0,199,175
22401101,1,143,2.0,0.8391608391608392,150,7
22401101,1,2,0.0,0.0,2,0
22401101,2,100,-6.0,-3.5999999999999996,720,620
22401101,2,30,3.0,6.0,620,590
22401101,2,80,2.0,1.5,581,501
22401101,2,84,1.0,0.7142857142857142,494,410
22401101,2,25,-3.0,-7.199999999999999,396,371
22401101,2,62,-4.0,-3.870967741935484,366,304
22401101,2,127,-1.0,-0.47244094488188976,281,154
22401101,2,104,3.0,1.7307692307692308,150,46
22401101,2,33,-1.0,-1.8181818181818183,33,0
22401101,3,206,4.0,1.1650485436893203,720,514
22401101,3,70,3.0,2.5714285714285716,508,438
22401101,3,111,6.0,3.2432432432432434,426,315
22401101,3,50,-2.0,-2.4,302,252
22401101,3,104,3.0,1.7307692307692308,243,139
22401101,3,124,-5.0,-2.4193548387096775,127,3
22401101,4,89,0.0,0.0,720,631
22401101,4,104,2.0,1.153846153846154,618,514
22401101,4,49,-5.0,-6.122448979591837,514,465
22401101,4,106,2.0,1.1320754716981132,448,342
22401101,4,70,1.0,0.8571428571428571,335,265
22401101,4,27,-2.0,-4.444444444444445,265,238
22401101,4,16,-2.0,-7.5,222,206
22401101,4,153,-1.0,-0.39215686274509803,191,38
22401101,4,33,3.0,5.454545454545455,33,0
22401102,1,350,13.0,2.2285714285714286,720,370
22401102,1,52,-3.0,-3.4615384615384617,352,300
22401102,1,49,3.0,3.673469387755102,290,241
22401102,1,33,-3.0,-5.454545454545455,241,208
22401102,1,30,0.0,0.0,208,178
22401102,1,69,-3.0,-2.608695652173913,178,109
22401102,1,109,-5.0,-2.7522935779816518,109,0
22401102,2,252,-4.0,-0.9523809523809523,720,468
22401102,2,64,4.0,3.75,462,398
22401102,2,3,0.0,0.0,386,383
22401102,2,74,0.0,0.0,358,284
22401102,2,243,-4.0,-0.9876543209876544,284,41
22401102,2,30,0.0,0.0,33,3
22401102,2,3,0.0,0.0,3,0
22401102,3,431,-2.0,-0.27842227378190254,720,289
22401102,3,8,0.0,0.0,289,281
22401102,3,83,1.0,0.7228915662650602,277,194
22401102,3,67,-5.0,-4.477611940298507,149,82
22401102,3,64,0.0,0.0,82,18
22401102,3,1,0.0,0.0,1,0
22401102,4,96,7.0,4.375,720,624
22401102,4,18,0.0,0.0,609,591
22401102,4,216,3.0,0.8333333333333333,579,363
22401102,4,334,-8.0,-1.437125748502994,347,13
22401102,4,13,0.0,0.0,13,0
22401102,5,300,0.0,0.0,300,0
22401102,6,283,-3.0,-0.6360424028268552,300,17
22401102,6,13,-2.0,-9.230769230769232,13,0
22401103,1,318,-9.0,-1.6981132075471699,720,402
22401103,1,93,-2.0,-1.2903225806451615,391,298
22401103,1,148,2.0,0.8108108108108109,283,135
22401103,1,72,-3.0,-2.5,129,57
22401103,1,22,1.0,2.7272727272727275,50,28
22401103,1,28,0.0,0.0,28,0
22401103,2,187,-7.0,-2.245989304812834,720,533
22401103,2,95,1.0,0.631578947368421,522,427
22401103,2,69,-2.0,-1.7391304347826086,427,358
22401103,2,125,-3.0,-1.44,343,218
22401103,2,26,2.0,4.615384615384616,211,185
22401103,2,173,5.0,1.7341040462427746,173,0
22401103,3,395,10.0,1.5189873417721518,720,325
22401103,3,88,2.0,1.3636363636363638,317,229
22401103,3,115,-5.0,-2.608695652173913,223,108
22401103,4,99,5.0,3.0303030303030303,720,621
22401103,4,40,1.0,1.5,615,575
22401103,4,119,1.0,0.5042016806722689,566,447
22401103,4,10,0.0,0.0,429,419
22401103,4,7,0.0,0.0,419,412
22401103,4,16,0.0,0.0,404,388
22401103,4,38,2.0,3.1578947368421053,376,338
22401103,4,19,0.0,0.0,338,319
22401103,4,79,0.0,0.0,314,235
22401103,4,91,4.0,2.6373626373626378,222,131
22401103,4,17,-2.0,-7.0588235294117645,131,114
22401103,4,114,1.0,0.5263157894736842,114,0
22401104,1,364,4.0,0.6593406593406594,720,356
22401104,1,26,1.0,2.307692307692308,341,315
22401104,1,84,1.0,0.7142857142857142,315,231
22401104,1,93,1.0,0.6451612903225807,207,114
22401104,2,104,4.0,2.307692307692308,720,616
22401104,2,20,0.0,0.0,616,596
22401104,2,20,2.0,6.0,596,576
22401104,2,29,3.0,6.206896551724138,563,534
22401104,2,60,-5.0,-5.0,514,454
22401104,2,23,0.0,0.0,433,410
22401104,2,87,-4.0,-2.7586206896551726,403,316
22401104,2,28,2.0,4.285714285714286,316,288
22401104,2,52,-1.0,-1.153846153846154,288,236
22401104,2,236,4.0,1.0169491525423728,236,0
22401104,3,281,4.0,0.8540925266903914,720,439
22401104,3,27,0.0,0.0,434,407
22401104,3,27,-2.0,-4.444444444444445,400,373
22401104,3,25,0.0,0.0,354,329
22401104,3,22,-1.0,-2.7272727272727275,320,298
22401104,3,298,13.0,2.61744966442953,298,0
22401104,4,162,-6.0,-2.2222222222222223,720,558
22401104,4,46,-2.0,-2.608695652173913,547,501
22401104,4,44,1.0,1.3636363636363638,501,457
22401104,4,78,3.0,2.307692307692308,457,379
22401104,4,6,2.0,20.0,362,356
22401104,4,54,-4.0,-4.444444444444445,356,302
22401104,4,94,3.0,1.9148936170212765,292,198
22401104,4,68,0.0,0.0,178,110
22401104,4,8,0.0,0.0,96,88
22401104,4,80,1.0,0.75,80,0
22401105,1,389,-1.0,-0.15424164524421594,720,331
22401105,1,40,0.0,0.0,331,291
22401105,1,66,0.0,0.0,282,216
22401105,1,65,-1.0,-0.9230769230769231,201,136
22401105,1,223,-3.0,-0.8071748878923767,292,69
22401105,1,69,0.0,0.0,69,0
22401105,2,175,5.0,1.7142857142857142,720,545
22401105,2,107,1.0,0.5607476635514018,531,424
22401105,2,99,-1.0,-0.6060606060606061,424,325
22401105,2,23,-1.0,-2.608695652173913,310,287
22401105,2,122,8.0,3.934426229508197,287,165
22401105,2,145,-6.0,-2.4827586206896552,145,0
22401105,3,256,3.0,0.703125,720,464
22401105,3,113,3.0,1.592920353982301,451,338
22401105,3,68,1.0,0.8823529411764706,331,263
22401105,3,78,3.0,2.307692307692308,252,174
22401105,3,174,7.0,2.413793103448276,174,0
22401105,4,242,-2.0,-0.49586776859504134,720,478
22401105,4,19,0.0,0.0,478,459
22401105,4,123,-3.0,-1.4634146341463414,457,334
22401105,4,256,-7.0,-1.640625,311,55
22401105,4,55,3.0,3.2727272727272725,55,0
22401106,1,345,4.0,0.6956521739130435,720,375
22401106,1,24,-3.0,-7.5,361,337
22401106,1,59,2.0,2.0338983050847457,326,267
22401106,1,111,-7.0,-3.7837837837837833,267,156
22401106,1,140,1.0,0.42857142857142855,140,0
22401106,2,169,-1.0,-0.35502958579881655,720,551
22401106,2,37,-2.0,-3.2432432432432434,538,501
22401106,2,41,0.0,0.0,492,451
22401106,2,100,-2.0,-1.2,442,342
22401106,2,50,0.0,0.0,334,284
22401106,2,46,3.0,3.9130434782608696,262,216
22401106,2,98,-2.0,-1.2244897959183672,209,111
22401106,2,31,0.0,0.0,110,79
22401106,2,24,3.0,7.5,62,38
22401106,2,38,-5.0,-7.894736842105263,38,0
22401106,3,182,-7.0,-2.307692307692308,720,538
22401106,3,45,0.0,0.0,529,484
22401106,3,101,4.0,2.376237623762376,475,374
22401106,3,22,3.0,8.181818181818182,361,339
22401106,3,134,3.0,1.3432835820895521,319,185
22401106,3,62,-3.0,-2.903225806451613,185,123
22401106,3,46,1.0,1.3043478260869565,113,67
22401106,3,67,0.0,0.0,67,0
22401106,4,121,5.0,2.479338842975207,720,599
22401106,4,166,-3.0,-1.0843373493975903,599,433
22401106,4,49,-5.0,-6.122448979591837,351,302
22401106,4,193,-3.0,-0.9326424870466321,293,100
22401106,4,94,-3.0,-1.9148936170212765,94,0
22401107,1,288,1.0,0.20833333333333331,720,432
22401107,1,91,-6.0,-3.956043956043956,432,341
22401107,1,37,2.0,3.2432432432432434,339,302
22401107,1,54,-1.0,-1.1111111111111112,279,225
22401107,1,53,0.0,0.0,209,156
22401107,1,13,0.0,0.0,152,139
22401107,1,51,4.0,4.705882352941177,128,77
22401107,1,69,0.0,0.0,69,0
22401107,2,174,5.0,1.7241379310344827,720,546
22401107,2,18,2.0,6.666666666666666,535,517
22401107,2,65,-3.0,-2.769230769230769,517,452
22401107,2,39,2.0,3.0769230769230766,452,413
22401107,2,124,-1.0,-0.4838709677419355,407,283
22401107,2,10,0.0,0.0,275,265
22401107,2,94,6.0,3.829787234042553,260,166
22401107,2,134,4.0,1.791044776119403,166,32
22401107,2,32,0.0,0.0,32,0
22401107,3,290,6.0,1.2413793103448276,720,430
22401107,3,70,0.0,0.0,420,350
22401107,3,61,1.0,0.9836065573770493,338,277
22401107,3,51,-1.0,-1.1764705882352942,266,215
22401107,3,39,0.0,0.0,202,163
22401107,3,87,1.0,0.6896551724137931,163,76
22401107,3,76,-1.0,-0.7894736842105263,76,0
22401107,4,181,-1.0,-0.3314917127071823,720,539
22401107,4,128,11.0,5.15625,525,397
22401107,4,119,-1.0,-0.5042016806722689,397,278
22401107,4,278,4.0,0.8633093525179857,278,0
22401108,1,331,11.0,1.9939577039274925,720,389
22401108,1,49,5.0,6.122448979591837,381,332
22401108,1,20,-1.0,-3.0,321,301
22401108,1,11,1.0,5.454545454545455,301,290
22401108,1,66,-4.0,-3.6363636363636367,290,224
22401108,1,85,6.0,4.235294117647059,224,139
22401108,1,91,0.0,0.0,120,29
22401108,1,21,0.0,0.0,29,8
22401108,1,1,0.0,0.0,1,0
22401108,2,49,1.0,1.2244897959183672,720,671
22401108,2,86,-3.0,-2.0930232558139537,655,569
22401108,2,52,-1.0,-1.153846153846154,552,500
22401108,2,94,2.0,1.2765957446808511,500,406
22401108,2,92,-2.0,-1.3043478260869565,390,298
22401108,2,202,-1.0,-0.297029702970297,293,91
22401108,2,82,-5.0,-3.6585365853658534,82,0
22401108,3,313,8.0,1.5335463258785942,720,407
22401108,3,110,-3.0,-1.6363636363636362,405,295
22401108,3,29,0.0,0.0,295,266
22401108,3,44,-3.0,-4.090909090909091,266,222
22401108,3,59,-2.0,-2.0338983050847457,210,151
22401108,3,24,2.0,5.0,144,120
22401108,3,120,3.0,1.5,120,0
22401108,4,92,-3.0,-1.9565217391304348,720,628
22401108,4,72,-1.0,-0.8333333333333333,621,549
22401108,4,78,-5.0,-3.846153846153846,543,465
22401108,4,60,-2.0,-2.0,445,385
22401108,4,107,4.0,2.2429906542056073,385,278
22401108,4,68,-5.0,-4.411764705882353,278,210
22401108,4,183,11.0,3.6065573770491803,210,27
22401108,4,27,0.0,0.0,27,0
22401109,1,201,4.0,1.1940298507462686,720,519
22401109,1,154,-2.0,-0.7792207792207793,519,365
22401109,1,105,0.0,0.0,357,252
22401109,1,96,-2.0,-1.25,252,156
22401109,1,22,0.0,0.0,144,122
22401109,1,122,-3.0,-1.4754098360655736,122,0
22401109,2,80,1.0,0.75,720,640
22401109,2,36,-3.0,-5.0,640,604
22401109,2,49,-3.0,-3.673469387755102,604,555
22401109,2,108,2.0,1.1111111111111112,532,424
22401109,2,45,2.0,2.666666666666667,424,379
22401109,2,104,1.0,0.576923076923077,366,262
22401109,2,43,-2.0,-2.7906976744186047,248,205
22401109,2,54,0.0,0.0,199,145
22401109,2,25,3.0,7.199999999999999,145,120
22401109,2,120,0.0,0.0,120,0
22401109,3,268,-2.0,-0.44776119402985076,720,452
22401109,3,15,0.0,0.0,440,425
22401109,3,22,2.0,5.454545454545455,414,392
22401109,3,48,1.0,1.25,370,322
22401109,3,52,-1.0,-1.153846153846154,322,270
22401109,3,9,2.0,13.333333333333332,262,253
22401109,3,85,7.0,4.9411764705882355,238,153
22401109,3,57,1.0,1.0526315789473684,153,96
22401109,3,96,1.0,0.625,96,0
22401109,4,105,7.0,4.0,720,615
22401109,4,28,-2.0,-4.285714285714286,603,575
22401109,4,43,-2.0,-2.7906976744186047,575,532
22401109,4,1,0.0,0.0,519,518
22401109,4,35,-2.0,-3.4285714285714284,499,464
22401109,4,74,-4.0,-3.2432432432432434,451,377
22401109,4,77,0.0,0.0,364,287
22401109,4,9,0.0,0.0,276,267
22401109,4,150,-6.0,-2.4,256,106
22401109,4,58,0.0,0.0,82,24
22401109,4,14,0.0,0.0,21,7
22401109,4,1,0.0,0.0,1,0
22401110,1,447,-4.0,-0.5369127516778524,720,273
22401110,1,16,-3.0,-11.25,261,245
22401110,2,202,-3.0,-0.891089108910891,720,518
22401110,2,60,-5.0,-5.0,518,458
22401110,2,70,1.0,0.8571428571428571,448,378
22401110,2,99,2.0,1.2121212121212122,378,279
22401110,2,233,4.0,1.0300429184549356,265,32
22401110,2,32,0.0,0.0,32,0
22401110,3,347,6.0,1.037463976945245,720,373
22401110,3,40,-3.0,-4.5,373,333
22401110,3,56,4.0,4.285714285714286,322,266
22401110,3,42,0.0,0.0,257,215
22401110,3,69,2.0,1.7391304347826086,205,136
22401110,3,122,4.0,1.9672131147540985,122,0
22401110,4,90,5.0,3.333333333333333,720,630
22401110,4,117,-4.0,-2.0512820512820515,614,497
22401110,4,264,-1.0,-0.2272727272727273,704,440
22401110,4,17,0.0,0.0,431,414
22401110,4,70,4.0,3.4285714285714284,394,324
22401110,4,60,-2.0,-2.0,306,246
22401110,4,1,0.0,0.0,244,243
22401110,4,36,2.0,3.333333333333333,227,191
22401110,4,126,-3.0,-1.4285714285714284,175,49
22401111,1,464,4.0,0.5172413793103449,720,256
22401111,1,36,0.0,0.0,241,205
22401111,1,14,0.0,0.0,194,180
22401111,1,158,-2.0,-0.7594936708860759,158,0
22401111,2,173,3.0,1.0404624277456647,720,547
22401111,2,72,0.0,0.0,547,475
22401111,2,200,0.0,0.0,461,261
22401111,2,24,2.0,5.0,261,237
22401111,2,221,-3.0,-0.8144796380090498,221,0
22401111,3,461,-3.0,-0.39045553145336226,720,259
22401111,3,62,-2.0,-1.935483870967742,256,194
22401111,3,101,5.0,2.9702970297029703,178,77
22401111,3,77,-2.0,-1.5584415584415585,77,0
22401111,4,230,-2.0,-0.5217391304347826,720,490
22401111,4,104,4.0,2.307692307692308,506,402
22401111,4,161,4.0,1.4906832298136645,402,241
22401111,4,53,1.0,1.1320754716981132,241,188
22401111,4,8,-2.0,-15.0,169,161
22401111,4,149,-2.0,-0.8053691275167785,149,0
22401112,1,483,-1.0,-0.12422360248447206,720,237
22401112,1,77,4.0,3.116883116883117,223,146
22401112,1,24,-1.0,-2.5,130,106
22401112,1,40,-7.0,-10.5,106,66
22401112,2,78,0.0,0.0,720,642
22401112,2,80,0.0,0.0,634,554
22401112,2,57,0.0,0.0,546,489
22401112,2,31,-4.0,-7.741935483870968,479,448
22401112,2,63,-6.0,-5.7142857142857135,430,367
22401112,2,44,0.0,0.0,203,159
22401112,2,7,1.0,8.571428571428571,159,152
22401112,2,56,0.0,0.0,152,96
22401112,2,80,-4.0,-3.0,80,0
22401112,3,61,2.0,1.9672131147540985,720,659
22401112,3,298,1.0,0.20134228187919462,647,349
22401112,3,48,3.0,3.75,338,290
22401112,3,63,0.0,0.0,290,227
22401112,3,66,0.0,0.0,227,161
22401112,3,64,0.0,0.0,161,97
22401112,3,97,1.0,0.6185567010309279,97,0
22401112,4,214,-6.0,-1.6822429906542056,720,506
22401112,4,211,-2.0,-0.5687203791469195,506,295
22401112,4,120,1.0,0.5,282,162
22401112,4,144,1.0,0.41666666666666663,144,0
22401113,1,330,-7.0,-1.2727272727272727,720,390
22401113,1,35,1.0,1.7142857142857142,390,355
22401113,1,45,-1.0,-1.3333333333333335,337,292
22401113,1,82,-3.0,-2.195121951219512,292,210
22401113,1,40,0.0,0.0,194,154
22401113,1,101,5.0,2.9702970297029703,145,44
22401113,1,34,2.0,3.5294117647058822,34,0
22401113,2,155,3.0,1.1612903225806452,720,565
22401113,2,11,0.0,0.0,542,531
22401113,2,12,-4.0,-20.0,518,506
22401113,2,95,0.0,0.0,506,411
22401113,2,107,-2.0,-1.1214953271028036,397,290
22401113,2,41,0.0,0.0,290,249
22401113,2,13,-3.0,-13.846153846153847,238,225
22401113,2,100,-2.0,-1.2,215,115
22401113,2,78,-3.0,-2.307692307692308,115,37
22401113,2,33,0.0,0.0,33,0
22401113,3,357,2.0,0.33613445378151263,720,363
22401113,3,20,2.0,6.0,348,328
22401113,3,152,1.0,0.39473684210526316,315,163
22401113,3,151,-1.0,-0.3973509933774834,151,0
22401113,4,113,3.0,1.592920353982301,720,607
22401113,4,86,-6.0,-4.186046511627907,607,521
22401113,4,41,0.0,0.0,511,470
22401113,4,56,-1.0,-1.0714285714285714,449,393
22401113,4,3,-2.0,-40.0,387,384
22401113,4,354,2.0,0.3389830508474576,445,91
22401113,4,84,2.0,1.4285714285714284,84,0
22401114,1,271,2.0,0.44280442804428044,720,449
22401114,1,19,0.0,0.0,434,415
22401114,1,59,-2.0,-2.0338983050847457,390,331
22401114,1,76,-2.0,-1.5789473684210527,315,239
22401114,1,50,3.0,3.5999999999999996,221,171
22401114,1,58,0.0,0.0,157,99
22401114,1,7,1.0,8.571428571428571,99,92
22401114,1,46,3.0,3.9130434782608696,85,39
22401114,1,24,0.0,0.0,24,0
22401114,2,172,-1.0,-0.3488372093023256,720,548
22401114,2,72,-1.0,-0.8333333333333333,548,476
22401114,2,37,2.0,3.2432432432432434,469,432
22401114,2,196,-7.0,-2.142857142857143,432,236
22401114,2,45,2.0,2.666666666666667,219,174
22401114,2,55,4.0,4.363636363636363,164,109
22401114,2,96,2.0,1.25,107,11
22401114,2,11,0.0,0.0,11,0
22401114,3,296,-6.0,-1.2162162162162162,720,424
22401114,3,18,-3.0,-10.0,411,393
22401114,3,53,3.0,3.3962264150943398,374,321
22401114,3,72,0.0,0.0,304,232
22401114,3,56,4.0,4.285714285714286,220,164
22401114,3,71,-3.0,-2.535211267605634,164,93
22401114,3,90,5.0,3.333333333333333,93,3
22401114,3,3,-1.0,-20.0,3,0
22401114,4,190,-3.0,-0.9473684210526316,720,530
22401114,4,51,-1.0,-1.1764705882352942,520,469
22401114,4,25,1.0,2.4,445,420
22401114,4,93,-1.0,-0.6451612903225807,420,327
22401114,4,64,-2.0,-1.875,333,269
22401114,4,237,2.0,0.5063291139240506,250,13
22401115,1,336,6.0,1.0714285714285714,720,384
22401115,1,21,1.0,2.8571428571428568,384,363
22401115,1,79,-5.0,-3.79746835443038,363,284
22401115,1,8,0.0,0.0,278,270
22401115,1,48,2.0,2.5,252,204
22401115,1,19,0.0,0.0,204,185
22401115,1,32,2.0,3.75,174,142
22401115,1,120,1.0,0.5,120,0
22401115,2,81,-5.0,-3.7037037037037033,720,639
22401115,2,22,-2.0,-5.454545454545455,624,602
22401115,2,62,-3.0,-2.903225806451613,586,524
22401115,2,74,-2.0,-1.6216216216216217,511,437
22401115,2,33,2.0,3.6363636363636367,416,383
22401115,2,12,2.0,10.0,383,371
22401115,2,122,-1.0,-0.49180327868852464,371,249
22401115,2,47,-2.0,-2.5531914893617023,249,202
22401115,2,3,2.0,40.0,200,197
22401115,2,197,0.0,0.0,197,0
22401115,3,110,0.0,0.0,720,610
22401115,3,120,-5.0,-2.5,608,488
22401115,3,56,-1.0,-1.0714285714285714,471,415
22401115,3,35,2.0,3.4285714285714284,415,380
22401115,3,102,4.0,2.3529411764705883,375,273
22401115,3,138,3.0,1.3043478260869565,273,135
22401115,3,20,-2.0,-6.0,135,115
22401115,3,53,-4.0,-4.528301886792453,115,62
22401115,3,62,-3.0,-2.903225806451613,62,0
22401115,4,111,4.0,2.1621621621621623,720,609
22401115,4,29,0.0,0.0,609,580
22401115,4,171,-5.0,-1.7543859649122806,573,402
22401115,4,52,-3.0,-3.4615384615384617,389,337
22401115,4,139,3.0,1.2949640287769786,317,178
22401115,4,113,-4.0,-2.1238938053097343,178,65
22401115,4,46,2.0,2.608695652173913,46,0
22401116,1,306,6.0,1.1764705882352942,720,414
22401116,1,9,0.0,0.0,399,390
22401116,1,60,2.0,2.0,381,321
22401116,1,55,-3.0,-3.2727272727272725,314,259
22401116,1,80,3.0,2.25,257,177
22401116,1,122,-1.0,-0.49180327868852464,177,55
22401116,1,37,-3.0,-4.864864864864865,37,0
22401116,2,84,2.0,1.4285714285714284,720,636
22401116,2,100,-4.0,-2.4,636,536
22401116,2,65,0.0,0.0,519,454
22401116,2,74,-2.0,-1.6216216216216217,432,358
22401116,2,64,2.0,1.875,358,294
22401116,2,43,2.0,2.7906976744186047,277,234
22401116,2,69,4.0,3.4782608695652173,217,148
22401116,2,94,0.0,0.0,131,37
22401116,2,26,0.0,0.0,26,0
22401116,3,295,-1.0,-0.20338983050847456,720,425
22401116,3,178,-3.0,-1.0112359550561798,422,244
22401116,3,133,-3.0,-1.3533834586466165,230,97
22401116,3,78,-3.0,-2.307692307692308,78,0
22401116,4,267,-2.0,-0.449438202247191,720,453
22401116,4,121,0.0,0.0,439,318
22401116,4,117,-6.0,-3.0769230769230766,310,193
22401116,4,192,6.0,1.875,192,0
22401117,1,258,2.0,0.46511627906976744,720,462
22401117,1,29,0.0,0.0,450,421
22401117,1,90,-1.0,-0.6666666666666667,397,307
22401117,1,38,-3.0,-4.7368421052631575,283,245
22401117,1,66,1.0,0.9090909090909092,245,179
22401117,1,9,0.0,0.0,171,162
22401117,1,33,0.0,0.0,154,121
22401117,1,102,-1.0,-0.5882352941176471,121,19
22401117,1,19,0.0,0.0,19,0
22401117,2,238,0.0,0.0,720,482
22401117,2,37,-2.0,-3.2432432432432434,456,419
22401117,2,51,-4.0,-4.705882352941177,419,368
22401117,2,103,3.0,1.7475728155339807,368,265
22401117,2,41,1.0,1.4634146341463414,265,224
22401117,2,62,-2.0,-1.935483870967742,215,153
22401117,2,59,-1.0,-1.0169491525423728,142,83
22401117,2,27,0.0,0.0,66,39
22401117,2,10,1.0,6.0,39,29
22401117,2,29,-1.0,-2.0689655172413794,29,0
22401117,3,244,2.0,0.49180327868852464,720,476
22401117,3,74,1.0,0.8108108108108109,476,402
22401117,3,64,2.0,1.875,388,324
22401117,3,27,0.0,0.0,316,289
22401117,3,36,2.0,3.333333333333333,285,249
22401117,3,32,0.0,0.0,236,204
22401117,3,37,-2.0,-3.2432432432432434,199,162
22401117,3,93,2.0,1.2903225806451615,162,69
22401117,3,53,0.0,0.0,53,0
22401117,4,143,-3.0,-1.2587412587412588,720,577
22401117,4,38,-1.0,-1.5789473684210527,565,527
22401117,4,58,1.0,1.0344827586206897,527,469
22401117,4,43,-3.0,-4.186046511627907,454,411
22401117,4,89,6.0,4.044943820224719,411,322
22401117,4,99,0.0,0.0,309,210
22401117,4,200,2.0,0.6,200,0
22401118,1,306,4.0,0.7843137254901961,720,414
22401118,1,34,-1.0,-1.7647058823529411,414,380
22401118,1,52,-2.0,-2.307692307692308,380,328
22401118,1,26,0.0,0.0,328,302
22401118,1,110,-1.0,-0.5454545454545454,293,183
22401118,1,28,1.0,2.142857142857143,161,133
22401118,1,28,-1.0,-2.142857142857143,133,105
22401118,1,105,-4.0,-2.285714285714286,105,0
22401118,2,158,-4.0,-1.5189873417721518,720,562
22401118,2,19,3.0,9.473684210526315,562,543
22401118,2,23,0.0,0.0,533,510
22401118,2,28,-4.0,-8.571428571428571,500,472
22401118,2,7,-1.0,-8.571428571428571,448,441
22401118,2,71,-3.0,-2.535211267605634,441,370
22401118,2,97,1.0,0.6185567010309279,370,273
22401118,2,95,-1.0,-0.631578947368421,273,178
22401118,2,36,-1.0,-1.6666666666666665,178,142
22401118,2,53,1.0,1.1320754716981132,142,89
22401118,2,46,-2.0,-2.608695652173913,89,43
22401118,2,29,-1.0,-2.0689655172413794,29,0
22401118,3,266,-4.0,-0.9022556390977443,720,454
22401118,3,123,2.0,0.9756097560975611,438,315
22401118,3,15,0.0,0.0,315,300
22401118,3,38,1.0,1.5789473684210527,285,247
22401118,3,42,2.0,2.8571428571428568,222,180
22401118,3,41,0.0,0.0,177,136
22401118,3,32,-1.0,-1.875,136,104
22401118,3,98,-3.0,-1.836734693877551,98,0
22401118,4,34,0.0,0.0,720,686
22401118,4,252,-1.0,-0.23809523809523808,686,434
22401118,4,46,0.0,0.0,421,375
22401118,4,85,0.0,0.0,363,278
22401118,4,120,-1.0,-0.5,249,129
22401118,4,118,5.0,2.542372881355932,118,0
22401119,1,311,1.0,0.19292604501607716,720,409
22401119,1,186,-3.0,-0.967741935483871,403,217
22401119,1,36,0.0,0.0,217,181
22401119,1,27,0.0,0.0,172,145
22401119,1,136,-1.0,-0.4411764705882353,145,9
22401119,1,9,0.0,0.0,9,0
22401119,2,127,-1.0,-0.47244094488188976,720,593
22401119,2,4,0.0,0.0,588,584
22401119,2,69,-1.0,-0.8695652173913043,564,495
22401119,2,111,6.0,3.2432432432432434,495,384
22401119,2,139,-3.0,-1.2949640287769786,370,231
22401119,2,112,5.0,2.678571428571429,231,119
22401119,2,61,1.0,0.9836065573770493,113,52
22401119,3,194,5.0,1.5463917525773194,720,526
22401119,3,122,1.0,0.49180327868852464,526,404
22401119,3,104,-5.0,-2.8846153846153846,388,284
22401119,3,39,2.0,3.0769230769230766,284,245
22401119,3,64,0.0,0.0,245,181
22401119,3,173,5.0,1.7341040462427746,181,8
22401119,3,1,0.0,0.0,1,0
22401119,4,104,6.0,3.4615384615384617,720,616
22401119,4,26,1.0,2.307692307692308,616,590
22401119,4,87,2.0,1.3793103448275863,590,503
22401119,4,21,-1.0,-2.8571428571428568,503,482
22401119,4,16,1.0,3.75,482,466
22401119,4,96,2.0,1.25,466,370
22401119,4,68,0.0,0.0,368,300
22401119,4,60,2.0,2.0,283,223
22401119,4,10,-1.0,-6.0,223,213
22401119,4,42,-2.0,-2.8571428571428568,213,171
22401119,4,40,2.0,3.0,155,115
22401119,4,106,9.0,5.094339622641509,106,0
22401120,1,373,6.0,0.9651474530831099,720,347
22401120,1,66,1.0,0.9090909090909092,324,258
22401120,1,69,-5.0,-4.3478260869565215,243,174
22401120,1,163,8.0,2.9447852760736195,163,0
22401120,2,177,5.0,1.694915254237288,720,543
22401120,2,73,5.0,4.10958904109589,543,470
22401120,2,45,-3.0,-4.0,452,407
22401120,2,4,0.0,0.0,407,403
22401120,2,83,-3.0,-2.1686746987951806,399,316
22401120,2,108,-1.0,-0.5555555555555556,300,192
22401120,2,184,-3.0,-0.9782608695652174,192,8
22401120,3,280,5.0,1.0714285714285714,720,440
22401120,3,154,1.0,0.38961038961038963,427,273
22401120,3,67,2.0,1.791044776119403,271,204
22401120,3,198,-6.0,-1.8181818181818183,198,0
22401120,4,28,0.0,0.0,720,692
22401120,4,181,2.0,0.6629834254143646,692,511
22401120,4,147,-1.0,-0.40816326530612246,489,342
22401120,4,108,-3.0,-1.6666666666666665,328,220
22401120,4,95,3.0,1.8947368421052633,208,113
22401120,4,103,-1.0,-0.5825242718446602,103,0
22401121,1,348,0.0,0.0,720,372
22401121,1,44,-6.0,-8.181818181818182,372,328
22401121,1,57,-2.0,-2.1052631578947367,318,261
22401121,1,8,0.0,0.0,261,253
22401121,1,33,2.0,3.6363636363636367,242,209
22401121,1,15,1.0,4.0,200,185
22401121,1,97,-3.0,-1.8556701030927836,185,88
22401121,1,22,0.0,0.0,88,66
22401121,1,66,3.0,2.7272727272727275,66,0
22401121,2,279,-6.0,-1.2903225806451615,720,441
22401121,2,10,0.0,0.0,441,431
22401121,2,88,3.0,2.0454545454545454,431,343
22401121,2,25,2.0,4.8,317,292
22401121,2,41,-2.0,-2.926829268292683,282,241
22401121,2,93,0.0,0.0,241,148
22401121,2,148,-5.0,-2.027027027027027,148,0
22401121,3,151,-9.0,-3.576158940397351,720,569
22401121,3,183,-1.0,-0.32786885245901637,569,386
22401121,3,69,9.0,7.826086956521739,386,317
22401121,3,177,2.0,0.6779661016949152,307,130
22401121,3,43,-3.0,-4.186046511627907,117,74
22401121,3,59,-3.0,-3.050847457627119,59,0
22401121,4,122,5.0,2.4590163934426226,720,598
22401121,4,55,1.0,1.0909090909090908,598,543
22401121,4,82,2.0,1.4634146341463414,543,461
22401121,4,178,-2.0,-0.6741573033707865,437,259
22401121,4,43,2.0,2.7906976744186047,247,204
22401121,4,127,-3.0,-1.4173228346456692,204,77
22401121,4,77,-2.0,-1.5584415584415585,77,0
22401122,1,287,-1.0,-0.20905923344947736,720,433
22401122,1,88,2.0,1.3636363636363638,418,330
22401122,1,86,-2.0,-1.3953488372093024,330,244
22401122,1,110,-2.0,-1.0909090909090908,244,134
22401122,1,35,-4.0,-6.857142857142857,129,94
22401122,1,77,-1.0,-0.7792207792207793,77,0
22401122,2,195,5.0,1.5384615384615383,720,525
22401122,2,14,1.0,4.285714285714286,511,497
22401122,2,68,-2.0,-1.7647058823529411,497,429
22401122,2,3,-2.0,-40.0,412,409
22401122,2,214,2.0,0.5607476635514018,397,183
22401122,2,24,-3.0,-7.5,171,147
22401122,2,68,3.0,2.647058823529412,133,65
22401122,2,65,-1.0,-0.9230769230769231,65,0
22401122,3,209,5.0,1.4354066985645932,720,511
22401122,3,129,-2.0,-0.9302325581395349,504,375
22401122,3,17,0.0,0.0,375,358
22401122,3,81,0.0,0.0,358,277
22401122,3,51,1.0,1.1764705882352942,277,226
22401122,3,24,1.0,2.5,226,202
22401122,3,52,2.0,2.307692307692308,202,150
22401122,3,128,1.0,0.46875,128,0
22401122,4,37,0.0,0.0,720,683
22401122,4,99,5.0,3.0303030303030303,678,579
22401122,4,163,-1.0,-0.36809815950920244,558,395
22401122,4,82,-4.0,-2.926829268292683,386,304
22401122,4,124,-2.0,-0.967741935483871,304,180
22401122,4,165,3.0,1.0909090909090908,165,0
22401123,1,311,6.0,1.157556270096463,720,409
22401123,1,43,0.0,0.0,401,358
22401123,1,34,0.0,0.0,353,319
22401123,1,70,-2.0,-1.7142857142857142,307,237
22401123,1,58,2.0,2.0689655172413794,230,172
22401123,1,145,3.0,1.2413793103448276,160,15
22401123,2,237,2.0,0.5063291139240506,720,483
22401123,2,132,6.0,2.7272727272727275,481,349
22401123,2,12,0.0,0.0,325,313
22401123,2,148,3.0,1.2162162162162162,304,156
22401123,2,57,5.0,5.263157894736842,145,88
22401123,2,23,-1.0,-2.608695652173913,79,56
22401123,2,56,-4.0,-4.285714285714286,56,0
22401123,3,230,-3.0,-0.7826086956521738,720,490
22401123,3,104,-3.0,-1.7307692307692308,476,372
22401123,3,53,1.0,1.1320754716981132,360,307
22401123,3,78,3.0,2.307692307692308,289,211
22401123,3,28,2.0,4.285714285714286,201,173
22401123,3,93,-5.0,-3.2258064516129035,156,63
22401123,3,63,-3.0,-2.8571428571428568,63,0
22401123,4,160,-1.0,-0.375,720,560
22401123,4,100,0.0,0.0,560,460
22401123,4,65,2.0,1.8461538461538463,447,382
22401123,4,185,2.0,0.6486486486486487,382,197
22401123,4,42,1.0,1.4285714285714284,189,147
22401123,4,81,-1.0,-0.7407407407407407,134,53
22401123,4,1,0.0,0.0,53,52
22401123,4,41,0.0,0.0,41,0
22401124,1,327,-2.0,-0.3669724770642202,720,393
22401124,1,165,0.0,0.0,387,222
22401124,1,99,-7.0,-4.242424242424242,210,111
22401124,1,95,-1.0,-0.631578947368421,96,1
22401124,2,133,-3.0,-1.3533834586466165,720,587
22401124,2,41,-1.0,-1.4634146341463414,587,546
22401124,2,114,2.0,1.0526315789473684,546,432
22401124,2,16,-4.0,-15.0,420,404
22401124,2,76,-3.0,-2.3684210526315788,380,304
22401124,2,114,-2.0,-1.0526315789473684,291,177
22401124,2,163,3.0,1.1042944785276074,163,0
22401124,3,281,3.0,0.6405693950177936,720,439
22401124,3,58,4.0,4.137931034482759,425,367
22401124,3,60,-2.0,-2.0,361,301
22401124,3,128,3.0,1.40625,285,157
22401124,3,37,1.0,1.6216216216216217,157,120
22401124,3,111,1.0,0.5405405405405406,120,9
22401124,3,9,0.0,0.0,9,0
22401124,4,65,-6.0,-5.538461538461538,720,655
22401124,4,156,-1.0,-0.3846153846153846,644,488
22401124,4,110,5.0,2.7272727272727275,479,369
22401124,4,89,0.0,0.0,369,280
22401124,4,59,1.0,1.0169491525423728,265,206
22401124,4,206,12.0,3.4951456310679614,206,0
22401125,1,375,-6.0,-0.96,720,345
22401125,1,85,1.0,0.7058823529411764,345,260
22401125,1,113,-4.0,-2.1238938053097343,260,147
22401125,1,54,-6.0,-6.666666666666666,136,82
22401125,1,60,2.0,2.0,62,2
22401125,1,1,0.0,0.0,1,0
22401125,2,199,7.0,2.1105527638190953,720,521
22401125,2,169,2.0,0.7100591715976331,502,333
22401125,2,102,3.0,1.7647058823529411,316,214
22401125,2,39,-3.0,-4.615384615384616,206,167
22401125,2,138,3.0,1.3043478260869565,167,29
22401125,2,3,2.0,40.0,6,3
22401125,3,307,1.0,0.19543973941368079,720,413
22401125,3,99,-1.0,-0.6060606060606061,400,301
22401125,3,71,3.0,2.535211267605634,301,230
22401125,3,63,0.0,0.0,222,159
22401125,3,144,3.0,1.25,159,15
22401125,4,205,1.0,0.2926829268292683,720,515
22401125,4,106,2.0,1.1320754716981132,491,385
22401125,4,9,0.0,0.0,376,367
22401125,4,63,0.0,0.0,357,294
22401125,4,109,-1.0,-0.5504587155963303,270,161
22401125,4,96,-1.0,-0.625,150,54
22401125,4,37,0.0,0.0,37,0
22401126,1,348,0.0,0.0,720,372
22401126,1,15,0.0,0.0,358,343
22401126,1,21,0.0,0.0,327,306
22401126,1,47,0.0,0.0,300,253
22401126,1,57,-6.0,-6.315789473684211,249,192
22401126,1,43,-1.0,-1.3953488372093024,185,142
22401126,1,116,0.0,0.0,136,20
22401126,1,20,0.0,0.0,20,0
22401126,2,128,-1.0,-0.46875,720,592
22401126,2,58,3.0,3.103448275862069,592,534
22401126,2,54,4.0,4.444444444444445,525,471
22401126,2,67,2.0,1.791044776119403,456,389
22401126,2,65,3.0,2.769230769230769,375,310
22401126,2,99,1.0,0.6060606060606061,310,211
22401126,2,38,3.0,4.7368421052631575,193,155
22401126,2,35,3.0,5.142857142857143,155,120
22401126,2,86,1.0,0.6976744186046512,120,34
22401126,2,34,-2.0,-3.5294117647058822,34,0
22401126,3,212,-7.0,-1.9811320754716981,720,508
22401126,3,22,1.0,2.7272727272727275,492,470
22401126,3,140,-4.0,-1.7142857142857142,470,330
22401126,3,16,2.0,7.5,330,314
22401126,3,52,3.0,3.4615384615384617,314,262
22401126,3,26,0.0,0.0,240,214
22401126,3,14,1.0,4.285714285714286,214,200
22401126,3,10,0.0,0.0,200,190
22401126,3,121,-5.0,-2.479338842975207,174,53
22401126,3,35,1.0,1.7142857142857142,35,0
22401126,4,236,2.0,0.5084745762711864,720,484
22401126,4,40,-2.0,-3.0,458,418
22401126,4,174,5.0,1.7241379310344827,418,244
22401126,4,85,2.0,1.4117647058823528,239,154
22401126,4,15,2.0,8.0,135,120
22401126,4,7,0.0,0.0,120,113
22401126,4,106,-1.0,-0.5660377358490566,106,0
22401127,1,291,4.0,0.8247422680412371,720,429
22401127,1,40,0.0,0.0,417,377
22401127,1,59,1.0,1.0169491525423728,370,311
22401127,1,56,1.0,1.0714285714285714,311,255
22401127,1,183,4.0,1.3114754098360655,250,67
22401127,1,54,2.0,2.2222222222222223,54,0
22401127,2,104,3.0,1.7307692307692308,720,616
22401127,2,130,1.0,0.46153846153846156,600,470
22401127,2,82,7.0,5.121951219512195,460,378
22401127,2,127,-4.0,-1.889763779527559,367,240
22401127,2,49,2.0,2.4489795918367343,240,191
22401127,2,191,1.0,0.31413612565445026,191,0
22401127,3,224,0.0,0.0,720,496
22401127,3,17,0.0,0.0,486,469
22401127,3,130,-3.0,-1.3846153846153846,460,330
22401127,3,12,0.0,0.0,320,308
22401127,3,97,2.0,1.2371134020618557,303,206
22401127,3,9,0.0,0.0,197,188
22401127,3,48,0.0,0.0,180,132
22401127,3,20,0.0,0.0,123,103
22401127,3,92,-3.0,-1.9565217391304348,92,0
22401127,4,103,6.0,3.4951456310679614,720,617
22401127,4,73,5.0,4.10958904109589,607,534
22401127,4,34,2.0,3.5294117647058822,524,490
22401127,4,104,-2.0,-1.153846153846154,490,386
22401127,4,177,-7.0,-2.3728813559322037,386,209
22401127,4,61,-1.0,-0.9836065573770493,194,133
22401127,4,123,0.0,0.0,123,0
22401128,1,318,-7.0,-1.320754716981132,720,402
22401128,1,86,-6.0,-4.186046511627907,368,282
22401128,1,68,-1.0,-0.8823529411764706,267,199
22401128,1,12,0.0,0.0,187,175
22401128,1,1,0.0,0.0,160,159
22401128,1,125,6.0,2.88,153,28
22401128,2,73,-2.0,-1.643835616438356,720,647
22401128,2,77,0.0,0.0,647,570
22401128,2,65,0.0,0.0,560,495
22401128,2,26,3.0,6.923076923076923,485,459
22401128,2,49,1.0,1.2244897959183672,451,402
22401128,2,49,-3.0,-3.673469387755102,402,353
22401128,2,13,0.0,0.0,339,326
22401128,2,67,-7.0,-6.26865671641791,324,257
22401128,2,250,-3.0,-0.72,250,0
22401128,3,330,-7.0,-1.2727272727272727,720,390
22401128,3,196,3.0,0.9183673469387755,374,178
22401128,3,28,0.0,0.0,178,150
22401128,3,138,-2.0,-0.8695652173913043,138,0
22401128,4,356,1.0,0.16853932584269662,720,364
22401128,4,60,0.0,0.0,357,297
22401128,4,146,3.0,1.2328767123287672,290,144
22401128,4,26,2.0,4.615384615384616,119,93
22401128,4,78,0.0,0.0,78,0
22401129,1,239,-4.0,-1.00418410041841,720,481
22401129,1,99,0.0,0.0,467,368
22401129,1,40,0.0,0.0,357,317
22401129,1,135,-5.0,-2.2222222222222223,310,175
22401129,1,29,3.0,6.206896551724138,175,146
22401129,1,42,1.0,1.4285714285714284,146,104
22401129,1,104,1.0,0.576923076923077,104,0
22401129,2,134,0.0,0.0,720,586
22401129,2,21,0.0,0.0,574,553
22401129,2,111,-1.0,-0.5405405405405406,543,432
22401129,2,17,0.0,0.0,432,415
22401129,2,39,-2.0,-3.0769230769230766,415,376
22401129,2,63,8.0,7.619047619047619,361,298
22401129,2,133,6.0,2.706766917293233,286,153
22401129,2,35,-1.0,-1.7142857142857142,143,108
22401129,2,90,-1.0,-0.6666666666666667,108,18
22401129,2,3,0.0,0.0,18,15
22401129,3,223,-9.0,-2.42152466367713,720,497
22401129,3,42,0.0,0.0,497,455
22401129,3,119,-2.0,-1.0084033613445378,455,336
22401129,3,163,5.0,1.8404907975460123,318,155
22401129,3,36,0.0,0.0,148,112
22401129,3,112,3.0,1.607142857142857,112,0
22401129,4,152,-7.0,-2.763157894736842,720,568
22401129,4,146,0.0,0.0,552,406
22401129,4,85,-3.0,-2.1176470588235294,406,321
22401129,4,72,6.0,5.0,321,249
22401129,4,19,-2.0,-6.315789473684211,236,217
22401129,4,60,-1.0,-1.0,217,157
22401129,4,52,-2.0,-2.307692307692308,157,105
22401129,4,72,-4.0,-3.333333333333333,98,26
22401130,1,254,1.0,0.23622047244094488,720,466
22401130,1,83,-1.0,-0.7228915662650602,454,371
22401130,1,143,-4.0,-1.6783216783216783,355,212
22401130,1,97,0.0,0.0,195,98
22401130,1,83,0.0,0.0,83,0
22401130,2,210,-8.0,-2.285714285714286,720,510
22401130,2,21,0.0,0.0,510,489
22401130,2,25,0.0,0.0,480,455
22401130,2,32,2.0,3.75,446,414
22401130,2,79,-1.0,-0.7594936708860759,388,309
22401130,2,124,3.0,1.4516129032258065,309,185
22401130,2,71,1.0,0.8450704225352113,167,96
22401130,2,91,-1.0,-0.6593406593406594,91,0
22401130,3,295,3.0,0.6101694915254237,720,425
22401130,3,47,0.0,0.0,415,368
22401130,3,76,4.0,3.1578947368421053,357,281
22401130,3,3,0.0,0.0,265,262
22401130,3,10,0.0,0.0,262,252
22401130,3,63,0.0,0.0,247,184
22401130,3,23,-3.0,-7.826086956521739,184,161
22401130,3,161,1.0,0.37267080745341613,161,0
22401130,4,197,-5.0,-1.5228426395939085,720,523
22401130,4,79,0.0,0.0,507,428
22401130,4,54,-3.0,-3.333333333333333,420,366
22401130,4,261,8.0,1.839080459770115,366,105
22401130,4,98,-4.0,-2.4489795918367343,105,7
22401130,4,5,0.0,0.0,5,0
22401131,1,368,1.0,0.16304347826086957,720,352
22401131,1,150,3.0,1.2,352,202
22401131,1,33,-1.0,-1.8181818181818183,202,169
22401131,2,62,-3.0,-2.903225806451613,720,658
22401131,2,202,-4.0,-1.188118811881188,658,456
22401131,2,89,-5.0,-3.3707865168539324,456,367
22401131,2,73,-1.0,-0.821917808219178,367,294
22401131,2,88,3.0,2.0454545454545454,294,206
22401131,2,9,0.0,0.0,206,197
22401131,2,47,2.0,2.5531914893617023,197,150
22401131,2,38,0.0,0.0,133,95
22401131,2,77,-1.0,-0.7792207792207793,77,0
22401131,3,160,-2.0,-0.75,720,560
22401131,3,76,4.0,3.1578947368421053,560,484
22401131,3,199,4.0,1.206030150753769,470,271
22401131,3,23,2.0,5.217391304347826,268,245
22401131,3,125,3.0,1.44,232,107
22401131,3,20,2.0,6.0,103,83
22401131,3,71,-1.0,-0.8450704225352113,71,0
22401131,4,266,-6.0,-1.3533834586466165,720,454
22401131,4,117,0.0,0.0,454,337
22401131,4,1,0.0,0.0,274,273
22401131,4,259,-4.0,-0.9266409266409267,259,0
22401131,5,220,-4.0,-1.0909090909090908,300,80
22401131,5,56,-2.0,-2.142857142857143,66,10
22401131,5,5,-2.0,-24.0,9,4
22401132,1,214,2.0,0.5607476635514018,720,506
22401132,1,164,6.0,2.195121951219512,500,336
22401132,1,60,1.0,1.0,309,249
22401132,1,82,2.0,1.4634146341463414,249,167
22401132,1,146,-2.0,-0.821917808219178,146,0
22401132,2,213,1.0,0.28169014084507044,720,507
22401132,2,8,-2.0,-15.0,494,486
22401132,2,22,-2.0,-5.454545454545455,460,438
22401132,2,101,1.0,0.594059405940594,438,337
22401132,2,70,-1.0,-0.8571428571428571,337,267
22401132,2,80,-1.0,-0.75,267,187
22401132,2,127,-1.0,-0.47244094488188976,187,60
22401132,2,60,2.0,2.0,60,0
22401132,3,198,2.0,0.6060606060606061,720,522
22401132,3,28,0.0,0.0,522,494
22401132,3,132,0.0,0.0,489,357
22401132,3,71,7.0,5.915492957746478,342,271
22401132,3,93,1.0,0.6451612903225807,255,162
22401132,3,80,1.0,0.75,154,74
22401132,3,74,2.0,1.6216216216216217,74,0
22401132,4,147,7.0,2.8571428571428568,720,573
22401132,4,37,-1.0,-1.6216216216216217,564,527
22401132,4,99,3.0,1.8181818181818183,527,428
22401132,4,220,3.0,0.8181818181818181,406,186
22401132,4,69,-4.0,-3.4782608695652173,179,110
22401132,4,110,2.0,1.0909090909090908,110,0
22401133,1,254,5.0,1.1811023622047243,720,466
22401133,1,114,-8.0,-4.2105263157894735,448,334
22401133,1,33,-2.0,-3.6363636363636367,311,278
22401133,1,81,-2.0,-1.4814814814814814,263,182
22401133,1,37,1.0,1.6216216216216217,172,135
22401133,1,135,2.0,0.888888888888889,135,0
22401133,2,58,0.0,0.0,720,662
22401133,2,89,-1.0,-0.6741573033707865,662,573
22401133,2,147,-5.0,-2.0408163265306123,573,426
22401133,2,82,0.0,0.0,426,344
22401133,2,46,-2.0,-2.608695652173913,344,298
22401133,2,103,-8.0,-4.660194174757281,298,195
22401133,2,40,-2.0,-3.0,186,146
22401133,2,74,1.0,0.8108108108108109,146,72
22401133,2,59,-5.0,-5.084745762711864,59,0
22401133,3,206,6.0,1.7475728155339807,720,514
22401133,3,78,2.0,1.5384615384615383,503,425
22401133,3,23,-2.0,-5.217391304347826,409,386
22401133,3,164,-1.0,-0.36585365853658536,365,201
22401133,3,35,0.0,0.0,201,166
22401133,3,122,1.0,0.49180327868852464,140,18
22401133,3,18,0.0,0.0,18,0
22401133,4,109,0.0,0.0,720,611
22401133,4,33,0.0,0.0,592,559
22401133,4,82,-3.0,-2.195121951219512,559,477
22401133,4,53,-1.0,-1.1320754716981132,468,415
22401133,4,13,0.0,0.0,415,402
22401133,4,56,-1.0,-1.0714285714285714,396,340
22401133,4,170,-6.0,-2.1176470588235294,340,170
22401133,4,28,0.0,0.0,170,142
22401133,4,58,6.0,6.206896551724138,142,84
22401133,4,39,3.0,4.615384615384616,84,45
22401133,4,45,1.0,1.3333333333333335,45,0
22401134,1,334,-7.0,-1.2574850299401197,720,386
22401134,1,33,1.0,1.8181818181818183,386,353
22401134,1,65,4.0,3.6923076923076925,353,288
22401134,1,62,0.0,0.0,288,226
22401134,1,215,-8.0,-2.2325581395348837,215,0
22401134,2,201,0.0,0.0,720,519
22401134,2,40,3.0,4.5,514,474
22401134,2,61,1.0,0.9836065573770493,461,400
22401134,2,145,-5.0,-2.0689655172413794,389,244
22401134,2,81,-4.0,-2.962962962962963,238,157
22401134,2,144,-2.0,-0.8333333333333333,144,0
22401134,3,320,-5.0,-0.9375,720,400
22401134,3,82,4.0,2.926829268292683,400,318
22401134,3,20,0.0,0.0,311,291
22401134,3,55,5.0,5.454545454545455,282,227
22401134,3,211,3.0,0.8530805687203791,211,0
22401134,4,244,1.0,0.24590163934426232,720,476
22401134,4,93,0.0,0.0,459,366
22401134,4,30,-2.0,-4.0,349,319
22401134,4,71,-3.0,-2.535211267605634,298,227
22401134,4,227,4.0,1.0572687224669604,227,0
22401135,1,224,-1.0,-0.26785714285714285,720,496
22401135,1,79,-7.0,-5.3164556962025316,488,409
22401135,1,62,0.0,0.0,399,337
22401135,1,11,0.0,0.0,328,317
22401135,1,122,-2.0,-0.9836065573770493,304,182
22401135,1,73,-2.0,-1.643835616438356,176,103
22401135,1,103,-1.0,-0.5825242718446602,103,0
22401135,2,79,-6.0,-4.556962025316456,720,641
22401135,2,156,-1.0,-0.3846153846153846,641,485
22401135,2,52,5.0,5.769230769230769,479,427
22401135,2,21,0.0,0.0,407,386
22401135,2,12,0.0,0.0,377,365
22401135,2,100,-4.0,-2.4,366,266
22401135,2,78,-4.0,-3.0769230769230766,261,183
22401135,2,30,3.0,6.0,168,138
22401135,2,125,7.0,3.36,125,0
22401135,3,120,1.0,0.5,720,600
22401135,3,118,-2.0,-1.0169491525423728,590,472
22401135,3,78,-1.0,-0.7692307692307692,457,379
22401135,3,17,0.0,0.0,357,340
22401135,3,61,-2.0,-1.9672131147540985,335,274
22401135,3,136,0.0,0.0,274,138
22401135,3,128,0.0,0.0,128,0
22401135,4,97,1.0,0.6185567010309279,720,623
22401135,4,37,2.0,3.2432432432432434,623,586
22401135,4,113,-1.0,-0.5309734513274336,573,460
22401135,4,129,4.0,1.8604651162790697,336,207
22401135,4,62,-1.0,-0.967741935483871,198,136
22401135,4,131,-4.0,-1.83206106870229,131,0
22401136,1,287,7.0,1.4634146341463414,720,433
22401136,1,79,-1.0,-0.7594936708860759,430,351
22401136,1,31,-3.0,-5.806451612903226,337,306
22401136,1,29,1.0,2.0689655172413794,295,266
22401136,1,69,2.0,1.7391304347826086,263,194
22401136,2,181,-8.0,-2.6519337016574585,720,539
22401136,2,30,0.0,0.0,520,490
22401136,2,29,3.0,6.206896551724138,474,445
22401136,2,34,-2.0,-3.5294117647058822,433,399
22401136,2,26,2.0,4.615384615384616,399,373
22401136,2,132,7.0,3.181818181818182,368,236
22401136,2,109,-3.0,-1.651376146788991,236,127
22401136,2,75,2.0,1.6,115,40
22401136,3,276,-1.0,-0.21739130434782608,720,444
22401136,3,132,4.0,1.8181818181818183,422,290
22401136,3,73,-2.0,-1.643835616438356,290,217
22401136,3,121,0.0,0.0,217,96
22401136,3,41,-2.0,-2.926829268292683,96,55
22401136,3,13,1.0,4.615384615384616,55,42
22401136,3,42,-2.0,-2.8571428571428568,42,0
22401136,4,108,-1.0,-0.5555555555555556,720,612
22401136,4,77,2.0,1.5584415584415585,612,535
22401136,4,111,4.0,2.1621621621621623,535,424
22401136,4,23,1.0,2.608695652173913,424,401
22401136,4,186,-5.0,-1.6129032258064517,399,213
22401136,4,213,0.0,0.0,213,0
22401137,1,338,4.0,0.7100591715976331,720,382
22401137,1,52,1.0,1.153846153846154,382,330
22401137,1,64,1.0,0.9375,319,255
22401137,1,77,-1.0,-0.7792207792207793,241,164
22401137,1,17,0.0,0.0,26,9
22401137,1,1,0.0,0.0,1,0
22401137,2,224,5.0,1.3392857142857144,720,496
22401137,2,78,-1.0,-0.7692307692307692,472,394
22401137,2,59,0.0,0.0,372,313
22401137,2,96,-1.0,-0.625,309,213
22401137,2,183,2.0,0.6557377049180327,190,7
22401137,2,4,0.0,0.0,4,0
22401137,3,435,0.0,0.0,720,285
22401137,3,74,8.0,6.486486486486487,248,174
22401137,3,87,2.0,1.3793103448275863,159,72
22401137,3,72,-1.0,-0.8333333333333333,72,0
22401137,4,307,3.0,0.5863192182410423,720,413
22401137,4,158,-3.0,-1.139240506329114,399,241
22401137,4,86,3.0,2.0930232558139537,232,146
22401137,4,144,1.0,0.41666666666666663,144,0
22401138,1,297,4.0,0.8080808080808081,720,423
22401138,1,188,-3.0,-0.9574468085106382,412,224
22401138,1,66,-3.0,-2.7272727272727275,214,148
22401138,1,109,-1.0,-0.5504587155963303,135,26
22401138,2,190,2.0,0.631578947368421,720,530
22401138,2,17,-1.0,-3.5294117647058822,519,502
22401138,2,110,3.0,1.6363636363636362,502,392
22401138,2,61,5.0,4.918032786885245,382,321
22401138,2,200,3.0,0.8999999999999999,303,103
22401138,2,92,-6.0,-3.9130434782608696,92,0
22401138,3,126,5.0,2.380952380952381,720,594
22401138,3,160,0.0,0.0,577,417
22401138,3,13,0.0,0.0,401,388
22401138,3,119,-7.0,-3.5294117647058822,388,269
22401138,3,87,-3.0,-2.0689655172413794,269,182
22401138,4,80,7.0,5.25,720,640
22401138,4,122,2.0,0.9836065573770493,640,518
22401138,4,51,2.0,2.3529411764705883,518,467
22401138,4,101,-3.0,-1.782178217821782,467,366
22401138,4,64,0.0,0.0,351,287
22401138,4,263,-1.0,-0.22813688212927757,269,6
22401138,4,6,-2.0,-20.0,6,0
22401139,1,307,0.0,0.0,720,413
22401139,1,64,0.0,0.0,395,331
22401139,1,39,3.0,4.615384615384616,317,278
22401139,1,24,2.0,5.0,268,244
22401139,1,56,3.0,3.214285714285714,220,164
22401139,1,151,3.0,1.1920529801324504,159,8
22401139,2,45,2.0,2.666666666666667,720,675
22401139,2,40,-5.0,-7.5,665,625
22401139,2,125,3.0,1.44,612,487
22401139,2,42,-3.0,-4.285714285714286,463,421
22401139,2,128,-3.0,-1.40625,410,282
22401139,2,42,2.0,2.8571428571428568,258,216
22401139,2,123,-1.0,-0.48780487804878053,199,76
22401139,2,76,5.0,3.9473684210526314,76,0
22401139,3,332,0.0,0.0,720,388
22401139,3,26,0.0,0.0,364,338
22401139,3,77,-3.0,-2.3376623376623376,326,249
22401139,3,51,-2.0,-2.3529411764705883,249,198
22401139,3,7,0.0,0.0,177,170
22401139,3,101,5.0,2.9702970297029703,170,69
22401139,4,114,2.0,1.0526315789473684,720,606
22401139,4,37,1.0,1.6216216216216217,597,560
22401139,4,90,-1.0,-0.6666666666666667,560,470
22401139,4,49,-3.0,-3.673469387755102,467,418
22401139,4,103,-2.0,-1.1650485436893203,418,315
22401139,4,20,0.0,0.0,301,281
22401139,4,65,0.0,0.0,274,209
22401139,4,146,4.0,1.643835616438356,204,58
22401139,4,3,-1.0,-20.0,58,55
22401139,4,17,3.0,10.588235294117649,55,38
22401139,4,14,0.0,0.0,38,24
22401139,4,1,0.0,0.0,24,23
22401139,4,23,-1.0,-2.608695652173913,23,0
22401140,1,280,-1.0,-0.21428571428571427,720,440
22401140,1,46,-2.0,-2.608695652173913,437,391
22401140,1,50,3.0,3.5999999999999996,391,341
22401140,1,41,0.0,0.0,322,281
22401140,1,57,-3.0,-3.1578947368421053,265,208
22401140,1,24,3.0,7.5,208,184
22401140,1,56,-2.0,-2.142857142857143,172,116
22401140,1,116,5.0,2.586206896551724,116,0
22401140,2,100,0.0,0.0,720,620
22401140,2,52,2.0,2.307692307692308,620,568
22401140,2,31,3.0,5.806451612903226,568,537
22401140,2,151,2.0,0.7947019867549668,521,370
22401140,2,45,-2.0,-2.666666666666667,362,317
22401140,2,24,0.0,0.0,305,281
22401140,2,55,-1.0,-1.0909090909090908,267,212
22401140,2,89,-4.0,-2.696629213483146,212,123
22401140,2,116,1.0,0.5172413793103449,116,0
22401140,3,284,0.0,0.0,720,436
22401140,3,61,3.0,2.9508196721311473,433,372
22401140,3,176,1.0,0.34090909090909094,354,178
22401140,3,165,5.0,1.8181818181818183,165,0
22401140,4,173,-2.0,-0.6936416184971098,720,547
22401140,4,23,0.0,0.0,538,515
22401140,4,43,0.0,0.0,515,472
22401140,4,31,-2.0,-3.870967741935484,472,441
22401140,4,100,-4.0,-2.4,435,335
22401140,4,231,0.0,0.0,319,88
22401140,4,88,5.0,3.409090909090909,88,0
22401141,1,264,-12.0,-2.7272727272727275,720,456
22401141,1,66,0.0,0.0,434,368
22401141,1,93,2.0,1.2903225806451615,364,271
22401141,1,36,-2.0,-3.333333333333333,271,235
22401141,1,59,-6.0,-6.101694915254238,227,168
22401141,1,70,3.0,2.5714285714285716,147,77
22401141,1,64,4.0,3.75,64,0
22401141,2,163,-3.0,-1.1042944785276074,720,557
22401141,2,67,2.0,1.791044776119403,546,479
22401141,2,59,-4.0,-4.067796610169491,469,410
22401141,2,59,0.0,0.0,398,339
22401141,2,51,-3.0,-3.5294117647058822,339,288
22401141,2,71,-3.0,-2.535211267605634,272,201
22401141,2,18,0.0,0.0,186,168
22401141,2,63,-1.0,-0.9523809523809523,168,105
22401141,2,75,-5.0,-4.0,75,0
22401141,3,237,-3.0,-0.7594936708860759,720,483
22401141,3,72,0.0,0.0,473,401
22401141,3,105,-1.0,-0.5714285714285715,401,296
22401141,3,64,3.0,2.8125,288,224
22401141,3,207,9.0,2.608695652173913,207,0
22401141,4,177,3.0,1.0169491525423728,720,543
22401141,4,212,-3.0,-0.8490566037735849,543,331
22401141,4,151,0.0,0.0,435,284
22401141,4,16,0.0,0.0,272,256
22401141,4,42,-3.0,-4.285714285714286,121,79
22401142,1,327,1.0,0.1834862385321101,720,393
22401142,1,32,0.0,0.0,376,344
22401142,1,92,4.0,2.608695652173913,337,245
22401142,1,58,-1.0,-1.0344827586206897,225,167
22401142,1,18,2.0,6.666666666666666,159,141
22401142,1,45,0.0,0.0,129,84
22401142,1,66,-2.0,-1.8181818181818183,77,11
22401142,1,11,1.0,5.454545454545455,11,0
22401142,2,176,-3.0,-1.0227272727272727,720,544
22401142,2,71,-2.0,-1.6901408450704225,544,473
22401142,2,52,4.0,4.615384615384616,463,411
22401142,2,97,1.0,0.6185567010309279,395,298
22401142,2,82,-3.0,-2.195121951219512,298,216
22401142,2,189,0.0,0.0,199,10
22401142,2,6,2.0,20.0,6,0
22401142,3,411,0.0,0.0,720,309
22401142,3,43,0.0,0.0,289,246
22401142,3,26,-1.0,-2.307692307692308,238,212
22401142,3,208,-4.0,-1.153846153846154,212,4
22401142,3,1,0.0,0.0,1,0
22401142,4,182,-2.0,-0.6593406593406594,720,538
22401142,4,350,4.0,0.6857142857142857,516,166
22401142,4,123,-2.0,-0.9756097560975611,166,43
22401142,4,29,-1.0,-2.0689655172413794,43,14
22401143,1,319,4.0,0.7523510971786833,720,401
22401143,1,79,1.0,0.7594936708860759,381,302
22401143,1,54,1.0,1.1111111111111112,302,248
22401143,1,96,6.0,3.75,236,140
22401143,1,136,-3.0,-1.323529411764706,136,0
22401143,2,183,-3.0,-0.9836065573770493,720,537
22401143,2,76,-2.0,-1.5789473684210527,537,461
22401143,2,36,-2.0,-3.333333333333333,461,425
22401143,2,27,0.0,0.0,425,398
22401143,2,104,-2.0,-1.153846153846154,395,291
22401143,2,105,-5.0,-2.8571428571428568,282,177
22401143,2,105,2.0,1.142857142857143,167,62
22401143,2,2,0.0,0.0,62,60
22401143,2,6,-3.0,-30.0,60,54
22401143,2,27,0.0,0.0,54,27
22401143,2,9,1.0,6.666666666666666,9,0
22401143,3,123,-7.0,-3.4146341463414633,720,597
22401143,3,38,0.0,0.0,590,552
22401143,3,125,2.0,0.96,552,427
22401143,3,154,-4.0,-1.5584415584415585,427,273
22401143,3,80,2.0,1.5,267,187
22401143,3,90,-1.0,-0.6666666666666667,179,89
22401143,3,46,-2.0,-2.608695652173913,86,40
22401143,3,23,-2.0,-5.217391304347826,23,0
22401143,4,232,1.0,0.25862068965517243,720,488
22401143,4,72,-4.0,-3.333333333333333,462,390
22401143,4,149,-3.0,-1.2080536912751678,377,228
22401143,4,78,2.0,1.5384615384615383,205,127
22401143,4,25,-2.0,-4.8,127,102
22401143,4,18,-3.0,-10.0,85,67
22401144,1,229,-1.0,-0.26200873362445415,720,491
22401144,1,112,6.0,3.214285714285714,485,373
22401144,1,125,-1.0,-0.48,355,230
22401144,1,33,-1.0,-1.8181818181818183,141,108
22401144,1,86,-2.0,-1.3953488372093024,108,22
22401144,1,22,0.0,0.0,22,0
22401144,2,101,8.0,4.752475247524752,720,619
22401144,2,43,0.0,0.0,612,569
22401144,2,124,7.0,3.3870967741935485,569,445
22401144,2,39,2.0,3.0769230769230766,422,383
22401144,2,92,2.0,1.3043478260869565,383,291
22401144,2,76,0.0,0.0,280,204
22401144,2,24,-2.0,-5.0,204,180
22401144,3,246,-5.0,-1.2195121951219512,720,474
22401144,3,29,0.0,0.0,461,432
22401144,3,32,3.0,5.625,423,391
22401144,3,117,-3.0,-1.5384615384615383,375,258
22401144,3,72,3.0,2.5,258,186
22401144,3,37,-2.0,-3.2432432432432434,168,131
22401144,3,131,-6.0,-2.7480916030534353,131,0
22401144,4,164,1.0,0.36585365853658536,720,556
22401144,4,37,-2.0,-3.2432432432432434,556,519
22401144,4,29,0.0,0.0,508,479
22401144,4,63,2.0,1.9047619047619047,479,416
22401144,4,12,1.0,5.0,389,377
22401144,4,144,-2.0,-0.8333333333333333,377,233
22401144,4,233,-5.0,-1.2875536480686696,233,0
22401145,1,374,-1.0,-0.16042780748663102,720,346
22401145,1,65,7.0,6.461538461538462,337,272
22401145,1,51,-3.0,-3.5294117647058822,261,210
22401145,1,93,0.0,0.0,210,117
22401145,1,19,0.0,0.0,96,77
22401145,1,26,0.0,0.0,67,41
22401145,1,24,-2.0,-5.0,24,0
22401145,2,150,8.0,3.2,720,570
22401145,2,137,-1.0,-0.437956204379562,558,421
22401145,2,65,-1.0,-0.9230769230769231,421,356
22401145,2,16,1.0,3.75,356,340
22401145,2,100,4.0,2.4,340,240
22401145,2,75,3.0,2.4,240,165
22401145,2,92,0.0,0.0,165,73
22401145,2,52,-1.0,-1.153846153846154,52,0
22401145,3,328,-5.0,-0.9146341463414633,720,392
22401145,3,50,-4.0,-4.8,380,330
22401145,3,112,0.0,0.0,321,209
22401145,3,51,3.0,3.5294117647058822,205,154
22401145,3,31,0.0,0.0,154,123
22401145,3,96,-5.0,-3.125,123,27
22401145,4,220,0.0,0.0,720,500
22401145,4,31,3.0,5.806451612903226,492,461
22401145,4,90,3.0,2.0,438,348
22401145,4,86,5.0,3.488372093023256,348,262
22401145,4,38,0.0,0.0,239,201
22401145,4,143,5.0,2.097902097902098,191,48
22401145,4,36,-1.0,-1.6666666666666665,36,0
22401146,1,277,-7.0,-1.5162454873646207,720,443
22401146,1,27,-4.0,-8.88888888888889,429,402
22401146,1,126,-6.0,-2.8571428571428568,402,276
22401146,1,72,2.0,1.6666666666666665,264,192
22401146,1,64,3.0,2.8125,192,128
22401146,1,107,-2.0,-1.1214953271028036,107,0
22401146,2,173,-1.0,-0.3468208092485549,720,547
22401146,2,74,2.0,1.6216216216216217,540,466
22401146,2,26,-3.0,-6.923076923076923,466,440
22401146,2,69,0.0,0.0,415,346
22401146,2,33,2.0,3.6363636363636367,336,303
22401146,2,59,0.0,0.0,303,244
22401146,2,171,-8.0,-2.807017543859649,241,70
22401146,2,20,0.0,0.0,58,38
22401146,3,242,-5.0,-1.2396694214876034,720,478
22401146,3,90,1.0,0.6666666666666667,478,388
22401146,3,78,-1.0,-0.7692307692307692,388,310
22401146,3,22,0.0,0.0,290,268
22401146,3,95,3.0,1.8947368421052633,268,173
22401146,3,171,-1.0,-0.3508771929824561,171,0
22401146,4,183,-6.0,-1.9672131147540985,720,537
22401146,4,49,2.0,2.4489795918367343,517,468
22401146,4,68,2.0,1.7647058823529411,468,400
22401146,4,25,0.0,0.0,400,375
22401146,4,62,-3.0,-2.903225806451613,368,306
22401146,4,191,0.0,0.0,285,94
22401146,4,25,0.0,0.0,76,51
22401147,1,392,4.0,0.6122448979591836,720,328
22401147,1,13,0.0,0.0,328,315
22401147,1,77,3.0,2.3376623376623376,315,238
22401147,1,46,3.0,3.9130434782608696,226,180
22401147,1,175,-6.0,-2.0571428571428574,175,0
22401147,2,137,6.0,2.6277372262773726,720,583
22401147,2,53,6.0,6.7924528301886795,571,518
22401147,2,29,3.0,6.206896551724138,512,483
22401147,2,134,0.0,0.0,470,336
22401147,2,57,3.0,3.1578947368421053,321,264
22401147,2,48,2.0,2.5,257,209
22401147,2,102,2.0,1.1764705882352942,209,107
22401147,2,93,-1.0,-0.6451612903225807,93,0
22401147,3,277,0.0,0.0,720,443
22401147,3,43,0.0,0.0,428,385
22401147,3,122,-6.0,-2.9508196721311473,379,257
22401147,3,17,0.0,0.0,257,240
22401147,3,220,-2.0,-0.5454545454545454,220,0
22401147,4,41,0.0,0.0,720,679
22401147,4,148,3.0,1.2162162162162162,671,523
22401147,4,51,6.0,7.0588235294117645,502,451
22401147,4,94,-1.0,-0.6382978723404256,444,350
22401147,4,102,4.0,2.3529411764705883,350,248
22401147,4,37,0.0,0.0,242,205
22401148,1,323,-3.0,-0.5572755417956656,720,397
22401148,1,13,0.0,0.0,397,384
22401148,1,50,-1.0,-1.2,374,324
22401148,1,26,-1.0,-2.307692307692308,324,298
22401148,1,71,1.0,0.8450704225352113,298,227
22401148,1,92,-5.0,-3.260869565217391,227,135
22401148,1,26,0.0,0.0,128,102
22401148,1,23,-2.0,-5.217391304347826,90,67
22401148,1,67,2.0,1.791044776119403,67,0
22401148,2,172,1.0,0.3488372093023256,720,548
22401148,2,34,-1.0,-1.7647058823529411,544,510
22401148,2,197,9.0,2.7411167512690353,510,313
22401148,2,30,1.0,2.0,313,283
22401148,2,161,2.0,0.7453416149068323,283,122
22401148,2,114,-1.0,-0.5263157894736842,117,3
22401148,3,327,-9.0,-1.651376146788991,720,393
22401148,3,22,0.0,0.0,370,348
22401148,3,184,7.0,2.282608695652174,348,164
22401148,3,51,0.0,0.0,164,113
22401148,3,108,4.0,2.2222222222222223,108,0
22401148,4,195,4.0,1.2307692307692308,720,525
22401148,4,148,-5.0,-2.027027027027027,525,377
22401148,4,152,2.0,0.7894736842105263,356,204
22401148,4,204,7.0,2.058823529411765,204,0
22401149,1,193,5.0,1.5544041450777202,720,527
22401149,1,139,-2.0,-0.8633093525179857,527,388
22401149,1,146,1.0,0.410958904109589,377,231
22401149,1,20,0.0,0.0,231,211
22401149,1,43,-3.0,-4.186046511627907,211,168
22401149,1,115,1.0,0.5217391304347826,142,27
22401149,1,27,0.0,0.0,27,0
22401149,2,38,2.0,3.1578947368421053,720,682
22401149,2,21,1.0,2.8571428571428568,682,661
22401149,2,70,-3.0,-2.5714285714285716,661,591
22401149,2,18,-2.0,-6.666666666666666,584,566
22401149,2,101,2.0,1.188118811881188,566,465
22401149,2,98,-1.0,-0.6122448979591836,448,350
22401149,2,68,0.0,0.0,350,282
22401149,2,187,7.0,2.245989304812834,265,78
22401149,3,353,-1.0,-0.16997167138810199,720,367
22401149,3,46,2.0,2.608695652173913,358,312
22401149,3,27,0.0,0.0,312,285
22401149,3,56,-1.0,-1.0714285714285714,271,215
22401149,3,47,0.0,0.0,200,153
22401149,3,95,-4.0,-2.526315789473684,131,36
22401149,3,36,-2.0,-3.333333333333333,36,0
22401149,4,193,1.0,0.31088082901554404,720,527
22401149,4,81,-5.0,-3.7037037037037033,515,434
22401149,4,4,0.0,0.0,427,423
22401149,4,34,-1.0,-1.7647058823529411,423,389
22401149,4,62,0.0,0.0,374,312
22401149,4,303,-1.0,-0.19801980198019803,303,0
22401150,1,444,6.0,0.8108108108108109,720,276
22401150,1,47,0.0,0.0,276,229
22401150,1,126,-5.0,-2.380952380952381,225,99
22401150,1,7,-1.0,-8.571428571428571,78,71
22401150,2,209,-3.0,-0.861244019138756,720,511
22401150,2,14,0.0,0.0,511,497
22401150,2,48,-2.0,-2.5,497,449
22401150,2,47,-2.0,-2.5531914893617023,449,402
22401150,2,17,-2.0,-7.0588235294117645,379,362
22401150,2,97,8.0,4.948453608247423,349,252
22401150,2,134,4.0,1.791044776119403,239,105
22401150,2,96,-6.0,-3.75,96,0
22401150,3,286,7.0,1.4685314685314685,720,434
22401150,3,48,1.0,1.25,419,371
22401150,3,28,1.0,2.142857142857143,371,343
22401150,3,42,1.0,1.4285714285714284,343,301
22401150,3,27,1.0,2.2222222222222223,296,269
22401150,3,23,2.0,5.217391304347826,269,246
22401150,3,53,0.0,0.0,246,193
22401150,3,178,3.0,1.0112359550561798,178,0
22401150,4,85,-5.0,-3.5294117647058822,720,635
22401150,4,122,0.0,0.0,629,507
22401150,4,22,0.0,0.0,507,485
22401150,4,34,0.0,0.0,485,451
22401150,4,71,-1.0,-0.8450704225352113,438,367
22401150,4,110,2.0,1.0909090909090908,367,257
22401150,4,58,1.0,1.0344827586206897,245,187
22401150,4,187,-10.0,-3.2085561497326203,187,0
22401151,1,429,5.0,0.6993006993006994,720,291
22401151,1,110,-2.0,-1.0909090909090908,291,181
22401151,1,167,-3.0,-1.0778443113772456,167,0
22401151,2,292,3.0,0.6164383561643836,720,428
22401151,2,11,0.0,0.0,415,404
22401151,2,58,3.0,3.103448275862069,388,330
22401151,2,30,2.0,4.0,322,292
22401151,2,77,4.0,3.116883116883117,292,215
22401151,2,203,-2.0,-0.5911330049261084,203,0
22401151,3,388,-10.0,-1.5463917525773194,720,332
22401151,3,40,0.0,0.0,332,292
22401151,3,110,3.0,1.6363636363636362,276,166
22401151,3,133,-5.0,-2.2556390977443606,141,8
22401151,4,150,0.0,0.0,720,570
22401151,4,154,1.0,0.38961038961038963,564,410
22401151,4,206,-2.0,-0.5825242718446602,410,204
22401151,4,136,6.0,2.647058823529412,204,68
22401151,4,15,-2.0,-8.0,50,35
22401151,4,8,0.0,0.0,35,27
22401151,4,9,0.0,0.0,11,2
22401151,5,160,0.0,0.0,300,140
22401151,5,115,-1.0,-0.5217391304347826,131,16
22401151,5,12,2.0,10.0,12,0
22401152,1,394,2.0,0.3045685279187817,720,326
22401152,1,21,0.0,0.0,315,294
22401152,1,98,-2.0,-1.2244897959183672,278,180
22401152,1,157,4.0,1.5286624203821657,173,16
22401152,1,4,-2.0,-30.0,4,0
22401152,2,90,-2.0,-1.3333333333333335,720,630
22401152,2,65,4.0,3.6923076923076925,630,565
22401152,2,63,0.0,0.0,555,492
22401152,2,76,-4.0,-3.1578947368421053,492,416
22401152,2,92,-4.0,-2.608695652173913,398,306
22401152,2,55,-1.0,-1.0909090909090908,282,227
22401152,2,227,1.0,0.2643171806167401,227,0
22401152,3,350,3.0,0.5142857142857143,720,370
22401152,3,42,0.0,0.0,353,311
22401152,3,173,-5.0,-1.7341040462427746,294,121
22401152,3,43,-2.0,-2.7906976744186047,121,78
22401152,3,14,-3.0,-12.857142857142856,50,36
22401152,4,88,-2.0,-1.3636363636363638,720,632
22401152,4,82,6.0,4.390243902439024,628,546
22401152,4,29,2.0,4.137931034482759,530,501
22401152,4,51,0.0,0.0,488,437
22401152,4,23,3.0,7.826086956521739,424,401
22401152,4,181,7.0,2.320441988950276,377,196
22401152,4,50,6.0,7.199999999999999,187,137
22401152,4,100,1.0,0.6,113,13
22401152,4,11,0.0,0.0,11,0
22401153,1,258,3.0,0.6976744186046512,720,462
22401153,1,113,1.0,0.5309734513274336,449,336
22401153,1,67,0.0,0.0,336,269
22401153,1,14,0.0,0.0,269,255
22401153,1,53,0.0,0.0,255,202
22401153,1,25,1.0,2.4,196,171
22401153,1,64,-3.0,-2.8125,171,107
22401153,1,95,5.0,3.1578947368421053,95,0
22401153,2,72,0.0,0.0,720,648
22401153,2,78,2.0,1.5384615384615383,636,558
22401153,2,29,0.0,0.0,549,520
22401153,2,125,9.0,4.319999999999999,513,388
22401153,2,54,-3.0,-3.333333333333333,373,319
22401153,2,58,-1.0,-1.0344827586206897,310,252
22401153,2,27,0.0,0.0,242,215
22401153,2,45,1.0,1.3333333333333335,210,165
22401153,2,142,1.0,0.4225352112676056,165,23
22401153,2,23,-2.0,-5.217391304347826,23,0
22401153,3,193,-4.0,-1.2435233160621761,720,527
22401153,3,22,0.0,0.0,513,491
22401153,3,135,-3.0,-1.3333333333333335,471,336
22401153,3,12,0.0,0.0,295,283
22401153,3,25,-1.0,-2.4,267,242
22401153,3,233,-3.0,-0.7725321888412017,393,160
22401153,3,79,3.0,2.278481012658228,152,73
22401153,3,60,2.0,2.0,65,5
22401153,4,180,3.0,1.0,720,540
22401153,4,64,-1.0,-0.9375,540,476
22401153,4,2,0.0,0.0,462,460
22401153,4,42,2.0,2.8571428571428568,449,407
22401153,4,66,7.0,6.363636363636364,407,341
22401153,4,107,-1.0,-0.5607476635514018,326,219
22401153,4,102,8.0,4.705882352941177,209,107
22401153,4,100,-4.0,-2.4,100,0
22401154,1,281,-3.0,-0.6405693950177936,720,439
22401154,1,52,-1.0,-1.153846153846154,431,379
22401154,1,86,-2.0,-1.3953488372093024,379,293
22401154,1,108,-1.0,-0.5555555555555556,277,169
22401154,1,169,-3.0,-1.0650887573964498,169,0
22401154,2,226,2.0,0.5309734513274336,720,494
22401154,2,38,-4.0,-6.315789473684211,494,456
22401154,2,46,-2.0,-2.608695652173913,438,392
22401154,2,73,-2.0,-1.643835616438356,392,319
22401154,2,11,0.0,0.0,304,293
22401154,2,116,-5.0,-2.586206896551724,287,171
22401154,3,234,-7.0,-1.794871794871795,720,486
22401154,3,52,2.0,2.307692307692308,486,434
22401154,3,18,2.0,6.666666666666666,424,406
22401154,3,19,0.0,0.0,392,373
22401154,3,120,-2.0,-1.0,373,253
22401154,3,25,0.0,0.0,235,210
22401154,3,75,-2.0,-1.6,196,121
22401154,4,113,2.0,1.0619469026548671,720,607
22401154,4,50,5.0,6.0,594,544
22401154,4,141,-7.0,-2.9787234042553195,544,403
22401154,4,60,0.0,0.0,391,331
22401154,4,331,1.0,0.18126888217522658,331,0
22401155,1,492,-5.0,-0.6097560975609756,720,228
22401155,1,11,0.0,0.0,228,217
22401155,1,7,0.0,0.0,192,185
22401155,1,98,3.0,1.836734693877551,166,68
22401155,1,68,1.0,0.8823529411764706,68,0
22401155,2,167,-1.0,-0.3592814371257485,720,553
22401155,2,128,-2.0,-0.9375,534,406
22401155,2,59,0.0,0.0,399,340
22401155,2,67,2.0,1.791044776119403,340,273
22401155,2,54,-4.0,-4.444444444444445,259,205
22401155,2,19,2.0,6.315789473684211,199,180
22401155,2,174,3.0,1.0344827586206897,180,6
22401155,2,6,0.0,0.0,6,0
22401155,3,375,9.0,1.44,720,345
22401155,3,75,-1.0,-0.8,345,270
22401155,3,42,0.0,0.0,270,228
22401155,3,113,6.0,3.185840707964602,218,105
22401155,3,15,-2.0,-8.0,94,79
22401155,4,246,1.0,0.24390243902439027,720,474
22401155,4,33,-5.0,-9.090909090909092,464,431
22401155,4,48,-1.0,-1.25,431,383
22401155,4,122,8.0,3.934426229508197,370,248
22401155,4,180,-4.0,-1.3333333333333335,231,51
22401155,4,51,-7.0,-8.23529411764706,51,0
22401156,1,327,-3.0,-0.5504587155963303,720,393
22401156,1,39,-2.0,-3.0769230769230766,377,338
22401156,1,35,2.0,3.4285714285714284,321,286
22401156,1,52,0.0,0.0,279,227
22401156,1,49,-2.0,-2.4489795918367343,227,178
22401156,1,59,0.0,0.0,170,111
22401156,1,104,5.0,2.8846153846153846,111,7
22401156,1,7,0.0,0.0,7,0
22401156,2,146,8.0,3.287671232876712,720,574
22401156,2,152,2.0,0.7894736842105263,558,406
22401156,2,77,3.0,2.3376623376623376,395,318
22401156,2,214,-9.0,-2.5233644859813085,300,86
22401156,2,74,-2.0,-1.6216216216216217,74,0
22401156,3,294,5.0,1.0204081632653061,720,426
22401156,3,104,6.0,3.4615384615384617,410,306
22401156,3,48,2.0,2.5,286,238
22401156,3,160,2.0,0.75,218,58
22401156,3,52,-2.0,-2.307692307692308,52,0
22401156,4,277,2.0,0.4332129963898917,720,443
22401156,4,98,0.0,0.0,433,335
22401156,4,316,-1.0,-0.18987341772151897,316,0
22401157,1,352,1.0,0.17045454545454547,720,368
22401157,1,12,0.0,0.0,368,356
22401157,1,78,2.0,1.5384615384615383,345,267
22401157,1,91,1.0,0.6593406593406594,267,176
22401157,1,80,1.0,0.75,161,81
22401157,1,81,-1.0,-0.7407407407407407,81,0
22401157,2,173,-2.0,-0.6936416184971098,720,547
22401157,2,66,-4.0,-3.6363636363636367,547,481
22401157,2,72,3.0,2.5,481,409
22401157,2,15,1.0,4.0,395,380
22401157,2,115,-8.0,-4.173913043478261,371,256
22401157,2,28,2.0,4.285714285714286,219,191
22401157,2,154,3.0,1.1688311688311688,188,34
22401157,2,11,2.0,10.90909090909091,34,23
22401157,3,283,1.0,0.21201413427561838,720,437
22401157,3,79,1.0,0.7594936708860759,435,356
22401157,3,119,-2.0,-1.0084033613445378,356,237
22401157,3,52,0.0,0.0,226,174
22401157,3,85,-6.0,-4.235294117647059,161,76
22401157,4,29,4.0,8.275862068965518,720,691
22401157,4,47,-1.0,-1.2765957446808511,691,644
22401157,4,45,-3.0,-4.0,631,586
22401157,4,243,-10.0,-2.4691358024691357,580,337
22401157,4,87,-3.0,-2.0689655172413794,322,235
22401157,4,235,4.0,1.0212765957446808,235,0
22401158,1,336,0.0,0.0,720,384
22401158,1,43,-3.0,-4.186046511627907,372,329
22401158,1,36,2.0,3.333333333333333,321,285
22401158,1,51,0.0,0.0,285,234
22401158,1,202,1.0,0.297029702970297,234,32
22401158,1,28,4.0,8.571428571428571,28,0
22401158,2,194,2.0,0.6185567010309279,720,526
22401158,2,136,-2.0,-0.8823529411764706,523,387
22401158,2,78,3.0,2.307692307692308,375,297
22401158,2,115,1.0,0.5217391304347826,297,182
22401158,2,26,3.0,6.923076923076923,169,143
22401158,2,129,-4.0,-1.8604651162790697,131,2
22401158,3,257,3.0,0.7003891050583657,720,463
22401158,3,20,1.0,3.0,451,431
22401158,3,75,1.0,0.8,431,356
22401158,3,160,5.0,1.875,346,186
22401158,3,115,0.0,0.0,186,71
22401158,3,71,3.0,2.535211267605634,71,0
22401158,4,185,5.0,1.6216216216216217,720,535
22401158,4,121,7.0,3.4710743801652892,525,404
22401158,4,197,-1.0,-0.3045685279187817,385,188
22401158,4,83,-1.0,-0.7228915662650602,180,97
22401158,4,86,-2.0,-1.3953488372093024,86,0
22401159,1,206,3.0,0.8737864077669903,720,514
22401159,1,64,1.0,0.9375,514,450
22401159,1,113,-3.0,-1.592920353982301,445,332
22401159,1,86,-3.0,-2.0930232558139537,332,246
22401159,1,13,0.0,0.0,230,217
22401159,1,64,-1.0,-0.9375,209,145
22401159,1,51,4.0,4.705882352941177,137,86
22401159,1,86,2.0,1.3953488372093024,86,0
22401159,2,59,0.0,0.0,720,661
22401159,2,167,0.0,0.0,652,485
22401159,2,34,0.0,0.0,478,444
22401159,2,192,-6.0,-1.875,433,241
22401159,2,39,2.0,3.0769230769230766,219,180
22401159,2,129,3.0,1.3953488372093024,277,148
22401159,2,115,1.0,0.5217391304347826,115,0
22401159,3,215,-2.0,-0.5581395348837209,720,505
22401159,3,145,-7.0,-2.896551724137931,505,360
22401159,3,75,2.0,1.6,343,268
22401159,3,43,2.0,2.7906976744186047,268,225
22401159,3,211,-1.0,-0.28436018957345977,211,0
22401159,4,94,6.0,3.829787234042553,720,626
22401159,4,7,3.0,25.71428571428571,545,538
22401159,4,29,-4.0,-8.275862068965518,519,490
22401159,4,57,-3.0,-3.1578947368421053,490,433
22401159,4,86,4.0,2.7906976744186047,433,347
22401159,4,60,-2.0,-2.0,342,282
22401159,4,36,-2.0,-3.333333333333333,259,223
22401159,4,115,-4.0,-2.0869565217391304,210,95
22401159,4,94,0.0,0.0,94,0
22401160,1,350,-2.0,-0.34285714285714286,720,370
22401160,1,37,-2.0,-3.2432432432432434,370,333
22401160,1,67,3.0,2.6865671641791042,331,264
22401160,1,35,-2.0,-3.4285714285714284,251,216
22401160,1,33,1.0,1.8181818181818183,208,175
22401160,1,175,-4.0,-1.3714285714285714,175,0
22401160,2,45,1.0,1.3333333333333335,720,675
22401160,2,91,-3.0,-1.978021978021978,675,584
22401160,2,43,0.0,0.0,545,502
22401160,2,28,0.0,0.0,501,473
22401160,2,203,2.0,0.5911330049261084,464,261
22401160,2,115,5.0,2.608695652173913,261,146
22401160,2,78,0.0,0.0,143,65
22401160,2,13,0.0,0.0,48,35
22401160,3,280,5.0,1.0714285714285714,720,440
22401160,3,18,0.0,0.0,427,409
22401160,3,28,5.0,10.714285714285715,398,370
22401160,3,217,-2.0,-0.5529953917050692,344,127
22401160,3,56,-2.0,-2.142857142857143,109,53
22401160,3,39,0.0,0.0,39,0
22401160,4,145,0.0,0.0,720,575
22401160,4,27,0.0,0.0,563,536
22401160,4,22,-2.0,-5.454545454545455,536,514
22401160,4,43,4.0,5.5813953488372094,477,434
22401160,4,216,-2.0,-0.5555555555555556,417,201
22401160,4,160,0.0,0.0,191,31
22401160,4,4,-2.0,-30.0,28,24
22401160,4,23,0.0,0.0,23,0
22401161,1,432,-6.0,-0.8333333333333333,720,288
22401161,1,67,-2.0,-1.791044776119403,274,207
22401161,1,177,0.0,0.0,180,3
22401161,1,3,0.0,0.0,3,0
22401161,2,290,2.0,0.41379310344827586,720,430
22401161,2,88,-2.0,-1.3636363636363638,430,342
22401161,2,168,4.0,1.4285714285714284,330,162
22401161,2,148,6.0,2.4324324324324325,148,0
22401161,3,325,0.0,0.0,720,395
22401161,3,31,2.0,3.870967741935484,370,339
22401161,3,7,2.0,17.142857142857142,333,326
22401161,3,31,0.0,0.0,326,295
22401161,3,29,0.0,0.0,295,266
22401161,3,30,4.0,8.0,261,231
22401161,3,52,1.0,1.153846153846154,213,161
22401161,3,161,4.0,1.4906832298136645,161,0
22401161,4,266,10.0,2.2556390977443606,720,454
22401161,4,18,-3.0,-10.0,454,436
22401161,4,43,-1.0,-1.3953488372093024,361,318
22401161,4,178,2.0,0.6741573033707865,318,140
22401161,4,112,3.0,1.607142857142857,112,0
22401162,1,343,-2.0,-0.3498542274052478,720,377
22401162,1,53,2.0,2.2641509433962264,372,319
22401162,1,48,1.0,1.25,308,260
22401162,1,132,-2.0,-0.9090909090909092,260,128
22401162,1,26,2.0,4.615384615384616,105,79
22401162,2,233,0.0,0.0,720,487
22401162,2,49,-2.0,-2.4489795918367343,468,419
22401162,2,109,7.0,3.853211009174312,419,310
22401162,2,60,-5.0,-5.0,257,197
22401162,2,197,1.0,0.3045685279187817,197,0
22401162,3,35,0.0,0.0,720,685
22401162,3,245,-1.0,-0.2448979591836735,685,440
22401162,3,38,5.0,7.894736842105263,425,387
22401162,3,180,-5.0,-1.6666666666666665,373,193
22401162,3,16,2.0,7.5,185,169
22401162,3,39,-2.0,-3.0769230769230766,136,97
22401162,4,67,0.0,0.0,720,653
22401162,4,156,8.0,3.0769230769230766,653,497
22401162,4,100,-5.0,-3.0,497,397
22401162,4,126,-3.0,-1.4285714285714284,393,267
22401162,4,254,4.0,0.9448818897637795,254,0
22401162,5,195,1.0,0.3076923076923077,300,105
22401163,1,279,6.0,1.2903225806451615,720,441
22401163,1,168,2.0,0.7142857142857142,433,265
22401163,1,80,-2.0,-1.5,256,176
22401163,1,15,1.0,4.0,176,161
22401163,1,147,0.0,0.0,161,14
22401163,1,14,0.0,0.0,14,0
22401163,2,74,-5.0,-4.054054054054054,720,646
22401163,2,140,-1.0,-0.42857142857142855,634,494
22401163,2,38,-7.0,-11.052631578947368,486,448
22401163,2,167,2.0,0.718562874251497,448,281
22401163,2,281,-2.0,-0.4270462633451957,281,0
22401163,3,189,9.0,2.8571428571428568,720,531
22401163,3,93,1.0,0.6451612903225807,512,419
22401163,3,106,0.0,0.0,419,313
22401163,3,42,-1.0,-1.4285714285714284,300,258
22401163,3,92,4.0,2.608695652173913,258,166
22401163,3,31,0.0,0.0,157,126
22401163,3,82,0.0,0.0,106,24
22401163,4,137,-5.0,-2.18978102189781,720,583
22401163,4,38,-4.0,-6.315789473684211,583,545
22401163,4,94,0.0,0.0,530,436
22401163,4,36,1.0,1.6666666666666665,413,377
22401163,4,16,0.0,0.0,377,361
22401163,4,75,-5.0,-4.0,357,282
22401163,4,59,-1.0,-1.0169491525423728,282,223
22401163,4,215,-2.0,-0.5581395348837209,218,3
22401164,1,290,0.0,0.0,720,430
22401164,1,18,1.0,3.333333333333333,413,395
22401164,1,6,0.0,0.0,395,389
22401164,1,129,1.0,0.46511627906976744,385,256
22401164,1,81,3.0,2.2222222222222223,242,161
22401164,1,161,3.0,1.1180124223602486,161,0
22401164,2,151,3.0,1.1920529801324504,720,569
22401164,2,60,-1.0,-1.0,563,503
22401164,2,159,-3.0,-1.1320754716981132,503,344
22401164,2,95,-2.0,-1.263157894736842,326,231
22401164,2,135,-6.0,-2.666666666666667,231,96
22401164,2,95,-2.0,-1.263157894736842,96,1
22401164,2,1,0.0,0.0,1,0
22401164,3,214,-12.0,-3.364485981308411,720,506
22401164,3,79,4.0,3.0379746835443036,493,414
22401164,3,92,1.0,0.6521739130434783,414,322
22401164,3,93,-3.0,-1.935483870967742,308,215
22401164,3,88,0.0,0.0,215,127
22401164,3,65,-5.0,-4.615384615384616,115,50
22401164,3,29,-1.0,-2.0689655172413794,34,5
22401164,3,5,0.0,0.0,5,0
22401164,4,241,-2.0,-0.4979253112033195,720,479
22401164,4,61,-2.0,-1.9672131147540985,479,418
22401164,4,210,0.0,0.0,406,196
22401164,4,70,0.0,0.0,182,112
22401164,4,99,4.0,2.4242424242424243,99,0
22401165,1,358,0.0,0.0,720,362
22401165,1,42,-2.0,-2.8571428571428568,355,313
22401165,1,202,-5.0,-1.4851485148514851,313,111
22401165,1,87,-1.0,-0.6896551724137931,87,0
22401165,2,279,6.0,1.2903225806451615,720,441
22401165,2,61,2.0,1.9672131147540985,365,304
22401165,2,106,3.0,1.6981132075471699,288,182
22401165,2,170,-5.0,-1.7647058823529411,170,0
22401165,3,372,-8.0,-1.2903225806451615,720,348
22401165,3,86,2.0,1.3953488372093024,326,240
22401165,3,88,-4.0,-2.7272727272727275,229,141
22401165,3,141,6.0,2.5531914893617023,141,0
22401165,4,146,1.0,0.410958904109589,720,574
22401165,4,19,2.0,6.315789473684211,566,547
22401165,4,11,-1.0,-5.454545454545455,529,518
22401165,4,38,-3.0,-4.7368421052631575,495,457
22401165,4,128,2.0,0.9375,457,329
22401165,4,329,2.0,0.364741641337386,329,0
22401166,1,506,9.0,1.0671936758893281,720,214
22401166,1,69,-3.0,-2.608695652173913,203,134
22401166,1,13,0.0,0.0,127,114
22401166,1,87,-5.0,-3.4482758620689653,100,13
22401166,1,1,0.0,0.0,1,0
22401166,2,120,3.0,1.5,720,600
22401166,2,86,3.0,2.0930232558139537,600,514
22401166,2,98,-2.0,-1.2244897959183672,499,401
22401166,2,108,2.0,1.1111111111111112,385,277
22401166,2,68,6.0,5.294117647058824,263,195
22401166,2,37,1.0,1.6216216216216217,181,144
22401166,2,144,-1.0,-0.41666666666666663,144,0
22401166,3,385,4.0,0.6233766233766234,720,335
22401166,3,51,-1.0,-1.1764705882352942,324,273
22401166,3,217,0.0,0.0,262,45
22401166,3,39,3.0,4.615384615384616,39,0
22401166,4,222,2.0,0.5405405405405406,720,498
22401166,4,44,-3.0,-4.090909090909091,498,454
22401166,4,135,-1.0,-0.4444444444444445,443,308
22401166,4,123,-4.0,-1.9512195121951221,296,173
22401166,4,73,1.0,0.821917808219178,158,85
22401166,4,14,0.0,0.0,80,66
22401166,4,15,0.0,0.0,62,47
22401166,4,23,0.0,0.0,23,0
22401167,1,404,-3.0,-0.4455445544554455,720,316
22401167,1,74,-3.0,-2.4324324324324325,293,219
22401167,1,82,0.0,0.0,202,120
22401167,1,67,-5.0,-4.477611940298507,107,40
22401167,1,25,-2.0,-4.8,25,0
22401167,2,130,0.0,0.0,720,590
22401167,2,80,1.0,0.75,590,510
22401167,2,1,0.0,0.0,497,496
22401167,2,101,-2.0,-1.188118811881188,488,387
22401167,2,54,-1.0,-1.1111111111111112,375,321
22401167,2,114,-2.0,-1.0526315789473684,318,204
22401167,2,41,2.0,2.926829268292683,189,148
22401167,2,119,3.0,1.5126050420168067,128,9
22401167,2,4,-1.0,-15.0,9,5
22401167,2,5,0.0,0.0,5,0
22401167,3,257,-4.0,-0.933852140077821,720,463
22401167,3,56,-1.0,-1.0714285714285714,463,407
22401167,3,57,1.0,1.0526315789473684,391,334
22401167,3,107,4.0,2.2429906542056073,325,218
22401167,3,65,2.0,1.8461538461538463,208,143
22401167,3,40,0.0,0.0,140,100
22401167,3,12,0.0,0.0,100,88
22401167,3,14,1.0,4.285714285714286,88,74
22401167,3,74,0.0,0.0,74,0
22401167,4,96,0.0,0.0,720,624
22401167,4,8,0.0,0.0,619,611
22401167,4,235,7.0,1.7872340425531916,602,367
22401167,4,11,0.0,0.0,331,320
22401167,4,157,4.0,1.5286624203821657,313,156
22401167,4,93,1.0,0.6451612903225807,156,63
22401167,4,63,4.0,3.8095238095238093,63,0
22401168,1,305,0.0,0.0,720,415
22401168,1,116,-4.0,-2.0689655172413794,408,292
22401168,1,19,0.0,0.0,277,258
22401168,1,6,2.0,20.0,248,242
22401168,1,104,2.0,1.153846153846154,228,124
22401168,1,124,-1.0,-0.4838709677419355,124,0
22401168,2,143,-3.0,-1.2587412587412588,720,577
22401168,2,82,-5.0,-3.6585365853658534,558,476
22401168,2,27,-2.0,-4.444444444444445,467,440
22401168,2,108,-2.0,-1.1111111111111112,428,320
22401168,2,141,0.0,0.0,304,163
22401168,2,55,2.0,2.1818181818181817,163,108
22401168,2,93,0.0,0.0,93,0
22401168,3,292,1.0,0.2054794520547945,720,428
22401168,3,26,0.0,0.0,410,384
22401168,3,177,-3.0,-1.0169491525423728,373,196
22401168,3,60,3.0,3.0,185,125
22401168,3,113,1.0,0.5309734513274336,113,0
22401168,4,183,-4.0,-1.3114754098360655,720,537
22401168,4,29,4.0,8.275862068965518,532,503
22401168,4,103,-1.0,-0.5825242718446602,489,386
22401168,4,78,2.0,1.5384615384615383,381,303
22401168,4,52,0.0,0.0,303,251
22401168,4,228,3.0,0.7894736842105263,237,9
22401168,4,9,0.0,0.0,9,0
22401169,1,309,-8.0,-1.5533980582524272,720,411
22401169,1,21,-3.0,-8.571428571428571,402,381
22401169,1,42,-2.0,-2.8571428571428568,381,339
22401169,1,152,-2.0,-0.7894736842105263,324,172
22401169,1,152,-3.0,-1.1842105263157894,152,0
22401169,2,131,-1.0,-0.4580152671755725,720,589
22401169,2,32,-5.0,-9.375,589,557
22401169,2,85,-4.0,-2.8235294117647056,557,472
22401169,2,51,3.0,3.5294117647058822,450,399
22401169,2,187,-2.0,-0.6417112299465241,399,212
22401169,2,193,3.0,0.9326424870466321,207,14
22401169,2,14,-2.0,-8.571428571428571,14,0
22401169,3,384,-3.0,-0.46875,720,336
22401169,3,129,-2.0,-0.9302325581395349,311,182
22401169,3,25,0.0,0.0,182,157
22401169,3,151,-2.0,-0.7947019867549668,151,0
22401169,4,59,8.0,8.135593220338983,720,661
22401169,4,157,3.0,1.1464968152866242,649,492
22401169,4,147,-2.0,-0.8163265306122449,492,345
22401169,4,142,-3.0,-1.267605633802817,345,203
22401169,4,102,-1.0,-0.5882352941176471,188,86
22401169,4,74,4.0,3.2432432432432434,74,0
22401170,1,286,-10.0,-2.097902097902098,720,434
22401170,1,30,3.0,6.0,417,387
22401170,1,75,7.0,5.6000000000000005,387,312
22401170,1,26,-2.0,-4.615384615384616,301,275
22401170,1,21,-1.0,-2.8571428571428568,264,243
22401170,1,19,3.0,9.473684210526315,229,210
22401170,1,36,0.0,0.0,198,162
22401170,1,123,-8.0,-3.9024390243902443,151,28
22401170,2,182,4.0,1.3186813186813189,720,538
22401170,2,44,2.0,2.7272727272727275,531,487
22401170,2,156,0.0,0.0,487,331
22401170,2,33,0.0,0.0,323,290
22401170,2,7,1.0,8.571428571428571,271,264
22401170,2,85,5.0,3.5294117647058822,264,179
22401170,2,54,2.0,2.2222222222222223,176,122
22401170,2,122,1.0,0.49180327868852464,122,0
22401170,3,18,-1.0,-3.333333333333333,720,702
22401170,3,131,-6.0,-2.7480916030534353,702,571
22401170,3,54,-6.0,-6.666666666666666,571,517
22401170,3,70,-7.0,-6.0,506,436
22401170,3,76,0.0,0.0,416,340
22401170,3,16,-1.0,-3.75,340,324
22401170,3,73,1.0,0.821917808219178,324,251
22401170,3,24,0.0,0.0,251,227
22401170,3,208,-5.0,-1.4423076923076923,227,19
22401170,4,104,-1.0,-0.576923076923077,720,616
22401170,4,54,1.0,1.1111111111111112,606,552
22401170,4,30,0.0,0.0,552,522
22401170,4,145,2.0,0.8275862068965517,516,371
22401170,4,77,5.0,3.8961038961038956,359,282
22401170,4,194,-1.0,-0.30927835051546393,282,88
22401170,4,2,0.0,0.0,88,86
22401170,4,30,1.0,2.0,75,45
22401170,4,45,-2.0,-2.666666666666667,45,0
22401171,1,333,-6.0,-1.0810810810810811,720,387
22401171,1,41,1.0,1.4634146341463414,373,332
22401171,1,35,2.0,3.4285714285714284,332,297
22401171,1,132,8.0,3.6363636363636367,287,155
22401171,1,59,-4.0,-4.067796610169491,90,31
22401171,1,31,-3.0,-5.806451612903226,31,0
22401171,2,210,-5.0,-1.4285714285714284,720,510
22401171,2,65,0.0,0.0,510,445
22401171,2,43,2.0,2.7906976744186047,445,402
22401171,2,44,0.0,0.0,393,349
22401171,2,8,0.0,0.0,333,325
22401171,2,3,0.0,0.0,320,317
22401171,2,84,-2.0,-1.4285714285714284,303,219
22401171,2,56,3.0,3.214285714285714,219,163
22401171,2,157,3.0,1.1464968152866242,157,0
22401171,3,410,-5.0,-0.7317073170731707,720,310
22401171,3,15,1.0,4.0,294,279
22401171,3,82,0.0,0.0,279,197
22401171,3,107,5.0,2.803738317757009,197,90
22401171,3,62,1.0,0.967741935483871,89,27
22401171,3,8,1.0,7.5,27,19
22401171,3,19,0.0,0.0,19,0
22401171,4,231,-3.0,-0.7792207792207793,720,489
22401171,4,55,-1.0,-1.0909090909090908,481,426
22401171,4,117,1.0,0.5128205128205129,406,289
22401171,4,90,0.0,0.0,289,199
22401171,4,165,1.0,0.36363636363636365,180,15
22401171,4,9,-1.0,-6.666666666666666,9,0
22401172,1,376,1.0,0.1595744680851064,720,344
22401172,1,6,0.0,0.0,321,315
22401172,1,85,3.0,2.1176470588235294,315,230
22401172,1,3,0.0,0.0,209,206
22401172,1,14,0.0,0.0,192,178
22401172,1,20,-1.0,-3.0,178,158
22401172,1,158,0.0,0.0,158,0
22401172,2,167,-9.0,-3.2335329341317367,720,553
22401172,2,135,-4.0,-1.777777777777778,540,405
22401172,2,40,-2.0,-3.0,405,365
22401172,2,90,-10.0,-6.666666666666666,360,270
22401172,2,87,0.0,0.0,248,161
22401172,2,69,5.0,4.3478260869565215,161,92
22401172,2,82,-1.0,-0.7317073170731707,82,0
22401172,3,211,-5.0,-1.4218009478672984,720,509
22401172,3,27,-2.0,-4.444444444444445,488,461
22401172,3,53,-2.0,-2.2641509433962264,453,400
22401172,3,44,2.0,2.7272727272727275,400,356
22401172,3,123,-3.0,-1.4634146341463414,344,221
22401172,3,81,2.0,1.4814814814814814,195,114
22401172,3,93,-6.0,-3.870967741935484,93,0
22401172,4,270,6.0,1.3333333333333335,720,450
22401172,4,71,5.0,4.225352112676057,436,365
22401172,4,122,4.0,1.9672131147540985,365,243
22401172,4,9,0.0,0.0,243,234
22401172,4,230,5.0,1.3043478260869565,230,0
22401173,1,313,4.0,0.7667731629392971,720,407
22401173,1,21,-3.0,-8.571428571428571,390,369
22401173,1,76,0.0,0.0,369,293
22401173,1,113,-1.0,-0.5309734513274336,280,167
22401173,1,28,3.0,6.428571428571428,167,139
22401173,1,135,-5.0,-2.2222222222222223,135,0
22401173,2,242,2.0,0.49586776859504134,720,478
22401173,2,42,0.0,0.0,464,422
22401173,2,28,0.0,0.0,422,394
22401173,2,143,1.0,0.4195804195804196,391,248
22401173,2,53,-2.0,-2.2641509433962264,237,184
22401173,2,75,0.0,0.0,166,91
22401173,2,91,-1.0,-0.6593406593406594,91,0
22401173,3,271,-3.0,-0.6642066420664207,720,449
22401173,3,49,-1.0,-1.2244897959183672,449,400
22401173,3,75,-3.0,-2.4,400,325
22401173,3,22,2.0,5.454545454545455,316,294
22401173,3,28,0.0,0.0,264,236
22401173,3,108,1.0,0.5555555555555556,236,128
22401173,3,128,-5.0,-2.34375,128,0
22401173,4,140,-3.0,-1.2857142857142858,720,580
22401173,4,51,2.0,2.3529411764705883,572,521
22401173,4,48,-5.0,-6.25,521,473
22401173,4,60,-3.0,-3.0,470,410
22401173,4,52,1.0,1.153846153846154,394,342
22401173,4,70,-3.0,-2.5714285714285716,342,272
22401173,4,62,-5.0,-4.838709677419355,264,202
22401173,4,94,2.0,1.2765957446808511,187,93
22401174,1,324,1.0,0.18518518518518517,720,396
22401174,1,270,3.0,0.6666666666666667,385,115
22401174,1,101,-1.0,-0.594059405940594,101,0
22401174,2,251,-4.0,-0.9561752988047809,720,469
22401174,2,49,-2.0,-2.4489795918367343,464,415
22401174,2,80,1.0,0.75,415,335
22401174,2,228,2.0,0.5263157894736842,335,107
22401174,2,107,2.0,1.1214953271028036,107,0
22401174,3,250,11.0,2.6399999999999997,720,470
22401174,3,60,2.0,2.0,455,395
22401174,3,161,-1.0,-0.37267080745341613,380,219
22401174,3,94,-4.0,-2.5531914893617023,198,104
22401174,3,94,3.0,1.9148936170212765,94,0
22401174,4,173,2.0,0.6936416184971098,720,547
22401174,4,89,6.0,4.044943820224719,534,445
22401174,4,137,-1.0,-0.437956204379562,438,301
22401174,4,24,2.0,5.0,294,270
22401174,4,117,5.0,2.5641025641025643,263,146
22401174,4,135,4.0,1.777777777777778,135,0
22401175,1,289,6.0,1.245674740484429,720,431
22401175,1,29,1.0,2.0689655172413794,415,386
22401175,1,29,1.0,2.0689655172413794,386,357
22401175,1,90,1.0,0.6666666666666667,357,267
22401175,1,171,9.0,3.1578947368421053,267,96
22401175,1,96,1.0,0.625,96,0
22401175,2,199,8.0,2.412060301507538,720,521
22401175,2,154,-5.0,-1.9480519480519478,518,364
22401175,2,64,2.0,1.875,364,300
22401175,2,15,0.0,0.0,300,285
22401175,2,69,-6.0,-5.217391304347826,277,208
22401175,2,208,0.0,0.0,208,0
22401175,3,278,0.0,0.0,720,442
22401175,3,72,-2.0,-1.6666666666666665,430,358
22401175,3,106,-3.0,-1.6981132075471699,352,246
22401175,3,96,-5.0,-3.125,246,150
22401175,3,150,4.0,1.6,150,0
22401175,4,154,-6.0,-2.3376623376623376,720,566
22401175,4,33,0.0,0.0,555,522
22401175,4,110,-1.0,-0.5454545454545454,457,347
22401175,4,52,1.0,1.153846153846154,333,281
22401175,4,246,-3.0,-0.7317073170731707,281,35
22401175,4,35,-2.0,-3.4285714285714284,35,0
22401176,1,236,2.0,0.5084745762711864,720,484
22401176,1,137,-6.0,-2.6277372262773726,482,345
22401176,1,2,3.0,90.0,335,333
22401176,1,78,3.0,2.307692307692308,333,255
22401176,1,63,-4.0,-3.8095238095238093,243,180
22401176,1,14,1.0,4.285714285714286,163,149
22401176,1,117,-2.0,-1.0256410256410258,149,32
22401176,2,84,2.0,1.4285714285714284,720,636
22401176,2,155,2.0,0.7741935483870968,625,470
22401176,2,7,0.0,0.0,442,435
22401176,2,10,0.0,0.0,428,418
22401176,2,62,-1.0,-0.967741935483871,418,356
22401176,2,39,2.0,3.0769230769230766,350,311
22401176,2,146,3.0,1.2328767123287672,311,165
22401176,2,15,0.0,0.0,165,150
22401176,2,32,2.0,3.75,144,112
22401176,2,88,2.0,1.3636363636363638,109,21
22401176,3,375,10.0,1.6,720,345
22401176,3,83,2.0,1.4457831325301205,336,253
22401176,3,102,0.0,0.0,243,141
22401176,3,62,1.0,0.967741935483871,130,68
22401176,3,33,3.0,5.454545454545455,68,35
22401176,4,62,4.0,3.870967741935484,720,658
22401176,4,95,-2.0,-1.263157894736842,658,563
22401176,4,120,-6.0,-3.0,557,437
22401176,4,98,1.0,0.6122448979591836,426,328
22401176,4,164,1.0,0.36585365853658536,328,164
22401176,4,151,6.0,2.384105960264901,151,0
22401177,1,332,-8.0,-1.4457831325301205,720,388
22401177,1,63,0.0,0.0,368,305
22401177,1,10,0.0,0.0,212,202
22401177,1,70,-3.0,-2.5714285714285716,200,130
22401177,1,7,0.0,0.0,130,123
22401177,1,120,6.0,3.0,120,0
22401177,2,225,0.0,0.0,720,495
22401177,2,65,5.0,4.615384615384616,480,415
22401177,2,130,-1.0,-0.46153846153846156,415,285
22401177,2,57,-4.0,-4.2105263157894735,261,204
22401177,2,29,1.0,2.0689655172413794,201,172
22401177,2,172,-8.0,-2.7906976744186047,172,0
22401177,3,124,-10.0,-4.838709677419355,720,596
22401177,3,223,-11.0,-2.959641255605381,585,362
22401177,3,60,0.0,0.0,361,301
22401177,3,34,-4.0,-7.0588235294117645,301,267
22401177,3,142,2.0,0.8450704225352113,251,109
22401177,3,84,-3.0,-2.142857142857143,90,6
22401177,4,181,-1.0,-0.3314917127071823,720,539
22401177,4,114,-3.0,-1.5789473684210527,532,418
22401177,4,77,-1.0,-0.7792207792207793,371,294
22401177,4,279,-5.0,-1.075268817204301,279,0
22401178,1,303,3.0,0.594059405940594,720,417
22401178,1,151,-1.0,-0.3973509933774834,293,142
22401178,1,118,6.0,3.050847457627119,118,0
22401178,2,113,0.0,0.0,720,607
22401178,2,46,2.0,2.608695652173913,597,551
22401178,2,31,0.0,0.0,536,505
22401178,2,154,12.0,4.675324675324675,499,345
22401178,2,75,2.0,1.6,345,270
22401178,2,87,-2.0,-1.3793103448275863,257,170
22401178,2,129,-1.0,-0.46511627906976744,159,30
22401178,2,28,0.0,0.0,28,0
22401178,3,234,3.0,0.7692307692307692,720,486
22401178,3,61,4.0,3.934426229508197,486,425
22401178,3,14,0.0,0.0,425,411
22401178,3,102,-2.0,-1.1764705882352942,401,299
22401178,3,14,0.0,0.0,299,285
22401178,3,22,1.0,2.7272727272727275,275,253
22401178,3,118,-3.0,-1.5254237288135595,253,135
22401178,3,126,-3.0,-1.4285714285714284,126,0
22401178,4,114,-1.0,-0.5263157894736842,720,606
22401178,4,95,-1.0,-0.631578947368421,606,511
22401178,4,37,-3.0,-4.864864864864865,488,451
22401178,4,51,2.0,2.3529411764705883,446,395
22401178,4,162,-5.0,-1.8518518518518516,381,219
22401178,4,219,1.0,0.273972602739726,219,0
22401179,1,307,3.0,0.5863192182410423,720,413
22401179,1,106,2.0,1.1320754716981132,400,294
22401179,1,74,3.0,2.4324324324324325,282,208
22401179,1,30,0.0,0.0,208,178
22401179,1,164,4.0,1.4634146341463414,171,7
22401179,1,7,0.0,0.0,7,0
22401179,2,153,0.0,0.0,720,567
22401179,2,58,-1.0,-1.0344827586206897,567,509
22401179,2,69,1.0,0.8695652173913043,509,440
22401179,2,51,0.0,0.0,440,389
22401179,2,28,-2.0,-4.285714285714286,389,361
22401179,2,89,-2.0,-1.348314606741573,346,257
22401179,2,33,1.0,1.8181818181818183,257,224
22401179,2,56,3.0,3.214285714285714,224,168
22401179,2,101,0.0,0.0,150,49
22401179,2,44,-2.0,-2.7272727272727275,44,0
22401179,3,239,3.0,0.7531380753138075,720,481
22401179,3,59,4.0,4.067796610169491,481,422
22401179,3,87,0.0,0.0,404,317
22401179,3,68,4.0,3.5294117647058822,317,249
22401179,3,167,3.0,1.0778443113772456,226,59
22401179,3,19,0.0,0.0,59,40
22401179,3,30,0.0,0.0,30,0
22401179,4,339,-7.0,-1.238938053097345,720,381
22401179,4,123,2.0,0.9756097560975611,358,235
22401179,4,24,2.0,5.0,226,202
22401179,4,118,4.0,2.0338983050847457,191,73
22401180,1,165,-2.0,-0.7272727272727273,720,555
22401180,1,64,-3.0,-2.8125,555,491
22401180,1,84,-6.0,-4.285714285714286,488,404
22401180,1,52,0.0,0.0,404,352
22401180,1,52,-1.0,-1.153846153846154,347,295
22401180,1,121,0.0,0.0,295,174
22401180,1,111,-1.0,-0.5405405405405406,162,51
22401180,1,39,0.0,0.0,51,12
22401180,1,12,2.0,10.0,12,0
22401180,2,162,-2.0,-0.7407407407407407,720,558
22401180,2,53,-1.0,-1.1320754716981132,545,492
22401180,2,43,-2.0,-2.7906976744186047,492,449
22401180,2,54,-2.0,-2.2222222222222223,438,384
22401180,2,68,-4.0,-3.5294117647058822,384,316
22401180,2,44,-2.0,-2.7272727272727275,305,261
22401180,2,69,4.0,3.4782608695652173,252,183
22401180,2,164,5.0,1.8292682926829267,168,4
22401180,3,309,-1.0,-0.1941747572815534,720,411
22401180,3,74,3.0,2.4324324324324325,396,322
22401180,3,22,1.0,2.7272727272727275,316,294
22401180,3,41,0.0,0.0,294,253
22401180,3,19,2.0,6.315789473684211,248,229
22401180,3,156,-3.0,-1.153846153846154,211,55
22401180,4,154,0.0,0.0,720,566
22401180,4,78,-3.0,-2.307692307692308,566,488
22401180,4,114,0.0,0.0,479,365
22401180,4,13,0.0,0.0,365,352
22401180,4,6,0.0,0.0,331,325
22401180,4,73,2.0,1.643835616438356,316,243
22401180,4,30,0.0,0.0,238,208
22401180,4,159,8.0,3.018867924528302,208,49
22401180,4,12,0.0,0.0,49,37
22401180,4,16,0.0,0.0,16,0
22401181,1,363,-1.0,-0.1652892561983471,720,357
22401181,1,70,-3.0,-2.5714285714285716,357,287
22401181,1,113,-2.0,-1.0619469026548671,287,174
22401181,1,165,-3.0,-1.0909090909090908,165,0
22401181,2,131,2.0,0.916030534351145,720,589
22401181,2,80,3.0,2.25,583,503
22401181,2,94,-4.0,-2.5531914893617023,503,409
22401181,2,61,1.0,0.9836065573770493,403,342
22401181,2,64,-1.0,-0.9375,335,271
22401181,2,255,-1.0,-0.23529411764705882,256,1
22401181,3,330,-9.0,-1.6363636363636362,720,390
22401181,3,86,6.0,4.186046511627907,374,288
22401181,3,60,3.0,3.0,288,228
22401181,3,53,1.0,1.1320754716981132,222,169
22401181,3,22,2.0,5.454545454545455,149,127
22401181,3,93,-6.0,-3.870967741935484,127,34
22401181,4,78,-4.0,-3.0769230769230766,720,642
22401181,4,114,-5.0,-2.631578947368421,642,528
22401181,4,76,4.0,3.1578947368421053,517,441
22401181,4,167,-1.0,-0.3592814371257485,430,263
22401181,4,181,-9.0,-2.983425414364641,263,82
22401181,4,69,1.0,0.8695652173913043,69,0
22401182,1,496,1.0,0.12096774193548387,720,224
22401182,1,75,3.0,2.4,206,131
22401182,1,131,-3.0,-1.3740458015267176,131,0
22401182,2,213,0.0,0.0,720,507
22401182,2,25,0.0,0.0,490,465
22401182,2,9,0.0,0.0,462,453
22401182,2,109,5.0,2.7522935779816518,446,337
22401182,2,79,2.0,1.5189873417721518,322,243
22401182,2,227,5.0,1.3215859030837005,227,0
22401182,3,379,10.0,1.58311345646438,720,341
22401182,3,20,2.0,6.0,331,311
22401182,3,86,7.0,4.883720930232559,295,209
22401182,3,98,4.0,2.4489795918367343,209,111
22401182,3,15,1.0,4.0,101,86
22401182,3,86,-3.0,-2.0930232558139537,86,0
22401182,4,187,-6.0,-1.9251336898395723,720,533
22401182,4,39,-3.0,-4.615384615384616,520,481
22401182,4,75,-2.0,-1.6,481,406
22401182,4,86,3.0,2.0930232558139537,406,320
22401182,4,120,-2.0,-1.0,311,191
22401182,4,145,-1.0,-0.41379310344827586,182,37
22401182,4,37,3.0,4.864864864864865,37,0
22401183,1,289,5.0,1.0380622837370244,720,431
22401183,1,171,-1.0,-0.3508771929824561,431,260
22401183,1,126,-1.0,-0.47619047619047616,245,119
22401183,1,78,-7.0,-5.384615384615385,103,25
22401183,1,25,0.0,0.0,25,0
22401183,2,202,-2.0,-0.594059405940594,720,518
22401183,2,36,0.0,0.0,518,482
22401183,2,139,-3.0,-1.2949640287769786,482,343
22401183,2,115,-2.0,-1.0434782608695652,321,206
22401183,2,27,2.0,4.444444444444445,189,162
22401183,2,162,-3.0,-1.1111111111111112,162,0
22401183,3,226,-10.0,-2.6548672566371683,720,494
22401183,3,84,-2.0,-1.4285714285714284,486,402
22401183,3,30,2.0,4.0,392,362
22401183,3,191,5.0,1.5706806282722514,354,163
22401183,3,163,-2.0,-0.7361963190184049,163,0
22401183,4,83,2.0,1.4457831325301205,720,637
22401183,4,198,-4.0,-1.2121212121212122,620,422
22401183,4,84,2.0,1.4285714285714284,422,338
22401183,4,7,0.0,0.0,332,325
22401183,4,120,-8.0,-4.0,312,192
22401183,4,185,10.0,3.2432432432432434,185,0
22401184,1,346,-1.0,-0.17341040462427745,720,374
22401184,1,88,5.0,3.409090909090909,351,263
22401184,1,31,4.0,7.741935483870968,256,225
22401184,1,27,0.0,0.0,202,175
22401184,1,105,4.0,2.285714285714286,163,58
22401184,1,50,0.0,0.0,50,0
22401184,2,104,0.0,0.0,720,616
22401184,2,42,0.0,0.0,609,567
22401184,2,88,1.0,0.6818181818181819,561,473
22401184,2,66,-2.0,-1.8181818181818183,462,396
22401184,2,306,-2.0,-0.39215686274509803,379,73
22401184,2,18,0.0,0.0,73,55
22401184,3,356,-5.0,-0.8426966292134831,720,364
22401184,3,93,0.0,0.0,352,259
22401184,3,94,0.0,0.0,259,165
22401184,3,151,0.0,0.0,165,14
22401184,4,153,2.0,0.7843137254901961,720,567
22401184,4,12,2.0,10.0,554,542
22401184,4,86,-2.0,-1.3953488372093024,542,456
22401184,4,159,-3.0,-1.1320754716981132,456,297
22401184,4,48,2.0,2.5,297,249
22401184,4,185,3.0,0.972972972972973,249,64
22401184,4,13,2.0,9.230769230769232,64,51
22401184,4,22,-1.0,-2.7272727272727275,32,10
22401184,4,7,1.0,8.571428571428571,10,3
22401184,4,1,0.0,0.0,3,2
22401185,1,245,2.0,0.489795918367347,720,475
22401185,1,31,-4.0,-7.741935483870968,464,433
22401185,1,42,-3.0,-4.285714285714286,421,379
22401185,1,75,4.0,3.2,375,300
22401185,1,24,0.0,0.0,300,276
22401185,1,15,0.0,0.0,264,249
22401185,1,71,-1.0,-0.8450704225352113,249,178
22401185,1,87,1.0,0.6896551724137931,178,91
22401185,1,75,3.0,2.4,81,6
22401185,1,1,0.0,0.0,1,0
22401185,2,108,5.0,2.7777777777777777,720,612
22401185,2,30,2.0,4.0,594,564
22401185,2,127,-2.0,-0.9448818897637795,560,433
22401185,2,57,1.0,1.0526315789473684,425,368
22401185,2,24,0.0,0.0,368,344
22401185,2,29,3.0,6.206896551724138,322,293
22401185,2,42,0.0,0.0,279,237
22401185,2,78,-2.0,-1.5384615384615383,237,159
22401185,2,122,3.0,1.4754098360655736,159,37
22401185,2,37,0.0,0.0,37,0
22401185,3,194,-5.0,-1.5463917525773194,720,526
22401185,3,73,0.0,0.0,520,447
22401185,3,23,-1.0,-2.608695652173913,440,417
22401185,3,165,2.0,0.7272727272727273,417,252
22401185,3,40,0.0,0.0,233,193
22401185,3,30,0.0,0.0,193,163
22401185,3,163,1.0,0.36809815950920244,163,0
22401185,4,148,2.0,0.8108108108108109,720,572
22401185,4,163,-2.0,-0.7361963190184049,572,409
22401185,4,84,-1.0,-0.7142857142857142,400,316
22401185,4,36,3.0,5.0,299,263
22401185,4,16,0.0,0.0,253,237
22401185,4,169,8.0,2.8402366863905324,228,59
22401186,1,276,0.0,0.0,720,444
22401186,1,23,0.0,0.0,430,407
22401186,1,100,-3.0,-1.7999999999999998,397,297
22401186,1,135,4.0,1.777777777777778,282,147
22401186,1,137,4.0,1.751824817518248,137,0
22401186,2,100,5.0,3.0,720,620
22401186,2,257,-11.0,-2.568093385214008,620,363
22401186,2,75,3.0,2.4,352,277
22401186,2,90,-2.0,-1.3333333333333335,277,187
22401186,2,171,8.0,2.807017543859649,171,0
22401186,3,258,5.0,1.1627906976744187,720,462
22401186,3,133,-3.0,-1.3533834586466165,447,314
22401186,3,133,-7.0,-3.1578947368421053,314,181
22401186,3,20,-1.0,-3.0,163,143
22401186,3,143,1.0,0.4195804195804196,143,0
22401186,4,109,4.0,2.2018348623853212,720,611
22401186,4,93,0.0,0.0,608,515
22401186,4,118,6.0,3.050847457627119,505,387
22401186,4,262,-5.0,-1.1450381679389314,387,125
22401187,1,344,11.0,1.9186046511627908,720,376
22401187,1,59,5.0,5.084745762711864,367,308
22401187,1,270,1.0,0.22222222222222224,290,20
22401187,2,102,1.0,0.5882352941176471,720,618
22401187,2,100,-2.0,-1.2,609,509
22401187,2,235,1.0,0.2553191489361702,509,274
22401187,2,248,-4.0,-0.967741935483871,258,10
22401187,3,277,-5.0,-1.0830324909747293,720,443
22401187,3,41,-2.0,-2.926829268292683,443,402
22401187,3,140,-1.0,-0.42857142857142855,402,262
22401187,3,18,0.0,0.0,254,236
22401187,3,236,-3.0,-0.7627118644067797,236,0
22401187,4,247,4.0,0.9716599190283401,720,473
22401187,4,72,2.0,1.6666666666666665,466,394
22401187,4,118,0.0,0.0,368,250
22401187,4,219,2.0,0.547945205479452,243,24
22401187,4,7,1.0,8.571428571428571,26,19
22401188,1,6,0.0,0.0,720,714
22401188,1,262,-2.0,-0.4580152671755725,695,433
22401188,1,100,2.0,1.2,433,333
22401188,1,64,-1.0,-0.9375,333,269
22401188,1,56,7.0,7.5,269,213
22401188,1,24,0.0,0.0,202,178
22401188,1,176,-3.0,-1.0227272727272727,176,0
22401188,2,199,5.0,1.5075376884422111,720,521
22401188,2,75,3.0,2.4,521,446
22401188,2,67,0.0,0.0,437,370
22401188,2,87,-2.0,-1.3793103448275863,358,271
22401188,2,69,-4.0,-3.4782608695652173,271,202
22401188,2,104,3.0,1.7307692307692308,192,88
22401188,2,88,-3.0,-2.0454545454545454,88,0
22401188,3,262,3.0,0.6870229007633588,720,458
22401188,3,72,-1.0,-0.8333333333333333,441,369
22401188,3,55,-1.0,-1.0909090909090908,354,299
22401188,3,18,0.0,0.0,299,281
22401188,3,42,-3.0,-4.285714285714286,267,225
22401188,3,216,-5.0,-1.3888888888888888,216,0
22401188,4,250,-2.0,-0.48,720,470
22401188,4,8,0.0,0.0,470,462
22401188,4,70,3.0,2.5714285714285716,450,380
22401188,4,41,0.0,0.0,367,326
22401188,4,82,5.0,3.6585365853658534,326,244
22401188,4,42,0.0,0.0,222,180
22401188,4,148,-4.0,-1.6216216216216217,176,28
22401188,4,24,0.0,0.0,24,0
22401189,1,41,0.0,0.0,720,679
22401189,1,275,-2.0,-0.43636363636363634,664,389
22401189,1,64,5.0,4.6875,389,325
22401189,1,14,0.0,0.0,325,311
22401189,1,48,0.0,0.0,296,248
22401189,1,24,0.0,0.0,245,221
22401189,1,215,5.0,1.3953488372093024,215,0
22401189,2,99,1.0,0.6060606060606061,720,621
22401189,2,57,2.0,2.1052631578947367,621,564
22401189,2,58,3.0,3.103448275862069,564,506
22401189,2,96,1.0,0.625,501,405
22401189,2,75,5.0,4.0,405,330
22401189,2,128,2.0,0.9375,310,182
22401189,2,173,-1.0,-0.3468208092485549,173,0
22401189,3,171,3.0,1.0526315789473684,720,549
22401189,3,136,6.0,2.647058823529412,549,413
22401189,3,26,-3.0,-6.923076923076923,407,381
22401189,3,104,-2.0,-1.153846153846154,381,277
22401189,3,28,-2.0,-4.285714285714286,277,249
22401189,3,57,-2.0,-2.1052631578947367,249,192
22401189,3,21,-2.0,-5.7142857142857135,192,171
22401189,3,157,2.0,0.7643312101910829,157,0
22401189,4,231,3.0,0.7792207792207793,720,489
22401189,4,113,-5.0,-2.6548672566371683,474,361
22401189,4,311,-12.0,-2.315112540192926,350,39
22401189,4,3,0.0,0.0,20,17
22401189,4,11,0.0,0.0,14,3
22401189,5,202,2.0,0.594059405940594,300,98
22401189,6,132,0.0,0.0,300,168
22401190,1,355,4.0,0.676056338028169,720,365
22401190,1,91,1.0,0.6593406593406594,351,260
22401190,1,80,-3.0,-2.25,257,177
22401190,1,160,-4.0,-1.5,160,0
22401190,2,143,-5.0,-2.097902097902098,720,577
22401190,2,63,-4.0,-3.8095238095238093,577,514
22401190,2,21,-2.0,-5.7142857142857135,499,478
22401190,2,96,2.0,1.25,478,382
22401190,2,97,-3.0,-1.8556701030927836,373,276
22401190,2,75,2.0,1.6,265,190
22401190,2,137,4.0,1.751824817518248,173,36
22401190,2,36,-1.0,-1.6666666666666665,36,0
22401190,3,371,-2.0,-0.3234501347708895,720,349
22401190,3,86,-4.0,-2.7906976744186047,349,263
22401190,3,168,3.0,1.0714285714285714,257,89
22401190,3,82,1.0,0.7317073170731707,82,0
22401190,4,602,7.0,0.6976744186046512,720,118
22401191,1,422,-4.0,-0.5687203791469195,720,298
22401191,1,110,-3.0,-1.6363636363636362,298,188
22401191,1,71,3.0,2.535211267605634,163,92
22401191,2,143,4.0,1.6783216783216783,720,577
22401191,2,108,-4.0,-2.2222222222222223,570,462
22401191,2,88,0.0,0.0,462,374
22401191,2,38,-2.0,-3.1578947368421053,366,328
22401191,2,78,6.0,4.615384615384616,319,241
22401191,2,56,4.0,4.285714285714286,227,171
22401191,2,55,2.0,2.1818181818181817,171,116
22401191,3,303,-16.0,-3.1683168316831685,720,417
22401191,3,118,-3.0,-1.5254237288135595,417,299
22401191,3,73,3.0,2.4657534246575343,292,219
22401191,3,65,0.0,0.0,211,146
22401191,3,131,-1.0,-0.4580152671755725,131,0
22401191,4,173,-4.0,-1.3872832369942196,720,547
22401191,4,140,-6.0,-2.5714285714285716,541,401
22401191,4,108,4.0,2.2222222222222223,386,278
22401191,4,74,-4.0,-3.2432432432432434,278,204
22401191,4,73,-2.0,-1.643835616438356,197,124
22401191,4,117,-3.0,-1.5384615384615383,117,0
22401192,1,501,12.0,1.437125748502994,720,219
22401192,1,84,3.0,2.142857142857143,201,117
22401192,1,103,-1.0,-0.5825242718446602,103,0
22401192,2,90,-3.0,-2.0,720,630
22401192,2,82,5.0,3.6585365853658534,619,537
22401192,2,87,2.0,1.3793103448275863,485,398
22401192,2,251,2.0,0.47808764940239046,386,135
22401192,2,116,-5.0,-2.586206896551724,116,0
22401192,3,337,-8.0,-1.42433234421365,720,383
22401192,3,71,-2.0,-1.6901408450704225,371,300
22401192,3,15,0.0,0.0,292,277
22401192,3,178,2.0,0.6741573033707865,264,86
22401192,4,182,-1.0,-0.3296703296703297,720,538
22401192,4,55,-2.0,-2.1818181818181817,506,451
22401192,4,216,-1.0,-0.2777777777777778,536,320
22401192,4,320,1.0,0.1875,320,0
22401192,5,253,5.0,1.1857707509881423,300,47
22401192,5,47,1.0,1.2765957446808511,47,0
22401193,1,352,0.0,0.0,720,368
22401193,1,113,-5.0,-2.6548672566371683,359,246
22401193,1,97,2.0,1.2371134020618557,233,136
22401193,1,111,-6.0,-3.2432432432432434,124,13
22401193,1,12,0.0,0.0,13,1
22401193,2,242,3.0,0.743801652892562,720,478
22401193,2,8,0.0,0.0,473,465
22401193,2,13,0.0,0.0,433,420
22401193,2,106,-3.0,-1.6981132075471699,405,299
22401193,2,77,6.0,4.675324675324675,299,222
22401193,2,195,-1.0,-0.3076923076923077,216,21
22401193,3,220,-5.0,-1.3636363636363638,720,500
22401193,3,172,-5.0,-1.744186046511628,485,313
22401193,3,114,-4.0,-2.1052631578947367,313,199
22401193,3,8,2.0,15.0,193,185
22401193,3,94,0.0,0.0,185,91
22401193,3,91,-4.0,-2.6373626373626378,91,0
22401193,4,128,-3.0,-1.40625,720,592
22401193,4,200,9.0,2.6999999999999997,582,382
22401193,4,99,-3.0,-1.8181818181818183,368,269
22401193,4,16,0.0,0.0,264,248
22401193,4,241,10.0,2.4896265560165975,241,0
22401194,1,187,-6.0,-1.9251336898395723,720,533
22401194,1,71,0.0,0.0,533,462
22401194,1,149,7.0,2.8187919463087248,449,300
22401194,1,46,3.0,3.9130434782608696,281,235
22401194,1,62,5.0,4.838709677419355,227,165
22401194,1,144,1.0,0.41666666666666663,151,7
22401194,1,7,-2.0,-17.142857142857142,7,0
22401194,2,60,0.0,0.0,720,660
22401194,2,32,0.0,0.0,647,615
22401194,2,30,0.0,0.0,606,576
22401194,2,68,3.0,2.647058823529412,561,493
22401194,2,15,-1.0,-4.0,493,478
22401194,2,18,-1.0,-3.333333333333333,478,460
22401194,2,43,0.0,0.0,460,417
22401194,2,49,1.0,1.2244897959183672,410,361
22401194,2,65,2.0,1.8461538461538463,361,296
22401194,2,59,4.0,4.067796610169491,283,224
22401194,2,80,4.0,3.0,209,129
22401194,2,119,-10.0,-5.04201680672269,119,0
22401194,3,211,6.0,1.7061611374407581,720,509
22401194,3,67,0.0,0.0,507,440
22401194,3,66,-1.0,-0.9090909090909092,440,374
22401194,3,70,2.0,1.7142857142857142,374,304
22401194,3,76,5.0,3.9473684210526314,304,228
22401194,3,113,2.0,1.0619469026548671,228,115
22401194,3,115,4.0,2.0869565217391304,115,0
22401194,4,180,6.0,2.0,720,540
22401194,4,126,-1.0,-0.47619047619047616,537,411
22401194,4,75,2.0,1.6,398,323
22401194,4,175,5.0,1.7142857142857142,308,133
22401195,1,368,4.0,0.6521739130434783,720,352
22401195,1,71,3.0,2.535211267605634,340,269
22401195,1,96,8.0,5.0,258,162
22401195,1,146,0.0,0.0,146,0
22401195,2,231,-1.0,-0.2597402597402597,720,489
22401195,2,39,0.0,0.0,489,450
22401195,2,29,-5.0,-10.344827586206897,432,403
22401195,2,91,0.0,0.0,391,300
22401195,2,22,0.0,0.0,282,260
22401195,2,100,0.0,0.0,249,149
22401195,2,112,0.0,0.0,149,37
22401195,2,32,2.0,3.75,32,0
22401195,3,107,4.0,2.2429906542056073,720,613
22401195,3,70,-1.0,-0.8571428571428571,602,532
22401195,3,110,1.0,0.5454545454545454,520,410
22401195,3,58,-1.0,-1.0344827586206897,399,341
22401195,3,56,4.0,4.285714285714286,332,276
22401195,3,92,0.0,0.0,276,184
22401195,3,174,1.0,0.3448275862068966,174,0
22401195,4,86,0.0,0.0,720,634
22401195,4,125,2.0,0.96,634,509
22401195,4,63,-4.0,-3.8095238095238093,500,437
22401195,4,93,1.0,0.6451612903225807,430,337
22401195,4,9,3.0,20.0,337,328
22401195,4,112,-7.0,-3.75,328,216
22401196,1,136,-7.0,-3.0882352941176467,720,584
22401196,1,97,-3.0,-1.8556701030927836,569,472
22401196,1,38,-2.0,-3.1578947368421053,472,434
22401196,1,28,-4.0,-8.571428571428571,421,393
22401196,1,92,-1.0,-0.6521739130434783,393,301
22401196,1,45,-2.0,-2.666666666666667,287,242
22401196,1,38,0.0,0.0,233,195
22401196,1,41,0.0,0.0,187,146
22401196,1,146,-2.0,-0.821917808219178,146,0
22401196,2,109,3.0,1.651376146788991,720,611
22401196,2,130,-7.0,-3.230769230769231,611,481
22401196,2,70,7.0,6.0,457,387
22401196,2,7,1.0,8.571428571428571,373,366
22401196,2,81,1.0,0.7407407407407407,355,274
22401196,2,62,-1.0,-0.967741935483871,255,193
22401196,2,162,0.0,0.0,193,31
22401196,2,29,0.0,0.0,29,0
22401196,3,268,6.0,1.3432835820895521,720,452
22401196,3,43,3.0,4.186046511627907,452,409
22401196,3,46,-2.0,-2.608695652173913,395,349
22401196,3,58,0.0,0.0,332,274
22401196,3,46,-3.0,-3.9130434782608696,261,215
22401196,3,151,-2.0,-0.7947019867549668,205,54
22401196,3,36,-2.0,-3.333333333333333,54,18
22401196,3,18,-1.0,-3.333333333333333,18,0
22401196,4,224,-3.0,-0.8035714285714285,720,496
22401196,4,106,1.0,0.5660377358490566,496,390
22401196,4,69,0.0,0.0,390,321
22401196,4,18,0.0,0.0,321,303
22401196,4,144,-2.0,-0.8333333333333333,294,150
22401196,4,137,8.0,3.503649635036496,137,0
22401197,1,182,-2.0,-0.6593406593406594,720,538
22401197,1,139,0.0,0.0,535,396
22401197,1,44,2.0,2.7272727272727275,383,339
22401197,1,60,-5.0,-5.0,336,276
22401197,1,9,0.0,0.0,276,267
22401197,1,57,-3.0,-3.1578947368421053,265,208
22401197,1,60,-1.0,-1.0,60,0
22401197,2,130,-5.0,-2.307692307692308,720,590
22401197,2,14,0.0,0.0,590,576
22401197,2,101,2.0,1.188118811881188,574,473
22401197,2,139,-5.0,-2.158273381294964,461,322
22401197,2,41,0.0,0.0,309,268
22401197,2,57,0.0,0.0,254,197
22401197,2,35,-1.0,-1.7142857142857142,189,154
22401197,2,23,2.0,5.217391304347826,154,131
22401197,2,131,-5.0,-2.290076335877863,131,0
22401197,3,297,3.0,0.6060606060606061,720,423
22401197,3,20,0.0,0.0,408,388
22401197,3,122,4.0,1.9672131147540985,380,258
22401197,3,111,5.0,2.7027027027027026,257,146
22401197,3,36,1.0,1.6666666666666665,134,98
22401197,4,158,3.0,1.139240506329114,720,562
22401197,4,179,1.0,0.335195530726257,602,423
22401197,4,43,4.0,5.5813953488372094,423,380
22401197,4,58,0.0,0.0,364,306
22401197,4,171,-2.0,-0.7017543859649122,306,135
22401197,4,135,2.0,0.888888888888889,135,0
22401198,1,306,0.0,0.0,720,414
22401198,1,19,0.0,0.0,401,382
22401198,1,55,-2.0,-2.1818181818181817,371,316
22401198,1,63,0.0,0.0,316,253
22401198,1,53,1.0,1.1320754716981132,253,200
22401198,1,20,2.0,6.0,180,160
22401198,1,54,-1.0,-1.1111111111111112,144,90
22401198,1,55,6.0,6.545454545454545,90,35
22401198,1,13,2.0,9.230769230769232,35,22
22401198,1,22,2.0,5.454545454545455,22,0
22401198,2,68,3.0,2.647058823529412,720,652
22401198,2,201,-3.0,-0.8955223880597015,645,444
22401198,2,115,-7.0,-3.6521739130434785,439,324
22401198,2,66,-5.0,-4.545454545454546,308,242
22401198,2,172,2.0,0.6976744186046512,230,58
22401198,2,26,-3.0,-6.923076923076923,58,32
22401198,2,29,0.0,0.0,29,0
22401198,3,280,3.0,0.6428571428571429,720,440
22401198,3,94,-5.0,-3.1914893617021276,422,328
22401198,3,145,-1.0,-0.41379310344827586,320,175
22401198,3,32,0.0,0.0,161,129
22401198,3,36,0.0,0.0,129,93
22401198,3,93,-2.0,-1.2903225806451615,93,0
22401198,4,177,-3.0,-1.0169491525423728,720,543
22401198,4,101,0.0,0.0,541,440
22401198,4,16,0.0,0.0,440,424
22401198,4,194,1.0,0.30927835051546393,410,216
22401198,4,189,5.0,1.5873015873015872,206,17
22401198,4,10,0.0,0.0,10,0
22401198,5,293,1.0,0.20477815699658702,300,7
22401199,1,327,5.0,0.9174311926605504,720,393
22401199,1,52,-3.0,-3.4615384615384617,393,341
22401199,1,40,0.0,0.0,341,301
22401199,1,61,1.0,0.9836065573770493,295,234
22401199,1,110,1.0,0.5454545454545454,215,105
22401199,1,103,-2.0,-1.1650485436893203,103,0
22401199,2,181,-2.0,-0.6629834254143646,720,539
22401199,2,129,1.0,0.46511627906976744,531,402
22401199,2,93,1.0,0.6451612903225807,389,296
22401199,2,42,3.0,4.285714285714286,291,249
22401199,2,44,1.0,1.3636363636363638,237,193
22401199,2,33,2.0,3.6363636363636367,179,146
22401199,2,134,3.0,1.3432835820895521,134,0
22401199,3,182,5.0,1.6483516483516483,720,538
22401199,3,69,-1.0,-0.8695652173913043,530,461
22401199,3,94,3.0,1.9148936170212765,457,363
22401199,3,106,4.0,2.2641509433962264,363,257
22401199,3,52,2.0,2.307692307692308,257,205
22401199,4,252,3.0,0.7142857142857142,720,468
22401199,4,74,-2.0,-1.6216216216216217,449,375
22401199,4,295,-2.0,-0.4067796610169491,295,0
22401200,1,332,12.0,2.1686746987951806,720,388
22401200,1,49,1.0,1.2244897959183672,383,334
22401200,1,46,-4.0,-5.217391304347826,325,279
22401200,1,92,1.0,0.6521739130434783,259,167
22401200,1,42,2.0,2.8571428571428568,73,31
22401200,1,14,2.0,8.571428571428571,20,6
22401200,1,4,0.0,0.0,6,2
22401200,2,134,-2.0,-0.8955223880597015,720,586
22401200,2,127,0.0,0.0,573,446
22401200,2,35,6.0,10.285714285714286,429,394
22401200,2,57,-2.0,-2.1052631578947367,380,323
22401200,2,111,1.0,0.5405405405405406,321,210
22401200,2,146,-1.0,-0.410958904109589,146,0
22401200,3,289,8.0,1.6608996539792389,720,431
22401200,3,65,-3.0,-2.769230769230769,423,358
22401200,3,18,0.0,0.0,358,340
22401200,3,103,-3.0,-1.7475728155339807,318,215
22401200,3,32,-2.0,-3.75,195,163
22401200,3,38,2.0,3.1578947368421053,150,112
22401200,3,88,2.0,1.3636363636363638,88,0
22401200,4,247,3.0,0.728744939271255,720,473
22401200,4,115,0.0,0.0,448,333
22401200,4,44,-2.0,-2.7272727272727275,318,274
22401200,4,90,3.0,2.0,256,166
22401200,4,156,-2.0,-0.7692307692307692,156,0
22401201,1,377,-3.0,-0.47745358090185674,720,343
22401201,1,29,0.0,0.0,331,302
22401201,1,70,0.0,0.0,302,232
22401201,1,151,-2.0,-0.7947019867549668,232,81
22401201,1,62,-1.0,-0.967741935483871,62,0
22401201,2,188,5.0,1.5957446808510638,720,532
22401201,2,200,5.0,1.5,520,320
22401201,2,15,0.0,0.0,295,280
22401201,2,115,-3.0,-1.5652173913043477,274,159
22401201,2,146,0.0,0.0,154,8
22401201,3,107,-4.0,-2.2429906542056073,720,613
22401201,3,179,4.0,1.340782122905028,607,428
22401201,3,75,0.0,0.0,287,212
22401201,3,109,7.0,3.853211009174312,212,103
22401201,3,32,0.0,0.0,87,55
22401201,3,47,0.0,0.0,47,0
22401201,4,263,-7.0,-1.5969581749049429,720,457
22401201,4,133,4.0,1.8045112781954886,436,303
22401201,4,182,-5.0,-1.6483516483516483,303,121
22401201,4,112,1.0,0.5357142857142857,121,9
22401201,4,1,0.0,0.0,6,5
22401201,4,2,2.0,60.0,2,0
22401202,1,341,2.0,0.3519061583577713,720,379
22401202,1,45,0.0,0.0,368,323
22401202,1,214,2.0,0.5607476635514018,323,109
22401202,2,57,-1.0,-1.0526315789473684,720,663
22401202,2,86,0.0,0.0,663,577
22401202,2,47,4.0,5.1063829787234045,556,509
22401202,2,73,0.0,0.0,494,421
22401202,2,12,2.0,10.0,400,388
22401202,2,47,3.0,3.829787234042553,388,341
22401202,2,322,-2.0,-0.37267080745341613,322,0
22401202,3,249,-5.0,-1.2048192771084336,720,471
22401202,3,129,-6.0,-2.7906976744186047,454,325
22401202,3,150,-5.0,-2.0,318,168
22401202,3,9,0.0,0.0,151,142
22401202,4,114,-1.0,-0.5263157894736842,720,606
22401202,4,59,0.0,0.0,606,547
22401202,4,132,2.0,0.9090909090909092,544,412
22401202,4,97,1.0,0.6185567010309279,406,309
22401202,4,267,4.0,0.898876404494382,290,23
22401202,4,23,-1.0,-2.608695652173913,23,0
22401203,1,234,2.0,0.5128205128205129,720,486
22401203,1,179,-2.0,-0.670391061452514,486,307
22401203,1,41,2.0,2.926829268292683,298,257
22401203,1,43,2.0,2.7906976744186047,251,208
22401203,1,27,0.0,0.0,198,171
22401203,1,77,4.0,3.116883116883117,162,85
22401203,1,82,4.0,2.926829268292683,85,3
22401203,2,230,-5.0,-1.3043478260869565,720,490
22401203,2,13,1.0,4.615384615384616,490,477
22401203,2,66,0.0,0.0,477,411
22401203,2,30,2.0,4.0,407,377
22401203,2,88,0.0,0.0,377,289
22401203,2,89,1.0,0.6741573033707865,289,200
22401203,2,161,-3.0,-1.1180124223602486,184,23
22401203,2,6,0.0,0.0,6,0
22401203,3,200,4.0,1.2,720,520
22401203,3,41,2.0,2.926829268292683,509,468
22401203,3,92,4.0,2.608695652173913,450,358
22401203,3,98,1.0,0.6122448979591836,350,252
22401203,3,124,-2.0,-0.967741935483871,239,115
22401203,3,84,1.0,0.7142857142857142,108,24
22401203,3,24,3.0,7.5,24,0
22401203,4,185,-7.0,-2.27027027027027,720,535
22401203,4,89,-3.0,-2.0224719101123596,523,434
22401203,4,71,4.0,3.380281690140845,385,314
22401203,4,253,-7.0,-1.6600790513833992,308,55
22401203,4,266,2.0,0.45112781954887216,266,0
22401204,1,285,0.0,0.0,720,435
22401204,1,80,2.0,1.5,421,341
22401204,1,212,2.0,0.5660377358490566,341,129
22401204,1,102,0.0,0.0,123,21
22401204,1,6,-1.0,-10.0,6,0
22401204,2,106,5.0,2.8301886792452833,720,614
22401204,2,149,0.0,0.0,614,465
22401204,2,4,0.0,0.0,453,449
22401204,2,43,2.0,2.7906976744186047,444,401
22401204,2,67,-2.0,-1.791044776119403,389,322
22401204,2,52,4.0,4.615384615384616,306,254
22401204,2,43,-2.0,-2.7906976744186047,243,200
22401204,2,57,-2.0,-2.1052631578947367,200,143
22401204,3,371,-5.0,-0.8086253369272237,720,349
22401204,3,115,-1.0,-0.5217391304347826,349,234
22401204,3,155,0.0,0.0,234,79
22401204,3,69,3.0,2.608695652173913,69,0
22401204,4,141,-3.0,-1.2765957446808511,720,579
22401204,4,83,3.0,2.1686746987951806,565,482
22401204,4,49,0.0,0.0,459,410
22401204,4,38,-3.0,-4.7368421052631575,393,355
22401204,4,75,0.0,0.0,341,266
22401204,4,330,-1.0,-0.18181818181818182,519,189
22401204,4,45,-1.0,-1.3333333333333335,184,139
22401204,4,27,0.0,0.0,126,99
22401204,4,7,3.0,25.71428571428571,82,75
22401204,4,16,0.0,0.0,48,32
22401204,4,24,0.0,0.0,27,3
22401204,4,2,0.0,0.0,2,0
22401205,1,370,-1.0,-0.16216216216216217,720,350
22401205,1,85,-3.0,-2.1176470588235294,338,253
22401205,1,25,2.0,4.8,242,217
22401205,1,12,2.0,10.0,200,188
22401205,1,23,0.0,0.0,188,165
22401205,1,121,7.0,3.4710743801652892,158,37
22401205,1,37,2.0,3.2432432432432434,37,0
22401205,2,44,-3.0,-4.090909090909091,720,676
22401205,2,183,-1.0,-0.32786885245901637,676,493
22401205,2,127,1.0,0.47244094488188976,484,357
22401205,2,99,8.0,4.848484848484849,357,258
22401205,2,201,3.0,0.8955223880597015,240,39
22401205,2,27,0.0,0.0,27,0
22401205,3,318,6.0,1.1320754716981132,720,402
22401205,3,99,0.0,0.0,402,303
22401205,3,80,2.0,1.5,296,216
22401205,3,142,7.0,2.957746478873239,201,59
22401205,3,53,-2.0,-2.2641509433962264,53,0
22401205,4,210,-1.0,-0.28571428571428575,720,510
22401205,4,53,0.0,0.0,499,446
22401205,4,45,6.0,8.0,437,392
22401205,4,145,0.0,0.0,378,233
22401205,4,233,-3.0,-0.7725321888412017,233,0
22401206,1,121,-5.0,-2.479338842975207,720,599
22401206,1,236,-7.0,-1.7796610169491527,597,361
22401206,1,102,1.0,0.5882352941176471,345,243
22401206,1,63,2.0,1.9047619047619047,237,174
22401206,1,58,2.0,2.0689655172413794,174,116
22401206,2,172,-8.0,-2.7906976744186047,720,548
22401206,2,31,-3.0,-5.806451612903226,548,517
22401206,2,126,5.0,2.380952380952381,500,374
22401206,2,42,1.0,1.4285714285714284,368,326
22401206,2,33,3.0,5.454545454545455,326,293
22401206,2,152,0.0,0.0,276,124
22401206,2,32,0.0,0.0,124,92
22401206,2,79,10.0,7.59493670886076,79,0
22401206,3,296,5.0,1.0135135135135136,720,424
22401206,3,59,-2.0,-2.0338983050847457,413,354
22401206,3,21,0.0,0.0,354,333
22401206,3,124,-2.0,-0.967741935483871,331,207
22401206,3,21,0.0,0.0,207,186
22401206,3,12,0.0,0.0,171,159
22401206,3,96,2.0,1.25,150,54
22401206,3,21,1.0,2.8571428571428568,54,33
22401206,3,33,0.0,0.0,33,0
22401206,4,195,5.0,1.5384615384615383,720,525
22401206,4,89,2.0,1.348314606741573,525,436
22401206,4,196,-8.0,-2.4489795918367343,427,231
22401206,4,65,2.0,1.8461538461538463,214,149
22401206,4,70,-1.0,-0.8571428571428571,149,79
22401206,4,75,-4.0,-3.2,75,0
22401207,1,390,-11.0,-1.6923076923076923,720,330
22401207,1,125,5.0,2.4,330,205
22401207,1,51,0.0,0.0,205,154
22401207,1,154,1.0,0.38961038961038963,154,0
22401207,2,81,6.0,4.444444444444445,720,639
22401207,2,86,3.0,2.0930232558139537,626,540
22401207,2,79,-3.0,-2.278481012658228,531,452
22401207,2,221,-2.0,-0.5429864253393666,641,420
22401207,2,77,3.0,2.3376623376623376,420,343
22401207,2,92,0.0,0.0,335,243
22401207,2,12,0.0,0.0,221,209
22401207,2,41,1.0,1.4634146341463414,202,161
22401207,2,92,0.0,0.0,161,69
22401207,2,68,-2.0,-1.7647058823529411,68,0
22401207,3,351,-5.0,-0.8547008547008548,720,369
22401207,3,31,-1.0,-1.935483870967742,356,325
22401207,3,130,-6.0,-2.769230769230769,325,195
22401207,3,8,0.0,0.0,178,170
22401207,3,12,0.0,0.0,163,151
22401207,4,153,-1.0,-0.39215686274509803,720,567
22401207,4,39,-2.0,-3.0769230769230766,567,528
22401207,4,83,0.0,0.0,516,433
22401207,4,39,0.0,0.0,421,382
22401207,4,43,1.0,1.3953488372093024,382,339
22401207,4,322,11.0,2.049689440993789,323,1
22401208,1,290,-2.0,-0.41379310344827586,720,430
22401208,1,67,0.0,0.0,408,341
22401208,1,24,0.0,0.0,341,317
22401208,1,34,1.0,1.7647058823529411,295,261
22401208,1,55,-3.0,-3.2727272727272725,240,185
22401208,1,54,-3.0,-3.333333333333333,185,131
22401208,1,98,6.0,3.673469387755102,126,28
22401208,2,185,-2.0,-0.6486486486486487,720,535
22401208,2,28,0.0,0.0,529,501
22401208,2,13,1.0,4.615384615384616,490,477
22401208,2,30,3.0,6.0,477,447
22401208,2,116,-2.0,-1.0344827586206897,447,331
22401208,2,23,1.0,2.608695652173913,322,299
22401208,2,89,9.0,6.067415730337078,299,210
22401208,2,89,0.0,0.0,210,121
22401208,2,121,-8.0,-3.9669421487603307,121,0
22401208,3,23,0.0,0.0,720,697
22401208,3,236,0.0,0.0,686,450
22401208,3,43,1.0,1.3953488372093024,450,407
22401208,3,141,-2.0,-0.851063829787234,400,259
22401208,3,58,1.0,1.0344827586206897,242,184
22401208,3,182,4.0,1.3186813186813189,182,0
22401208,4,128,1.0,0.46875,720,592
22401208,4,75,-1.0,-0.8,581,506
22401208,4,24,1.0,2.5,495,471
22401208,4,25,2.0,4.8,471,446
22401208,4,62,-6.0,-5.806451612903226,431,369
22401208,4,60,0.0,0.0,351,291
22401208,4,254,5.0,1.1811023622047243,281,27
22401208,4,19,-2.0,-6.315789473684211,19,0
22401209,1,384,-6.0,-0.9375,720,336
22401209,1,89,0.0,0.0,336,247
22401209,1,96,1.0,0.625,227,131
22401209,1,51,-2.0,-2.3529411764705883,120,69
22401209,1,69,-2.0,-1.7391304347826086,69,0
22401209,2,255,1.0,0.23529411764705882,720,465
22401209,2,68,2.0,1.7647058823529411,465,397
22401209,2,12,1.0,5.0,390,378
22401209,2,89,-4.0,-2.696629213483146,378,289
22401209,2,100,-5.0,-3.0,289,189
22401209,2,163,0.0,0.0,169,6
22401209,3,153,0.0,0.0,720,567
22401209,3,119,-3.0,-1.5126050420168067,567,448
22401209,3,90,-2.0,-1.3333333333333335,432,342
22401209,3,16,1.0,3.75,324,308
22401209,3,32,-3.0,-5.625,298,266
22401209,3,123,4.0,1.9512195121951221,247,124
22401209,3,50,3.0,3.5999999999999996,115,65
22401209,3,65,1.0,0.9230769230769231,65,0
22401209,4,130,2.0,0.9230769230769231,720,590
22401209,4,138,-4.0,-1.7391304347826086,590,452
22401209,4,1,0.0,0.0,436,435
22401209,4,148,-2.0,-0.8108108108108109,419,271
22401209,4,143,-12.0,-5.034965034965035,271,128
22401209,4,113,3.0,1.592920353982301,113,0
22401210,1,356,3.0,0.5056179775280899,720,364
22401210,1,103,-1.0,-0.5825242718446602,356,253
22401210,1,18,3.0,10.0,237,219
22401210,1,66,4.0,3.6363636363636367,219,153
22401210,1,29,2.0,4.137931034482759,153,124
22401210,1,109,-4.0,-2.2018348623853212,109,0
22401210,2,154,-3.0,-1.1688311688311688,720,566
22401210,2,90,-4.0,-2.666666666666667,566,476
22401210,2,82,2.0,1.4634146341463414,457,375
22401210,2,103,0.0,0.0,375,272
22401210,2,53,0.0,0.0,253,200
22401210,2,131,4.0,1.83206106870229,177,46
22401210,2,46,-3.0,-3.9130434782608696,46,0
22401210,3,290,4.0,0.8275862068965517,720,430
22401210,3,60,2.0,2.0,414,354
22401210,3,140,3.0,1.2857142857142858,344,204
22401210,3,38,-2.0,-3.1578947368421053,190,152
22401210,3,17,0.0,0.0,152,135
22401210,3,129,-2.0,-0.9302325581395349,129,0
22401210,4,131,-3.0,-1.3740458015267176,720,589
22401210,4,27,-3.0,-6.666666666666666,582,555
22401210,4,119,3.0,1.5126050420168067,532,413
22401210,4,36,0.0,0.0,397,361
22401210,4,131,0.0,0.0,352,221
22401210,4,131,5.0,2.290076335877863,215,84
22401210,4,26,3.0,6.923076923076923,81,55
22401210,4,24,0.0,0.0,55,31
22401210,4,18,0.0,0.0,18,0
22401211,1,309,-1.0,-0.1941747572815534,720,411
22401211,1,63,4.0,3.8095238095238093,402,339
22401211,1,45,0.0,0.0,324,279
22401211,1,65,4.0,3.6923076923076925,266,201
22401211,1,450,-4.0,-0.5333333333333333,582,132
22401211,1,132,1.0,0.4545454545454546,132,0
22401211,2,135,1.0,0.4444444444444445,720,585
22401211,2,21,0.0,0.0,572,551
22401211,2,46,0.0,0.0,544,498
22401211,2,36,2.0,3.333333333333333,482,446
22401211,2,62,-3.0,-2.903225806451613,437,375
22401211,2,14,2.0,8.571428571428571,371,357
22401211,2,21,0.0,0.0,337,316
22401211,2,51,0.0,0.0,316,265
22401211,2,58,-2.0,-2.0689655172413794,265,207
22401211,2,37,4.0,6.486486486486487,207,170
22401211,3,326,2.0,0.36809815950920244,720,394
22401211,3,41,-1.0,-1.4634146341463414,385,344
22401211,3,30,3.0,6.0,344,314
22401211,3,16,-2.0,-7.5,301,285
22401211,3,86,-4.0,-2.7906976744186047,285,199
22401211,3,82,-3.0,-2.195121951219512,199,117
22401211,3,104,5.0,2.8846153846153846,104,0
22401211,4,123,1.0,0.48780487804878053,720,597
22401211,4,75,0.0,0.0,584,509
22401211,4,25,0.0,0.0,491,466
22401211,4,21,0.0,0.0,458,437
22401211,4,14,0.0,0.0,437,423
22401211,4,102,-4.0,-2.3529411764705883,415,313
22401211,4,7,0.0,0.0,301,294
22401211,4,42,0.0,0.0,283,241
22401211,4,71,5.0,4.225352112676057,227,156
22401211,4,61,3.0,2.9508196721311473,132,71
22401211,4,71,-3.0,-2.535211267605634,71,0
22401212,1,308,11.0,2.142857142857143,720,412
22401212,1,85,-2.0,-1.4117647058823528,412,327
22401212,1,121,1.0,0.49586776859504134,318,197
22401212,1,34,2.0,3.5294117647058822,173,139
22401212,1,48,0.0,0.0,124,76
22401212,1,62,-5.0,-4.838709677419355,66,4
22401212,1,2,0.0,0.0,2,0
22401212,2,59,0.0,0.0,720,661
22401212,2,68,0.0,0.0,646,578
22401212,2,69,-2.0,-1.7391304347826086,578,509
22401212,2,44,2.0,2.7272727272727275,486,442
22401212,2,32,1.0,1.875,427,395
22401212,2,101,2.0,1.188118811881188,365,264
22401212,2,68,3.0,2.647058823529412,251,183
22401212,2,35,0.0,0.0,165,130
22401212,2,28,2.0,4.285714285714286,125,97
22401212,2,78,1.0,0.7692307692307692,78,0
22401212,3,260,-5.0,-1.153846153846154,720,460
22401212,3,21,0.0,0.0,459,438
22401212,3,15,1.0,4.0,428,413
22401212,3,30,0.0,0.0,413,383
22401212,3,79,-1.0,-0.7594936708860759,377,298
22401212,3,100,0.0,0.0,277,177
22401212,3,89,5.0,3.3707865168539324,156,67
22401212,4,213,-3.0,-0.8450704225352113,720,507
22401212,4,50,-1.0,-1.2,483,433
22401212,4,15,1.0,4.0,433,418
22401212,4,65,3.0,2.769230769230769,418,353
22401212,4,134,-1.0,-0.44776119402985076,353,219
22401212,4,80,2.0,1.5,219,139
22401212,4,66,-2.0,-1.8181818181818183,123,57
22401212,4,57,2.0,2.1052631578947367,57,0
22401213,1,370,9.0,1.4594594594594597,720,350
22401213,1,80,-1.0,-0.75,342,262
22401213,1,58,-2.0,-2.0689655172413794,259,201
22401213,1,52,0.0,0.0,201,149
22401213,1,83,2.0,1.4457831325301205,149,66
22401213,2,108,5.0,2.7777777777777777,720,612
22401213,2,93,0.0,0.0,612,519
22401213,2,12,-1.0,-5.0,513,501
22401213,2,185,-8.0,-2.5945945945945947,487,302
22401213,2,69,-3.0,-2.608695652173913,285,216
22401213,2,25,-1.0,-2.4,162,137
22401213,2,135,7.0,3.111111111111111,137,2
22401213,2,2,0.0,0.0,2,0
22401213,3,358,2.0,0.335195530726257,720,362
22401213,3,35,0.0,0.0,362,327
22401213,3,63,4.0,3.8095238095238093,322,259
22401213,3,57,0.0,0.0,251,194
22401213,3,94,2.0,1.2765957446808511,194,100
22401213,3,92,0.0,0.0,100,8
22401213,3,1,0.0,0.0,1,0
22401213,4,177,4.0,1.3559322033898304,720,543
22401213,4,91,4.0,2.6373626373626378,537,446
22401213,4,92,-2.0,-1.3043478260869565,430,338
22401213,4,46,2.0,2.608695652173913,327,281
22401213,4,19,1.0,3.1578947368421053,268,249
22401213,4,32,0.0,0.0,249,217
22401213,4,200,-3.0,-0.8999999999999999,200,0
22401214,1,328,7.0,1.2804878048780488,720,392
22401214,1,72,3.0,2.5,378,306
22401214,1,39,-3.0,-4.615384615384616,306,267
22401214,1,87,0.0,0.0,260,173
22401214,1,163,0.0,0.0,163,0
22401214,2,161,5.0,1.8633540372670807,720,559
22401214,2,64,-2.0,-1.875,541,477
22401214,2,94,-2.0,-1.2765957446808511,476,382
22401214,2,34,-2.0,-3.5294117647058822,370,336
22401214,2,29,-5.0,-10.344827586206897,312,283
22401214,2,48,0.0,0.0,210,162
22401214,2,57,-1.0,-1.0526315789473684,151,94
22401214,2,19,1.0,3.1578947368421053,94,75
22401214,2,75,1.0,0.8,75,0
22401214,3,352,-3.0,-0.5113636363636364,720,368
22401214,3,88,3.0,2.0454545454545454,368,280
22401214,3,20,2.0,6.0,268,248
22401214,3,89,-1.0,-0.6741573033707865,235,146
22401214,3,87,-1.0,-0.6896551724137931,140,53
22401214,3,40,-1.0,-1.5,40,0
22401214,4,122,3.0,1.4754098360655736,720,598
22401214,4,136,0.0,0.0,590,454
22401214,4,37,0.0,0.0,451,414
22401214,4,61,0.0,0.0,392,331
22401214,4,16,0.0,0.0,323,307
22401214,4,52,2.0,2.307692307692308,296,244
22401214,4,89,1.0,0.6741573033707865,237,148
22401214,4,148,-3.0,-1.2162162162162162,148,0
22401215,1,174,3.0,1.0344827586206897,720,546
22401215,1,39,-2.0,-3.0769230769230766,532,493
22401215,1,70,-4.0,-3.4285714285714284,482,412
22401215,1,11,-1.0,-5.454545454545455,395,384
22401215,1,87,0.0,0.0,384,297
22401215,1,57,-5.0,-5.263157894736842,263,206
22401215,1,127,0.0,0.0,190,63
22401215,1,45,2.0,2.666666666666667,48,3
22401215,2,156,-2.0,-0.7692307692307692,720,564
22401215,2,106,-2.0,-1.1320754716981132,564,458
22401215,2,57,4.0,4.2105263157894735,458,401
22401215,2,82,2.0,1.4634146341463414,377,295
22401215,2,49,0.0,0.0,275,226
22401215,2,37,-2.0,-3.2432432432432434,176,139
22401215,3,355,7.0,1.183098591549296,720,365
22401215,3,31,0.0,0.0,365,334
22401215,3,55,2.0,2.1818181818181817,317,262
22401215,3,87,3.0,2.0689655172413794,262,175
22401215,3,18,0.0,0.0,149,131
22401215,3,131,6.0,2.7480916030534353,131,0
22401215,4,152,6.0,2.3684210526315788,720,568
22401215,4,1,1.0,60.0,549,548
22401215,4,36,4.0,6.666666666666666,534,498
22401215,4,30,-3.0,-6.0,498,468
22401215,4,109,-5.0,-2.7522935779816518,454,345
22401215,4,113,-5.0,-2.6548672566371683,334,221
22401215,4,201,-5.0,-1.492537313432836,207,6
22401215,4,2,0.0,0.0,2,0
22401216,1,296,1.0,0.20270270270270271,720,424
22401216,1,17,0.0,0.0,424,407
22401216,1,66,4.0,3.6363636363636367,396,330
22401216,1,16,0.0,0.0,330,314
22401216,1,21,-1.0,-2.8571428571428568,308,287
22401216,1,95,1.0,0.631578947368421,287,192
22401216,1,27,1.0,2.2222222222222223,183,156
22401216,1,87,0.0,0.0,139,52
22401216,1,34,-2.0,-3.5294117647058822,34,0
22401216,2,58,2.0,2.0689655172413794,720,662
22401216,2,150,0.0,0.0,641,491
22401216,2,1,0.0,0.0,483,482
22401216,2,30,0.0,0.0,462,432
22401216,2,29,1.0,2.0689655172413794,424,395
22401216,2,34,3.0,5.294117647058824,395,361
22401216,2,19,2.0,6.315789473684211,351,332
22401216,2,69,-6.0,-5.217391304347826,324,255
22401216,2,86,0.0,0.0,245,159
22401216,2,12,1.0,5.0,144,132
22401216,2,132,5.0,2.272727272727273,132,0
22401216,3,357,2.0,0.33613445378151263,720,363
22401216,3,28,0.0,0.0,363,335
22401216,3,27,0.0,0.0,335,308
22401216,3,94,2.0,1.2765957446808511,308,214
22401216,3,140,0.0,0.0,208,68
22401216,3,68,3.0,2.647058823529412,68,0
22401216,4,56,3.0,3.214285714285714,720,664
22401216,4,142,-4.0,-1.6901408450704225,654,512
22401216,4,133,-3.0,-1.3533834586466165,500,367
22401216,4,27,0.0,0.0,367,340
22401216,4,129,-1.0,-0.46511627906976744,340,211
22401216,4,106,-1.0,-0.5660377358490566,211,105
22401216,4,7,1.0,8.571428571428571,105,98
22401217,1,309,-1.0,-0.1941747572815534,720,411
22401217,1,118,-5.0,-2.542372881355932,389,271
22401217,1,82,0.0,0.0,267,185
22401217,1,42,2.0,2.8571428571428568,171,129
22401217,1,111,-8.0,-4.324324324324325,111,0
22401217,2,235,-6.0,-1.5319148936170213,720,485
22401217,2,99,-4.0,-2.4242424242424243,471,372
22401217,2,158,2.0,0.7594936708860759,366,208
22401217,2,63,4.0,3.8095238095238093,202,139
22401217,3,72,-2.0,-1.6666666666666665,720,648
22401217,3,145,4.0,1.6551724137931034,643,498
22401217,3,201,0.0,0.0,498,297
22401217,3,11,0.0,0.0,282,271
22401217,3,115,-4.0,-2.0869565217391304,271,156
22401217,3,144,-3.0,-1.25,144,0
22401217,4,283,0.0,0.0,720,437
22401217,4,52,0.0,0.0,426,374
22401217,4,135,4.0,1.777777777777778,358,223
22401217,4,66,-4.0,-3.6363636363636367,208,142
22401217,4,98,5.0,3.0612244897959187,131,33
22401217,4,21,-1.0,-2.8571428571428568,21,0
22401218,1,382,4.0,0.6282722513089005,720,338
22401218,1,105,-4.0,-2.285714285714286,338,233
22401218,1,90,-3.0,-2.0,201,111
22401218,1,97,-2.0,-1.2371134020618557,97,0
22401218,2,253,-1.0,-0.23715415019762845,720,467
22401218,2,10,0.0,0.0,467,457
22401218,2,6,-3.0,-30.0,452,446
22401218,2,36,2.0,3.333333333333333,433,397
22401218,2,50,4.0,4.8,382,332
22401218,2,105,-2.0,-1.142857142857143,323,218
22401218,2,33,1.0,1.8181818181818183,206,173
22401218,2,114,1.0,0.5263157894736842,162,48
22401218,2,48,-3.0,-3.75,48,0
22401218,3,343,11.0,1.924198250728863,720,377
22401218,3,39,0.0,0.0,377,338
22401218,3,28,0.0,0.0,331,303
22401218,3,111,-1.0,-0.5405405405405406,279,168
22401218,3,23,-1.0,-2.608695652173913,150,127
22401218,3,283,3.0,0.6360424028268552,493,210
22401218,4,143,-2.0,-0.8391608391608392,720,577
22401218,4,8,0.0,0.0,561,553
22401218,4,38,-2.0,-3.1578947368421053,542,504
22401218,4,92,-4.0,-2.608695652173913,489,397
22401218,4,49,0.0,0.0,381,332
22401218,4,23,0.0,0.0,321,298
22401218,4,118,-7.0,-3.5593220338983054,298,180
22401218,4,164,5.0,1.8292682926829267,164,0
22401219,1,253,3.0,0.7114624505928854,720,467
22401219,1,119,0.0,0.0,453,334
22401219,1,46,0.0,0.0,320,274
22401219,1,52,-1.0,-1.153846153846154,259,207
22401219,1,169,6.0,2.1301775147928996,188,19
22401219,1,10,3.0,18.0,10,0
22401219,2,118,1.0,0.5084745762711864,720,602
22401219,2,45,-5.0,-6.666666666666666,600,555
22401219,2,91,-4.0,-2.6373626373626378,555,464
22401219,2,96,5.0,3.125,454,358
22401219,2,207,-1.0,-0.2898550724637681,338,131
22401219,2,96,2.0,1.25,131,35
22401219,2,15,0.0,0.0,15,0
22401219,3,295,-9.0,-1.8305084745762712,720,425
22401219,3,26,0.0,0.0,409,383
22401219,3,127,1.0,0.47244094488188976,383,256
22401219,3,21,3.0,8.571428571428571,256,235
22401219,3,1,0.0,0.0,224,223
22401219,3,33,0.0,0.0,210,177
22401219,3,38,-2.0,-3.1578947368421053,177,139
22401219,3,128,3.0,1.40625,128,0
22401219,4,62,0.0,0.0,720,658
22401219,4,74,2.0,1.6216216216216217,652,578
22401219,4,62,4.0,3.870967741935484,578,516
22401219,4,20,2.0,6.0,504,484
22401219,4,97,2.0,1.2371134020618557,471,374
22401219,4,136,0.0,0.0,367,231
22401219,4,25,-3.0,-7.199999999999999,217,192
22401219,4,177,-6.0,-2.0338983050847457,183,6
22401219,4,1,0.0,0.0,1,0
22401220,1,179,5.0,1.6759776536312847,720,541
22401220,1,120,-2.0,-1.0,527,407
22401220,1,50,5.0,6.0,392,342
22401220,1,36,-1.0,-1.6666666666666665,334,298
22401220,1,85,2.0,1.4117647058823528,298,213
22401220,1,30,3.0,6.0,200,170
22401220,1,42,0.0,0.0,161,119
22401220,1,26,-1.0,-2.307692307692308,100,74
22401220,2,150,-2.0,-0.8,720,570
22401220,2,75,-1.0,-0.8,561,486
22401220,2,32,3.0,5.625,486,454
22401220,2,28,4.0,8.571428571428571,449,421
22401220,2,76,0.0,0.0,412,336
22401220,2,38,2.0,3.1578947368421053,327,289
22401220,2,37,-1.0,-1.6216216216216217,275,238
22401220,2,58,0.0,0.0,238,180
22401220,2,32,2.0,3.75,180,148
22401220,2,97,0.0,0.0,136,39
22401220,2,30,-2.0,-4.0,30,0
22401220,3,314,1.0,0.1910828025477707,720,406
22401220,3,24,2.0,5.0,406,382
22401220,3,52,-3.0,-3.4615384615384617,382,330
22401220,3,45,0.0,0.0,323,278
22401220,3,63,3.0,2.8571428571428568,265,202
22401220,3,202,-10.0,-2.9702970297029703,202,0
22401220,4,111,2.0,1.0810810810810811,720,609
22401220,4,27,0.0,0.0,586,559
22401220,4,61,-1.0,-0.9836065573770493,559,498
22401220,4,29,2.0,4.137931034482759,493,464
22401220,4,60,-1.0,-1.0,454,394
22401220,4,48,-4.0,-5.0,394,346
22401220,4,78,0.0,0.0,330,252
22401220,4,252,-4.0,-0.9523809523809523,252,0
22401221,1,167,5.0,1.7964071856287425,720,553
22401221,1,123,7.0,3.4146341463414633,553,430
22401221,1,134,-7.0,-3.134328358208955,405,271
22401221,1,1,0.0,0.0,271,270
22401221,1,56,-1.0,-1.0714285714285714,254,198
22401221,1,175,0.0,0.0,186,11
22401221,1,4,0.0,0.0,4,0
22401221,2,170,9.0,3.176470588235294,720,550
22401221,2,6,0.0,0.0,550,544
22401221,2,6,-2.0,-20.0,532,526
22401221,2,91,5.0,3.2967032967032965,526,435
22401221,2,34,0.0,0.0,435,401
22401221,2,53,-3.0,-3.3962264150943398,390,337
22401221,2,38,-2.0,-3.1578947368421053,330,292
22401221,2,26,-1.0,-2.307692307692308,281,255
22401221,2,44,3.0,4.090909090909091,255,211
22401221,2,12,0.0,0.0,211,199
22401221,2,69,-4.0,-3.4782608695652173,184,115
22401221,2,18,1.0,3.333333333333333,107,89
22401221,2,86,-1.0,-0.6976744186046512,89,3
22401221,2,3,0.0,0.0,3,0
22401221,3,54,4.0,4.444444444444445,720,666
22401221,3,58,5.0,5.172413793103448,648,590
22401221,3,132,2.0,0.9090909090909092,566,434
22401221,3,26,0.0,0.0,410,384
22401221,3,44,0.0,0.0,384,340
22401221,3,123,2.0,0.9756097560975611,340,217
22401221,3,77,-1.0,-0.7792207792207793,213,136
22401221,3,136,-1.0,-0.4411764705882353,136,0
22401221,4,89,-4.0,-2.696629213483146,720,631
22401221,4,73,1.0,0.821917808219178,622,549
22401221,4,64,2.0,1.875,549,485
22401221,4,80,-2.0,-1.5,485,405
22401221,4,74,-1.0,-0.8108108108108109,402,328
22401221,4,48,-1.0,-1.25,311,263
22401221,4,65,0.0,0.0,263,198
22401221,4,54,-5.0,-5.555555555555555,198,144
22401221,4,110,-4.0,-2.1818181818181817,121,11
22401221,4,5,0.0,0.0,5,0
22401221,5,131,-4.0,-1.83206106870229,300,169
22401221,5,140,7.0,3.0,155,15
22401221,5,6,0.0,0.0,15,9
22401221,5,7,0.0,0.0,7,0
22401222,1,354,-2.0,-0.3389830508474576,720,366
22401222,1,32,0.0,0.0,366,334
22401222,1,48,-3.0,-3.75,323,275
22401222,1,61,4.0,3.934426229508197,247,186
22401222,1,100,-5.0,-3.0,167,67
22401222,1,53,-1.0,-1.1320754716981132,53,0
22401222,2,123,1.0,0.48780487804878053,720,597
22401222,2,45,0.0,0.0,597,552
22401222,2,104,-2.0,-1.153846153846154,538,434
22401222,2,60,0.0,0.0,434,374
22401222,2,167,5.0,1.7964071856287425,363,196
22401222,2,73,-3.0,-2.4657534246575343,171,98
22401222,2,88,3.0,2.0454545454545454,98,10
22401222,3,260,-2.0,-0.46153846153846156,720,460
22401222,3,129,-5.0,-2.3255813953488373,460,331
22401222,3,76,1.0,0.7894736842105263,317,241
22401222,3,71,-4.0,-3.380281690140845,228,157
22401222,3,157,3.0,1.1464968152866242,157,0
22401222,4,138,7.0,3.0434782608695654,720,582
22401222,4,43,3.0,4.186046511627907,578,535
22401222,4,19,2.0,6.315789473684211,519,500
22401222,4,37,2.0,3.2432432432432434,489,452
22401222,4,44,0.0,0.0,441,397
22401222,4,80,-3.0,-2.25,397,317
22401222,4,119,-2.0,-1.0084033613445378,306,187
22401222,4,100,3.0,1.7999999999999998,175,75
22401222,4,31,2.0,3.870967741935484,65,34
22401223,1,224,-6.0,-1.607142857142857,720,496
22401223,1,79,0.0,0.0,487,408
22401223,1,19,1.0,3.1578947368421053,406,387
22401223,1,116,-7.0,-3.620689655172414,387,271
22401223,1,67,-2.0,-1.791044776119403,271,204
22401223,1,97,-1.0,-0.6185567010309279,189,92
22401223,2,72,4.0,3.333333333333333,720,648
22401223,2,82,-2.0,-1.4634146341463414,633,551
22401223,2,52,2.0,2.307692307692308,532,480
22401223,2,46,0.0,0.0,459,413
22401223,2,78,1.0,0.7692307692307692,410,332
22401223,2,83,-2.0,-1.4457831325301205,319,236
22401223,2,48,-2.0,-2.5,236,188
22401223,2,85,4.0,2.8235294117647056,181,96
22401223,2,40,1.0,1.5,85,45
22401223,2,45,1.0,1.3333333333333335,45,0
22401223,3,257,-4.0,-0.933852140077821,720,463
22401223,3,29,2.0,4.137931034482759,463,434
22401223,3,25,-2.0,-4.8,427,402
22401223,3,27,-3.0,-6.666666666666666,393,366
22401223,3,67,0.0,0.0,356,289
22401223,3,84,0.0,0.0,289,205
22401223,3,14,0.0,0.0,193,179
22401223,3,65,-3.0,-2.769230769230769,168,103
22401223,3,77,1.0,0.7792207792207793,103,26
22401223,3,26,2.0,4.615384615384616,26,0
22401223,4,65,-4.0,-3.6923076923076925,720,655
22401223,4,43,0.0,0.0,655,612
22401223,4,78,-2.0,-1.5384615384615383,598,520
22401223,4,23,0.0,0.0,513,490
22401223,4,45,3.0,4.0,490,445
22401223,4,42,2.0,2.8571428571428568,437,395
22401223,4,260,5.0,1.153846153846154,395,135
22401223,4,131,0.0,0.0,135,4
22401224,1,291,0.0,0.0,720,429
22401224,1,38,-2.0,-3.1578947368421053,429,391
22401224,1,166,-10.0,-3.6144578313253013,391,225
22401224,1,6,-3.0,-30.0,225,219
22401224,1,204,-8.0,-2.3529411764705883,204,0
22401224,2,44,1.0,1.3636363636363638,720,676
22401224,2,79,-1.0,-0.7594936708860759,676,597
22401224,2,52,0.0,0.0,588,536
22401224,2,29,-3.0,-6.206896551724138,529,500
22401224,2,6,-1.0,-10.0,476,470
22401224,2,64,-2.0,-1.875,470,406
22401224,2,154,-2.0,-0.7792207792207793,392,238
22401224,2,57,3.0,3.1578947368421053,228,171
22401224,2,103,-4.0,-2.3300970873786406,242,139
22401224,2,90,0.0,0.0,139,49
22401224,2,30,0.0,0.0,30,0
22401224,3,250,-2.0,-0.48,720,470
22401224,3,34,2.0,3.5294117647058822,458,424
22401224,3,41,-2.0,-2.926829268292683,413,372
22401224,3,126,8.0,3.8095238095238093,372,246
22401224,3,36,-2.0,-3.333333333333333,237,201
22401224,3,201,-3.0,-0.8955223880597015,201,0
22401224,4,122,-3.0,-1.4754098360655736,720,598
22401224,4,96,3.0,1.875,576,480
22401224,4,47,-5.0,-6.382978723404255,480,433
22401224,4,94,-2.0,-1.2765957446808511,417,323
22401224,4,66,1.0,0.9090909090909092,318,252
22401224,4,33,3.0,5.454545454545455,252,219
22401224,4,43,0.0,0.0,219,176
22401224,4,176,7.0,2.3863636363636362,176,0
22401225,1,251,-10.0,-2.3904382470119523,720,469
22401225,1,145,-3.0,-1.2413793103448276,456,311
22401225,1,20,-1.0,-3.0,307,287
22401225,1,18,0.0,0.0,287,269
22401225,1,87,0.0,0.0,263,176
22401225,1,16,0.0,0.0,176,160
22401225,1,117,1.0,0.5128205128205129,154,37
22401225,1,10,-2.0,-12.0,33,23
22401225,1,15,0.0,0.0,23,8
22401225,2,184,0.0,0.0,720,536
22401225,2,54,3.0,3.333333333333333,523,469
22401225,2,21,0.0,0.0,469,448
22401225,2,53,0.0,0.0,433,380
22401225,2,32,9.0,16.875,379,347
22401225,2,102,-5.0,-2.941176470588235,271,169
22401225,2,157,4.0,1.5286624203821657,161,4
22401225,3,399,9.0,1.3533834586466165,720,321
22401225,3,97,3.0,1.8556701030927836,302,205
22401225,3,27,3.0,6.666666666666666,205,178
22401225,3,131,0.0,0.0,172,41
22401225,3,27,0.0,0.0,36,9
22401225,4,134,1.0,0.44776119402985076,720,586
22401225,4,37,2.0,3.2432432432432434,578,541
22401225,4,25,-3.0,-7.199999999999999,534,509
22401225,4,53,-3.0,-3.3962264150943398,509,456
22401225,4,30,1.0,2.0,440,410
22401225,4,40,-1.0,-1.5,410,370
22401225,4,41,3.0,4.390243902439024,370,329
22401225,4,17,2.0,7.0588235294117645,329,312
22401225,4,219,-9.0,-2.4657534246575343,294,75
22401225,4,44,0.0,0.0,64,20
22401225,4,1,0.0,0.0,1,0
22401226,1,315,11.0,2.0952380952380953,720,405
22401226,1,36,2.0,3.333333333333333,400,364
22401226,1,21,2.0,5.7142857142857135,350,329
22401226,1,30,0.0,0.0,329,299
22401226,1,58,0.0,0.0,289,231
22401226,1,231,0.0,0.0,231,0
22401226,2,169,5.0,1.7751479289940828,720,551
22401226,2,14,-1.0,-4.285714285714286,546,532
22401226,2,129,4.0,1.8604651162790697,532,403
22401226,2,374,3.0,0.4812834224598931,388,14
22401226,2,14,0.0,0.0,14,0
22401226,3,369,-2.0,-0.3252032520325203,720,351
22401226,3,144,2.0,0.8333333333333333,351,207
22401226,3,60,-1.0,-1.0,207,147
22401226,3,84,-1.0,-0.7142857142857142,147,63
22401226,3,44,3.0,4.090909090909091,44,0
22401226,4,149,6.0,2.4161073825503356,720,571
22401226,4,72,-4.0,-3.333333333333333,571,499
22401226,4,149,-2.0,-0.8053691275167785,499,350
22401226,4,10,0.0,0.0,350,340
22401226,4,332,0.0,0.0,332,0
22401227,1,234,1.0,0.25641025641025644,720,486
22401227,1,262,2.0,0.4580152671755725,475,213
22401227,1,16,-1.0,-3.75,197,181
22401227,1,19,0.0,0.0,181,162
22401227,1,139,-4.0,-1.7266187050359714,154,15
22401227,1,12,1.0,5.0,15,3
22401227,2,84,1.0,0.7142857142857142,720,636
22401227,2,93,-2.0,-1.2903225806451615,634,541
22401227,2,41,0.0,0.0,531,490
22401227,2,55,3.0,3.2727272727272725,488,433
22401227,2,130,-5.0,-2.307692307692308,425,295
22401227,2,19,3.0,9.473684210526315,285,266
22401227,2,118,-4.0,-2.0338983050847457,258,140
22401227,2,125,-3.0,-1.44,125,0
22401227,3,334,-2.0,-0.3592814371257485,720,386
22401227,3,63,1.0,0.9523809523809523,370,307
22401227,3,33,0.0,0.0,295,262
22401227,3,14,3.0,12.857142857142856,258,244
22401227,3,55,-1.0,-1.0909090909090908,226,171
22401227,3,34,-2.0,-3.5294117647058822,158,124
22401227,3,113,1.0,0.5309734513274336,113,0
22401227,4,106,1.0,0.5660377358490566,720,614
22401227,4,58,-1.0,-1.0344827586206897,606,548
22401227,4,66,-5.0,-4.545454545454546,522,456
22401227,4,163,-3.0,-1.1042944785276074,439,276
22401227,4,18,0.0,0.0,257,239
22401227,4,148,1.0,0.40540540540540543,239,91
22401228,1,262,-9.0,-2.0610687022900764,720,458
22401228,1,129,-3.0,-1.3953488372093024,458,329
22401228,1,10,-1.0,-6.0,322,312
22401228,1,135,4.0,1.777777777777778,312,177
22401228,1,133,1.0,0.45112781954887216,156,23
22401228,1,19,-3.0,-9.473684210526315,19,0
22401228,2,296,3.0,0.6081081081081081,720,424
22401228,2,31,0.0,0.0,407,376
22401228,2,116,2.0,1.0344827586206897,370,254
22401228,2,31,2.0,3.870967741935484,242,211
22401228,2,195,4.0,1.2307692307692308,202,7
22401228,2,7,0.0,0.0,7,0
22401228,3,252,-5.0,-1.1904761904761905,720,468
22401228,3,46,1.0,1.3043478260869565,458,412
22401228,3,16,0.0,0.0,412,396
22401228,3,11,0.0,0.0,396,385
22401228,3,23,-1.0,-2.608695652173913,373,350
22401228,3,87,-3.0,-2.0689655172413794,350,263
22401228,3,47,4.0,5.1063829787234045,263,216
22401228,3,70,-2.0,-1.7142857142857142,216,146
22401228,3,53,-2.0,-2.2641509433962264,146,93
22401228,3,71,6.0,5.070422535211268,71,0
22401228,4,59,3.0,3.050847457627119,720,661
22401228,4,36,-2.0,-3.333333333333333,661,625
22401228,4,90,-2.0,-1.3333333333333335,625,535
22401228,4,22,0.0,0.0,535,513
22401228,4,43,3.0,4.186046511627907,503,460
22401228,4,74,-5.0,-4.054054054054054,460,386
22401228,4,66,3.0,2.7272727272727275,386,320
22401228,4,255,0.0,0.0,318,63
22401228,4,17,-1.0,-3.5294117647058822,61,44
22401228,4,44,0.0,0.0,44,0
22401229,1,291,-1.0,-0.20618556701030927,720,429
22401229,1,80,2.0,1.5,429,349
22401229,1,44,-2.0,-2.7272727272727275,349,305
22401229,1,24,-2.0,-5.0,305,281
22401229,1,25,0.0,0.0,261,236
22401229,1,174,6.0,2.0689655172413794,225,51
22401229,1,51,-3.0,-3.5294117647058822,51,0
22401229,2,111,7.0,3.7837837837837833,720,609
22401229,2,123,0.0,0.0,603,480
22401229,2,40,-2.0,-3.0,480,440
22401229,2,106,1.0,0.5660377358490566,424,318
22401229,2,113,0.0,0.0,304,191
22401229,2,9,1.0,6.666666666666666,191,182
22401229,2,105,0.0,0.0,175,70
22401229,2,44,-1.0,-1.3636363636363638,70,26
22401229,2,26,0.0,0.0,26,0
22401229,3,386,0.0,0.0,720,334
22401229,3,128,-2.0,-0.9375,316,188
22401229,3,62,0.0,0.0,178,116
22401229,3,64,0.0,0.0,116,52
22401229,3,32,1.0,1.875,32,0
22401229,4,71,3.0,2.535211267605634,720,649
22401229,4,35,0.0,0.0,649,614
22401229,4,110,2.0,1.0909090909090908,607,497
22401229,4,136,0.0,0.0,484,348
22401229,4,67,1.0,0.8955223880597015,346,279
22401229,4,91,4.0,2.6373626373626378,272,181
22401229,4,158,1.0,0.37974683544303794,181,23
22401229,4,20,3.0,9.0,20,0
22401230,1,355,3.0,0.5070422535211268,720,365
22401230,1,22,0.0,0.0,365,343
22401230,1,72,-1.0,-0.8333333333333333,331,259
22401230,1,134,1.0,0.44776119402985076,259,125
22401230,1,70,1.0,0.8571428571428571,125,55
22401230,2,161,4.0,1.4906832298136645,720,559
22401230,2,18,0.0,0.0,553,535
22401230,2,46,2.0,2.608695652173913,513,467
22401230,2,48,0.0,0.0,424,376
22401230,2,2,0.0,0.0,354,352
22401230,2,6,0.0,0.0,344,338
22401230,2,79,2.0,1.5189873417721518,338,259
22401230,2,153,-7.0,-2.7450980392156863,259,106
22401230,2,68,1.0,0.8823529411764706,106,38
22401230,2,28,0.0,0.0,28,0
22401230,3,276,3.0,0.6521739130434783,720,444
22401230,3,117,-1.0,-0.5128205128205129,437,320
22401230,3,10,1.0,6.0,260,250
22401230,3,134,-2.0,-0.8955223880597015,250,116
22401230,3,14,-1.0,-4.285714285714286,116,102
22401230,3,35,2.0,3.4285714285714284,102,67
22401230,3,45,1.0,1.3333333333333335,47,2
22401230,4,68,4.0,3.5294117647058822,720,652
22401230,4,16,0.0,0.0,652,636
22401230,4,195,-5.0,-1.5384615384615383,636,441
22401230,4,67,5.0,4.477611940298507,428,361
22401230,4,112,-2.0,-1.0714285714285714,345,233
22401230,4,37,-2.0,-3.2432432432432434,218,181
22401230,4,102,-2.0,-1.1764705882352942,181,79
22401230,4,79,5.0,3.79746835443038,79,0
